dteday,season,hr,holiday,workingday,weathersit,casual,registered,cnt,season_cat
2011-01-01,1,0,0,0,1,3,13,16,springer
2011-01-01,1,1,0,0,1,8,32,40,springer
2011-01-01,1,2,0,0,1,5,27,32,springer
2011-01-01,1,3,0,0,1,3,10,13,springer
2011-01-01,1,4,0,0,1,0,1,1,springer
2011-01-01,1,5,0,0,2,0,1,1,springer
2011-01-01,1,6,0,0,1,2,0,2,springer
2011-01-01,1,7,0,0,1,1,2,3,springer
2011-01-01,1,8,0,0,1,1,7,8,springer
2011-01-01,1,9,0,0,1,8,6,14,springer
2011-01-01,1,10,0,0,1,12,24,36,springer
2011-01-01,1,11,0,0,1,26,30,56,springer
2011-01-01,1,12,0,0,1,29,55,84,springer
2011-01-01,1,13,0,0,2,47,47,94,springer
2011-01-01,1,14,0,0,2,35,71,106,springer
2011-01-01,1,15,0,0,2,40,70,110,springer
2011-01-01,1,16,0,0,2,41,52,93,springer
2011-01-01,1,17,0,0,2,15,52,67,springer
2011-01-01,1,18,0,0,3,9,26,35,springer
2011-01-01,1,19,0,0,3,6,31,37,springer
2011-01-01,1,20,0,0,2,11,25,36,springer
2011-01-01,1,21,0,0,2,3,31,34,springer
2011-01-01,1,22,0,0,2,11,17,28,springer
2011-01-01,1,23,0,0,2,15,24,39,springer
2011-01-02,1,0,0,0,2,4,13,17,springer
2011-01-02,1,1,0,0,2,1,16,17,springer
2011-01-02,1,2,0,0,2,1,8,9,springer
2011-01-02,1,3,0,0,2,2,4,6,springer
2011-01-02,1,4,0,0,2,2,1,3,springer
2011-01-02,1,6,0,0,3,0,2,2,springer
2011-01-02,1,7,0,0,2,0,1,1,springer
2011-01-02,1,8,0,0,3,0,8,8,springer
2011-01-02,1,9,0,0,2,1,19,20,springer
2011-01-02,1,10,0,0,2,7,46,53,springer
2011-01-02,1,11,0,0,2,16,54,70,springer
2011-01-02,1,12,0,0,2,20,73,93,springer
2011-01-02,1,13,0,0,2,11,64,75,springer
2011-01-02,1,14,0,0,3,4,55,59,springer
2011-01-02,1,15,0,0,3,19,55,74,springer
2011-01-02,1,16,0,0,3,9,67,76,springer
2011-01-02,1,17,0,0,1,7,58,65,springer
2011-01-02,1,18,0,0,2,10,43,53,springer
2011-01-02,1,19,0,0,1,1,29,30,springer
2011-01-02,1,20,0,0,1,5,17,22,springer
2011-01-02,1,21,0,0,1,11,20,31,springer
2011-01-02,1,22,0,0,1,0,9,9,springer
2011-01-02,1,23,0,0,1,0,8,8,springer
2011-01-03,1,0,0,1,1,0,5,5,springer
2011-01-03,1,1,0,1,1,0,2,2,springer
2011-01-03,1,4,0,1,1,0,1,1,springer
2011-01-03,1,5,0,1,1,0,3,3,springer
2011-01-03,1,6,0,1,1,0,30,30,springer
2011-01-03,1,7,0,1,1,1,63,64,springer
2011-01-03,1,8,0,1,1,1,153,154,springer
2011-01-03,1,9,0,1,1,7,81,88,springer
2011-01-03,1,10,0,1,1,11,33,44,springer
2011-01-03,1,11,0,1,1,10,41,51,springer
2011-01-03,1,12,0,1,1,13,48,61,springer
2011-01-03,1,13,0,1,1,8,53,61,springer
2011-01-03,1,14,0,1,1,11,66,77,springer
2011-01-03,1,15,0,1,1,14,58,72,springer
2011-01-03,1,16,0,1,1,9,67,76,springer
2011-01-03,1,17,0,1,1,11,146,157,springer
2011-01-03,1,18,0,1,1,9,148,157,springer
2011-01-03,1,19,0,1,1,8,102,110,springer
2011-01-03,1,20,0,1,1,3,49,52,springer
2011-01-03,1,21,0,1,1,3,49,52,springer
2011-01-03,1,22,0,1,1,0,20,20,springer
2011-01-03,1,23,0,1,1,1,11,12,springer
2011-01-04,1,0,0,1,1,0,5,5,springer
2011-01-04,1,1,0,1,1,0,2,2,springer
2011-01-04,1,2,0,1,1,0,1,1,springer
2011-01-04,1,4,0,1,1,0,2,2,springer
2011-01-04,1,5,0,1,1,0,4,4,springer
2011-01-04,1,6,0,1,1,0,36,36,springer
2011-01-04,1,7,0,1,1,2,92,94,springer
2011-01-04,1,8,0,1,1,2,177,179,springer
2011-01-04,1,9,0,1,1,2,98,100,springer
2011-01-04,1,10,0,1,2,5,37,42,springer
2011-01-04,1,11,0,1,1,7,50,57,springer
2011-01-04,1,12,0,1,1,12,66,78,springer
2011-01-04,1,13,0,1,1,18,79,97,springer
2011-01-04,1,14,0,1,1,9,54,63,springer
2011-01-04,1,15,0,1,1,17,48,65,springer
2011-01-04,1,16,0,1,1,15,68,83,springer
2011-01-04,1,17,0,1,1,10,202,212,springer
2011-01-04,1,18,0,1,1,3,179,182,springer
2011-01-04,1,19,0,1,1,2,110,112,springer
2011-01-04,1,20,0,1,1,1,53,54,springer
2011-01-04,1,21,0,1,1,0,48,48,springer
2011-01-04,1,22,0,1,1,1,34,35,springer
2011-01-04,1,23,0,1,1,2,9,11,springer
2011-01-05,1,0,0,1,1,0,6,6,springer
2011-01-05,1,1,0,1,1,0,6,6,springer
2011-01-05,1,2,0,1,1,0,2,2,springer
2011-01-05,1,4,0,1,1,0,2,2,springer
2011-01-05,1,5,0,1,1,0,3,3,springer
2011-01-05,1,6,0,1,1,0,33,33,springer
2011-01-05,1,7,0,1,1,1,87,88,springer
2011-01-05,1,8,0,1,1,3,192,195,springer
2011-01-05,1,9,0,1,1,6,109,115,springer
2011-01-05,1,10,0,1,1,4,53,57,springer
2011-01-05,1,11,0,1,1,12,34,46,springer
2011-01-05,1,12,0,1,1,5,74,79,springer
2011-01-05,1,13,0,1,1,6,65,71,springer
2011-01-05,1,14,0,1,1,10,52,62,springer
2011-01-05,1,15,0,1,1,7,55,62,springer
2011-01-05,1,16,0,1,1,4,85,89,springer
2011-01-05,1,17,0,1,1,4,186,190,springer
2011-01-05,1,18,0,1,1,3,166,169,springer
2011-01-05,1,19,0,1,1,5,127,132,springer
2011-01-05,1,20,0,1,1,7,82,89,springer
2011-01-05,1,21,0,1,1,3,40,43,springer
2011-01-05,1,22,0,1,1,1,41,42,springer
2011-01-05,1,23,0,1,1,1,18,19,springer
2011-01-06,1,0,0,1,1,0,11,11,springer
2011-01-06,1,1,0,1,1,0,4,4,springer
2011-01-06,1,2,0,1,1,0,2,2,springer
2011-01-06,1,4,0,1,2,0,1,1,springer
2011-01-06,1,5,0,1,2,0,4,4,springer
2011-01-06,1,6,0,1,2,0,36,36,springer
2011-01-06,1,7,0,1,2,0,95,95,springer
2011-01-06,1,8,0,1,1,3,216,219,springer
2011-01-06,1,9,0,1,2,6,116,122,springer
2011-01-06,1,10,0,1,1,3,42,45,springer
2011-01-06,1,11,0,1,1,2,57,59,springer
2011-01-06,1,12,0,1,1,6,78,84,springer
2011-01-06,1,13,0,1,1,12,55,67,springer
2011-01-06,1,14,0,1,1,11,59,70,springer
2011-01-06,1,15,0,1,1,8,54,62,springer
2011-01-06,1,16,0,1,1,12,74,86,springer
2011-01-06,1,17,0,1,1,9,163,172,springer
2011-01-06,1,18,0,1,1,5,158,163,springer
2011-01-06,1,19,0,1,1,3,109,112,springer
2011-01-06,1,20,0,1,1,3,66,69,springer
2011-01-06,1,21,0,1,2,0,48,48,springer
2011-01-06,1,22,0,1,2,1,51,52,springer
2011-01-06,1,23,0,1,2,4,19,23,springer
2011-01-07,1,0,0,1,2,4,13,17,springer
2011-01-07,1,1,0,1,2,2,5,7,springer
2011-01-07,1,2,0,1,2,0,1,1,springer
2011-01-07,1,4,0,1,2,0,1,1,springer
2011-01-07,1,5,0,1,3,0,5,5,springer
2011-01-07,1,6,0,1,2,8,26,34,springer
2011-01-07,1,7,0,1,1,8,76,84,springer
2011-01-07,1,8,0,1,1,20,190,210,springer
2011-01-07,1,9,0,1,1,9,125,134,springer
2011-01-07,1,10,0,1,1,16,47,63,springer
2011-01-07,1,11,0,1,2,19,48,67,springer
2011-01-07,1,12,0,1,2,9,50,59,springer
2011-01-07,1,13,0,1,2,9,64,73,springer
2011-01-07,1,14,0,1,2,7,43,50,springer
2011-01-07,1,15,0,1,2,9,63,72,springer
2011-01-07,1,16,0,1,2,5,82,87,springer
2011-01-07,1,17,0,1,2,9,178,187,springer
2011-01-07,1,18,0,1,1,7,116,123,springer
2011-01-07,1,19,0,1,1,3,92,95,springer
2011-01-07,1,20,0,1,1,1,50,51,springer
2011-01-07,1,21,0,1,1,0,39,39,springer
2011-01-07,1,22,0,1,2,2,34,36,springer
2011-01-07,1,23,0,1,2,1,14,15,springer
2011-01-08,1,0,0,0,2,1,24,25,springer
2011-01-08,1,1,0,0,2,1,15,16,springer
2011-01-08,1,2,0,0,2,3,13,16,springer
2011-01-08,1,3,0,0,3,0,7,7,springer
2011-01-08,1,4,0,0,3,0,1,1,springer
2011-01-08,1,5,0,0,2,0,5,5,springer
2011-01-08,1,6,0,0,2,0,2,2,springer
2011-01-08,1,7,0,0,2,1,8,9,springer
2011-01-08,1,8,0,0,3,0,15,15,springer
2011-01-08,1,9,0,0,3,0,20,20,springer
2011-01-08,1,10,0,0,2,5,56,61,springer
2011-01-08,1,11,0,0,2,2,60,62,springer
2011-01-08,1,12,0,0,2,8,90,98,springer
2011-01-08,1,13,0,0,1,7,95,102,springer
2011-01-08,1,14,0,0,1,12,83,95,springer
2011-01-08,1,15,0,0,1,5,69,74,springer
2011-01-08,1,16,0,0,1,8,68,76,springer
2011-01-08,1,17,0,0,1,5,64,69,springer
2011-01-08,1,18,0,0,1,3,52,55,springer
2011-01-08,1,19,0,0,1,4,26,30,springer
2011-01-08,1,20,0,0,1,0,28,28,springer
2011-01-08,1,21,0,0,1,2,35,37,springer
2011-01-08,1,22,0,0,1,1,33,34,springer
2011-01-08,1,23,0,0,1,0,22,22,springer
2011-01-09,1,0,0,0,1,1,24,25,springer
2011-01-09,1,1,0,0,1,0,12,12,springer
2011-01-09,1,2,0,0,1,0,11,11,springer
2011-01-09,1,3,0,0,1,0,4,4,springer
2011-01-09,1,4,0,0,1,0,1,1,springer
2011-01-09,1,5,0,0,1,0,1,1,springer
2011-01-09,1,6,0,0,1,0,1,1,springer
2011-01-09,1,7,0,0,1,1,5,6,springer
2011-01-09,1,8,0,0,1,0,10,10,springer
2011-01-09,1,9,0,0,1,0,19,19,springer
2011-01-09,1,10,0,0,1,0,49,49,springer
2011-01-09,1,11,0,0,1,2,47,49,springer
2011-01-09,1,12,0,0,1,4,79,83,springer
2011-01-09,1,13,0,0,1,6,69,75,springer
2011-01-09,1,14,0,0,1,8,64,72,springer
2011-01-09,1,15,0,0,1,5,77,82,springer
2011-01-09,1,16,0,0,1,13,79,92,springer
2011-01-09,1,17,0,0,1,3,59,62,springer
2011-01-09,1,18,0,0,1,4,44,48,springer
2011-01-09,1,19,0,0,1,1,40,41,springer
2011-01-09,1,20,0,0,1,0,38,38,springer
2011-01-09,1,21,0,0,1,1,19,20,springer
2011-01-09,1,22,0,0,1,5,10,15,springer
2011-01-09,1,23,0,0,1,0,6,6,springer
2011-01-10,1,0,0,1,1,2,3,5,springer
2011-01-10,1,1,0,1,1,1,0,1,springer
2011-01-10,1,2,0,1,1,0,3,3,springer
2011-01-10,1,3,0,1,1,0,1,1,springer
2011-01-10,1,4,0,1,1,1,2,3,springer
2011-01-10,1,5,0,1,1,0,3,3,springer
2011-01-10,1,6,0,1,1,0,31,31,springer
2011-01-10,1,7,0,1,1,2,75,77,springer
2011-01-10,1,8,0,1,2,4,184,188,springer
2011-01-10,1,9,0,1,2,2,92,94,springer
2011-01-10,1,10,0,1,2,0,31,31,springer
2011-01-10,1,11,0,1,2,2,28,30,springer
2011-01-10,1,12,0,1,2,5,47,52,springer
2011-01-10,1,13,0,1,2,4,50,54,springer
2011-01-10,1,14,0,1,2,0,47,47,springer
2011-01-10,1,15,0,1,2,2,43,45,springer
2011-01-10,1,16,0,1,1,4,70,74,springer
2011-01-10,1,17,0,1,1,4,174,178,springer
2011-01-10,1,18,0,1,1,1,154,155,springer
2011-01-10,1,19,0,1,1,3,92,95,springer
2011-01-10,1,20,0,1,1,1,73,74,springer
2011-01-10,1,21,0,1,1,1,37,38,springer
2011-01-10,1,22,0,1,1,2,22,24,springer
2011-01-10,1,23,0,1,1,0,18,18,springer
2011-01-11,1,0,0,1,1,2,10,12,springer
2011-01-11,1,1,0,1,1,0,3,3,springer
2011-01-11,1,2,0,1,2,0,3,3,springer
2011-01-11,1,5,0,1,2,0,6,6,springer
2011-01-11,1,6,0,1,2,0,27,27,springer
2011-01-11,1,7,0,1,2,2,97,99,springer
2011-01-11,1,8,0,1,2,3,214,217,springer
2011-01-11,1,9,0,1,2,3,127,130,springer
2011-01-11,1,10,0,1,2,3,51,54,springer
2011-01-11,1,11,0,1,2,4,31,35,springer
2011-01-11,1,12,0,1,2,2,55,57,springer
2011-01-11,1,13,0,1,2,6,46,52,springer
2011-01-11,1,14,0,1,2,3,60,63,springer
2011-01-11,1,15,0,1,2,2,45,47,springer
2011-01-11,1,16,0,1,2,4,72,76,springer
2011-01-11,1,17,0,1,2,6,130,136,springer
2011-01-11,1,18,0,1,3,1,94,95,springer
2011-01-11,1,19,0,1,3,0,51,51,springer
2011-01-11,1,20,0,1,3,0,32,32,springer
2011-01-11,1,21,0,1,3,0,20,20,springer
2011-01-11,1,22,0,1,3,1,28,29,springer
2011-01-11,1,23,0,1,3,1,18,19,springer
2011-01-12,1,0,0,1,2,0,7,7,springer
2011-01-12,1,1,0,1,2,0,6,6,springer
2011-01-12,1,2,0,1,1,0,1,1,springer
2011-01-12,1,5,0,1,1,0,5,5,springer
2011-01-12,1,6,0,1,1,0,16,16,springer
2011-01-12,1,7,0,1,1,0,54,54,springer
2011-01-12,1,8,0,1,1,3,125,128,springer
2011-01-12,1,9,0,1,1,3,78,81,springer
2011-01-12,1,10,0,1,1,0,39,39,springer
2011-01-12,1,11,0,1,1,3,32,35,springer
2011-01-12,1,12,0,1,1,3,52,55,springer
2011-01-12,1,13,0,1,1,0,49,49,springer
2011-01-12,1,14,0,1,1,0,44,44,springer
2011-01-12,1,15,0,1,1,1,48,49,springer
2011-01-12,1,16,0,1,1,5,63,68,springer
2011-01-12,1,17,0,1,1,0,139,139,springer
2011-01-12,1,18,0,1,1,2,135,137,springer
2011-01-12,1,19,0,1,1,1,82,83,springer
2011-01-12,1,20,0,1,1,2,54,56,springer
2011-01-12,1,21,0,1,1,0,57,57,springer
2011-01-12,1,22,0,1,1,1,32,33,springer
2011-01-12,1,23,0,1,1,1,19,20,springer
2011-01-13,1,0,0,1,1,1,6,7,springer
2011-01-13,1,1,0,1,1,0,2,2,springer
2011-01-13,1,2,0,1,1,0,2,2,springer
2011-01-13,1,3,0,1,1,0,3,3,springer
2011-01-13,1,4,0,1,1,0,4,4,springer
2011-01-13,1,5,0,1,1,0,3,3,springer
2011-01-13,1,6,0,1,1,0,28,28,springer
2011-01-13,1,7,0,1,1,0,72,72,springer
2011-01-13,1,8,0,1,1,5,197,202,springer
2011-01-13,1,9,0,1,1,2,137,139,springer
2011-01-13,1,10,0,1,2,2,36,38,springer
2011-01-13,1,11,0,1,2,4,33,37,springer
2011-01-13,1,12,0,1,1,3,49,52,springer
2011-01-13,1,13,0,1,1,2,81,83,springer
2011-01-13,1,14,0,1,1,3,39,42,springer
2011-01-13,1,15,0,1,1,5,55,60,springer
2011-01-13,1,16,0,1,1,2,76,78,springer
2011-01-13,1,17,0,1,1,4,158,162,springer
2011-01-13,1,18,0,1,1,3,141,144,springer
2011-01-13,1,19,0,1,1,1,98,99,springer
2011-01-13,1,20,0,1,1,0,64,64,springer
2011-01-13,1,21,0,1,1,0,40,40,springer
2011-01-13,1,22,0,1,1,0,30,30,springer
2011-01-13,1,23,0,1,1,1,14,15,springer
2011-01-14,1,0,0,1,1,0,14,14,springer
2011-01-14,1,1,0,1,1,0,5,5,springer
2011-01-14,1,2,0,1,1,0,1,1,springer
2011-01-14,1,3,0,1,1,0,1,1,springer
2011-01-14,1,5,0,1,1,0,8,8,springer
2011-01-14,1,6,0,1,1,0,17,17,springer
2011-01-14,1,7,0,1,1,0,70,70,springer
2011-01-14,1,8,0,1,1,2,156,158,springer
2011-01-14,1,9,0,1,1,0,117,117,springer
2011-01-14,1,10,0,1,1,4,40,44,springer
2011-01-14,1,11,0,1,1,6,47,53,springer
2011-01-14,1,12,0,1,1,2,59,61,springer
2011-01-14,1,13,0,1,1,4,73,77,springer
2011-01-14,1,14,0,1,1,5,59,64,springer
2011-01-14,1,15,0,1,1,9,59,68,springer
2011-01-14,1,16,0,1,1,3,87,90,springer
2011-01-14,1,17,0,1,1,4,155,159,springer
2011-01-14,1,18,0,1,1,5,134,139,springer
2011-01-14,1,19,0,1,1,3,89,92,springer
2011-01-14,1,20,0,1,1,0,68,68,springer
2011-01-14,1,21,0,1,1,4,48,52,springer
2011-01-14,1,22,0,1,2,2,34,36,springer
2011-01-14,1,23,0,1,2,1,26,27,springer
2011-01-15,1,0,0,0,1,3,25,28,springer
2011-01-15,1,1,0,0,2,2,18,20,springer
2011-01-15,1,2,0,0,2,0,12,12,springer
2011-01-15,1,3,0,0,2,1,7,8,springer
2011-01-15,1,4,0,0,2,0,5,5,springer
2011-01-15,1,5,0,0,1,0,1,1,springer
2011-01-15,1,6,0,0,1,1,2,3,springer
2011-01-15,1,7,0,0,1,1,9,10,springer
2011-01-15,1,8,0,0,1,1,22,23,springer
2011-01-15,1,9,0,0,1,2,31,33,springer
2011-01-15,1,10,0,0,1,2,57,59,springer
2011-01-15,1,11,0,0,1,18,54,72,springer
2011-01-15,1,12,0,0,1,15,74,89,springer
2011-01-15,1,13,0,0,1,21,80,101,springer
2011-01-15,1,14,0,0,1,26,92,118,springer
2011-01-15,1,15,0,0,2,21,108,129,springer
2011-01-15,1,16,0,0,2,33,95,128,springer
2011-01-15,1,17,0,0,2,29,54,83,springer
2011-01-15,1,18,0,0,2,15,69,84,springer
2011-01-15,1,19,0,0,2,14,60,74,springer
2011-01-15,1,20,0,0,2,6,35,41,springer
2011-01-15,1,21,0,0,2,6,51,57,springer
2011-01-15,1,22,0,0,2,0,26,26,springer
2011-01-15,1,23,0,0,1,5,39,44,springer
2011-01-16,1,0,0,0,1,6,33,39,springer
2011-01-16,1,1,0,0,1,4,19,23,springer
2011-01-16,1,2,0,0,1,3,13,16,springer
2011-01-16,1,3,0,0,1,9,6,15,springer
2011-01-16,1,4,0,0,1,0,1,1,springer
2011-01-16,1,5,0,0,2,1,1,2,springer
2011-01-16,1,6,0,0,2,0,1,1,springer
2011-01-16,1,7,0,0,2,0,3,3,springer
2011-01-16,1,8,0,0,1,0,18,18,springer
2011-01-16,1,9,0,0,1,3,29,32,springer
2011-01-16,1,10,0,0,1,8,71,79,springer
2011-01-16,1,11,0,0,1,23,70,93,springer
2011-01-16,1,12,0,0,1,29,75,104,springer
2011-01-16,1,13,0,0,1,23,95,118,springer
2011-01-16,1,14,0,0,1,22,69,91,springer
2011-01-16,1,15,0,0,1,35,78,113,springer
2011-01-16,1,16,0,0,1,22,77,99,springer
2011-01-16,1,17,0,0,1,23,82,105,springer
2011-01-16,1,18,0,0,1,11,56,67,springer
2011-01-16,1,19,0,0,1,14,47,61,springer
2011-01-16,1,20,0,0,1,7,50,57,springer
2011-01-16,1,21,0,0,1,6,22,28,springer
2011-01-16,1,22,0,0,2,2,19,21,springer
2011-01-16,1,23,0,0,2,0,18,18,springer
2011-01-17,1,0,1,0,2,1,16,17,springer
2011-01-17,1,1,1,0,2,1,15,16,springer
2011-01-17,1,2,1,0,2,0,8,8,springer
2011-01-17,1,3,1,0,2,0,2,2,springer
2011-01-17,1,4,1,0,2,1,2,3,springer
2011-01-17,1,5,1,0,2,0,1,1,springer
2011-01-17,1,6,1,0,2,0,5,5,springer
2011-01-17,1,7,1,0,2,4,9,13,springer
2011-01-17,1,8,1,0,2,3,30,33,springer
2011-01-17,1,9,1,0,2,8,39,47,springer
2011-01-17,1,10,1,0,2,7,50,57,springer
2011-01-17,1,11,1,0,2,9,55,64,springer
2011-01-17,1,12,1,0,2,10,70,80,springer
2011-01-17,1,13,1,0,2,13,80,93,springer
2011-01-17,1,14,1,0,2,12,74,86,springer
2011-01-17,1,15,1,0,2,21,72,93,springer
2011-01-17,1,16,1,0,2,6,76,82,springer
2011-01-17,1,17,1,0,1,4,67,71,springer
2011-01-17,1,18,1,0,2,7,85,92,springer
2011-01-17,1,19,1,0,3,2,58,60,springer
2011-01-17,1,20,1,0,3,4,29,33,springer
2011-01-17,1,21,1,0,3,3,24,27,springer
2011-01-17,1,22,1,0,3,0,13,13,springer
2011-01-17,1,23,1,0,3,1,3,4,springer
2011-01-18,1,12,0,1,2,0,3,3,springer
2011-01-18,1,13,0,1,2,0,22,22,springer
2011-01-18,1,14,0,1,2,2,26,28,springer
2011-01-18,1,15,0,1,2,3,32,35,springer
2011-01-18,1,16,0,1,2,0,61,61,springer
2011-01-18,1,17,0,1,2,1,124,125,springer
2011-01-18,1,18,0,1,2,1,132,133,springer
2011-01-18,1,19,0,1,2,1,98,99,springer
2011-01-18,1,20,0,1,2,0,83,83,springer
2011-01-18,1,21,0,1,2,0,41,41,springer
2011-01-18,1,22,0,1,2,0,33,33,springer
2011-01-18,1,23,0,1,2,1,19,20,springer
2011-01-19,1,0,0,1,2,0,3,3,springer
2011-01-19,1,1,0,1,3,1,6,7,springer
2011-01-19,1,2,0,1,3,0,3,3,springer
2011-01-19,1,4,0,1,3,1,1,2,springer
2011-01-19,1,5,0,1,2,0,7,7,springer
2011-01-19,1,6,0,1,2,0,32,32,springer
2011-01-19,1,7,0,1,2,1,89,90,springer
2011-01-19,1,8,0,1,2,1,196,197,springer
2011-01-19,1,9,0,1,2,2,107,109,springer
2011-01-19,1,10,0,1,2,1,46,47,springer
2011-01-19,1,11,0,1,2,5,47,52,springer
2011-01-19,1,12,0,1,2,5,65,70,springer
2011-01-19,1,13,0,1,1,11,67,78,springer
2011-01-19,1,14,0,1,1,7,68,75,springer
2011-01-19,1,15,0,1,1,4,78,82,springer
2011-01-19,1,16,0,1,1,10,94,104,springer
2011-01-19,1,17,0,1,1,7,190,197,springer
2011-01-19,1,18,0,1,1,5,156,161,springer
2011-01-19,1,19,0,1,1,4,108,112,springer
2011-01-19,1,20,0,1,1,2,74,76,springer
2011-01-19,1,21,0,1,1,4,55,59,springer
2011-01-19,1,22,0,1,1,6,53,59,springer
2011-01-19,1,23,0,1,1,1,27,28,springer
2011-01-20,1,0,0,1,1,5,8,13,springer
2011-01-20,1,1,0,1,1,2,3,5,springer
2011-01-20,1,2,0,1,1,0,2,2,springer
2011-01-20,1,3,0,1,1,0,1,1,springer
2011-01-20,1,4,0,1,1,0,1,1,springer
2011-01-20,1,5,0,1,1,0,6,6,springer
2011-01-20,1,6,0,1,1,0,35,35,springer
2011-01-20,1,7,0,1,1,1,100,101,springer
2011-01-20,1,8,0,1,1,2,247,249,springer
2011-01-20,1,9,0,1,2,3,140,143,springer
2011-01-20,1,10,0,1,1,1,56,57,springer
2011-01-20,1,11,0,1,2,5,63,68,springer
2011-01-20,1,12,0,1,2,7,77,84,springer
2011-01-20,1,13,0,1,2,12,86,98,springer
2011-01-20,1,14,0,1,2,6,75,81,springer
2011-01-20,1,15,0,1,2,8,62,70,springer
2011-01-20,1,16,0,1,2,8,83,91,springer
2011-01-20,1,17,0,1,2,8,207,215,springer
2011-01-20,1,18,0,1,2,1,184,185,springer
2011-01-20,1,19,0,1,1,6,146,152,springer
2011-01-20,1,20,0,1,2,2,124,126,springer
2011-01-20,1,21,0,1,2,3,54,57,springer
2011-01-20,1,22,0,1,2,0,56,56,springer
2011-01-20,1,23,0,1,2,3,28,31,springer
2011-01-21,1,0,0,1,2,1,20,21,springer
2011-01-21,1,1,0,1,2,0,6,6,springer
2011-01-21,1,2,0,1,3,0,2,2,springer
2011-01-21,1,3,0,1,3,0,1,1,springer
2011-01-21,1,4,0,1,2,0,1,1,springer
2011-01-21,1,5,0,1,1,1,4,5,springer
2011-01-21,1,6,0,1,1,0,27,27,springer
2011-01-21,1,7,0,1,1,2,66,68,springer
2011-01-21,1,8,0,1,1,7,210,217,springer
2011-01-21,1,9,0,1,1,7,159,166,springer
2011-01-21,1,10,0,1,1,6,57,63,springer
2011-01-21,1,11,0,1,1,6,53,59,springer
2011-01-21,1,12,0,1,1,11,67,78,springer
2011-01-21,1,13,0,1,1,8,65,73,springer
2011-01-21,1,14,0,1,1,6,56,62,springer
2011-01-21,1,15,0,1,1,4,61,65,springer
2011-01-21,1,16,0,1,1,0,97,97,springer
2011-01-21,1,17,0,1,1,10,151,161,springer
2011-01-21,1,18,0,1,1,1,119,120,springer
2011-01-21,1,19,0,1,1,3,93,96,springer
2011-01-21,1,20,0,1,1,1,52,53,springer
2011-01-21,1,21,0,1,1,0,41,41,springer
2011-01-21,1,22,0,1,1,1,33,34,springer
2011-01-21,1,23,0,1,1,0,27,27,springer
2011-01-22,1,0,0,0,1,0,13,13,springer
2011-01-22,1,1,0,0,2,3,9,12,springer
2011-01-22,1,2,0,0,2,0,11,11,springer
2011-01-22,1,3,0,0,2,1,6,7,springer
2011-01-22,1,4,0,0,2,0,3,3,springer
2011-01-22,1,6,0,0,2,0,2,2,springer
2011-01-22,1,7,0,0,1,0,8,8,springer
2011-01-22,1,8,0,0,1,1,26,27,springer
2011-01-22,1,9,0,0,1,3,37,40,springer
2011-01-22,1,10,0,0,2,3,50,53,springer
2011-01-22,1,11,0,0,2,4,59,63,springer
2011-01-22,1,12,0,0,2,10,60,70,springer
2011-01-22,1,13,0,0,1,12,72,84,springer
2011-01-22,1,14,0,0,1,11,64,75,springer
2011-01-22,1,15,0,0,1,10,93,103,springer
2011-01-22,1,16,0,0,1,11,72,83,springer
2011-01-22,1,17,0,0,1,8,59,67,springer
2011-01-22,1,18,0,0,1,0,54,54,springer
2011-01-22,1,19,0,0,1,6,53,59,springer
2011-01-22,1,20,0,0,1,1,44,45,springer
2011-01-22,1,21,0,0,1,0,39,39,springer
2011-01-22,1,22,0,0,1,7,23,30,springer
2011-01-22,1,23,0,0,1,2,31,33,springer
2011-01-23,1,0,0,0,1,2,20,22,springer
2011-01-23,1,1,0,0,1,1,12,13,springer
2011-01-23,1,2,0,0,1,3,15,18,springer
2011-01-23,1,3,0,0,1,1,4,5,springer
2011-01-23,1,5,0,0,2,0,3,3,springer
2011-01-23,1,6,0,0,2,0,1,1,springer
2011-01-23,1,7,0,0,1,1,1,2,springer
2011-01-23,1,8,0,0,1,2,17,19,springer
2011-01-23,1,9,0,0,1,3,25,28,springer
2011-01-23,1,10,0,0,1,7,51,58,springer
2011-01-23,1,11,0,0,1,22,77,99,springer
2011-01-23,1,12,0,0,1,24,92,116,springer
2011-01-23,1,13,0,0,1,12,75,87,springer
2011-01-23,1,14,0,0,1,17,93,110,springer
2011-01-23,1,15,0,0,1,13,64,77,springer
2011-01-23,1,16,0,0,1,9,56,65,springer
2011-01-23,1,17,0,0,1,5,50,55,springer
2011-01-23,1,18,0,0,1,5,44,49,springer
2011-01-23,1,19,0,0,1,5,45,50,springer
2011-01-23,1,20,0,0,1,4,31,35,springer
2011-01-23,1,21,0,0,1,5,20,25,springer
2011-01-23,1,22,0,0,1,5,23,28,springer
2011-01-23,1,23,0,0,1,4,17,21,springer
2011-01-24,1,0,0,1,1,0,7,7,springer
2011-01-24,1,1,0,1,1,0,1,1,springer
2011-01-24,1,3,0,1,1,0,1,1,springer
2011-01-24,1,4,0,1,1,0,1,1,springer
2011-01-24,1,5,0,1,1,0,5,5,springer
2011-01-24,1,6,0,1,1,0,15,15,springer
2011-01-24,1,7,0,1,1,5,79,84,springer
2011-01-24,1,8,0,1,1,6,171,177,springer
2011-01-24,1,9,0,1,1,4,98,102,springer
2011-01-24,1,10,0,1,1,6,34,40,springer
2011-01-24,1,11,0,1,1,3,43,46,springer
2011-01-24,1,12,0,1,2,11,52,63,springer
2011-01-24,1,13,0,1,2,6,54,60,springer
2011-01-24,1,14,0,1,2,2,43,45,springer
2011-01-24,1,15,0,1,1,7,50,57,springer
2011-01-24,1,16,0,1,1,4,66,70,springer
2011-01-24,1,17,0,1,1,6,178,184,springer
2011-01-24,1,18,0,1,1,8,145,153,springer
2011-01-24,1,19,0,1,1,5,101,106,springer
2011-01-24,1,20,0,1,1,1,80,81,springer
2011-01-24,1,21,0,1,1,6,53,59,springer
2011-01-24,1,22,0,1,2,3,32,35,springer
2011-01-24,1,23,0,1,2,3,21,24,springer
2011-01-25,1,0,0,1,2,3,6,9,springer
2011-01-25,1,1,0,1,2,0,5,5,springer
2011-01-25,1,2,0,1,1,0,2,2,springer
2011-01-25,1,4,0,1,1,0,1,1,springer
2011-01-25,1,5,0,1,1,0,9,9,springer
2011-01-25,1,6,0,1,1,1,35,36,springer
2011-01-25,1,7,0,1,1,5,103,108,springer
2011-01-25,1,8,0,1,2,5,233,238,springer
2011-01-25,1,9,0,1,2,10,134,144,springer
2011-01-25,1,10,0,1,2,6,49,55,springer
2011-01-25,1,11,0,1,2,6,55,61,springer
2011-01-25,1,12,0,1,2,21,85,106,springer
2011-01-25,1,13,0,1,2,21,72,93,springer
2011-01-25,1,14,0,1,2,11,57,68,springer
2011-01-25,1,15,0,1,2,21,63,84,springer
2011-01-25,1,16,0,1,2,14,102,116,springer
2011-01-25,1,17,0,1,1,14,208,222,springer
2011-01-25,1,18,0,1,2,7,218,225,springer
2011-01-25,1,19,0,1,2,13,133,146,springer
2011-01-25,1,20,0,1,1,16,103,119,springer
2011-01-25,1,21,0,1,1,5,40,45,springer
2011-01-25,1,22,0,1,1,4,49,53,springer
2011-01-25,1,23,0,1,2,3,37,40,springer
2011-01-26,1,0,0,1,2,3,14,17,springer
2011-01-26,1,1,0,1,2,0,5,5,springer
2011-01-26,1,2,0,1,3,3,7,10,springer
2011-01-26,1,5,0,1,3,0,1,1,springer
2011-01-26,1,6,0,1,3,0,8,8,springer
2011-01-26,1,7,0,1,3,1,29,30,springer
2011-01-26,1,8,0,1,3,3,69,72,springer
2011-01-26,1,9,0,1,3,3,55,58,springer
2011-01-26,1,10,0,1,3,2,26,28,springer
2011-01-26,1,11,0,1,3,6,35,41,springer
2011-01-26,1,12,0,1,3,7,41,48,springer
2011-01-26,1,13,0,1,3,4,43,47,springer
2011-01-26,1,14,0,1,3,0,36,36,springer
2011-01-26,1,15,0,1,3,1,42,43,springer
2011-01-26,1,16,0,1,4,1,35,36,springer
2011-01-26,1,17,0,1,3,0,26,26,springer
2011-01-27,1,16,0,1,1,1,23,24,springer
2011-01-27,1,17,0,1,1,2,82,84,springer
2011-01-27,1,18,0,1,1,3,101,104,springer
2011-01-27,1,19,0,1,1,3,76,79,springer
2011-01-27,1,20,0,1,1,4,55,59,springer
2011-01-27,1,21,0,1,1,2,36,38,springer
2011-01-27,1,22,0,1,1,0,27,27,springer
2011-01-27,1,23,0,1,1,0,16,16,springer
2011-01-28,1,0,0,1,2,0,9,9,springer
2011-01-28,1,1,0,1,2,1,2,3,springer
2011-01-28,1,2,0,1,2,0,2,2,springer
2011-01-28,1,3,0,1,2,1,0,1,springer
2011-01-28,1,5,0,1,2,0,4,4,springer
2011-01-28,1,6,0,1,2,0,16,16,springer
2011-01-28,1,7,0,1,2,2,58,60,springer
2011-01-28,1,8,0,1,2,2,155,157,springer
2011-01-28,1,9,0,1,3,6,95,101,springer
2011-01-28,1,10,0,1,3,0,49,49,springer
2011-01-28,1,11,0,1,3,0,30,30,springer
2011-01-28,1,12,0,1,3,1,28,29,springer
2011-01-28,1,13,0,1,3,0,31,31,springer
2011-01-28,1,14,0,1,3,2,36,38,springer
2011-01-28,1,15,0,1,2,1,40,41,springer
2011-01-28,1,16,0,1,1,10,70,80,springer
2011-01-28,1,17,0,1,1,2,147,149,springer
2011-01-28,1,18,0,1,1,2,107,109,springer
2011-01-28,1,19,0,1,2,5,84,89,springer
2011-01-28,1,20,0,1,2,1,61,62,springer
2011-01-28,1,21,0,1,2,1,57,58,springer
2011-01-28,1,22,0,1,1,0,26,26,springer
2011-01-28,1,23,0,1,1,1,22,23,springer
2011-01-29,1,0,0,0,1,2,26,28,springer
2011-01-29,1,1,0,0,1,0,20,20,springer
2011-01-29,1,2,0,0,1,0,15,15,springer
2011-01-29,1,3,0,0,1,3,5,8,springer
2011-01-29,1,4,0,0,1,1,2,3,springer
2011-01-29,1,6,0,0,1,0,2,2,springer
2011-01-29,1,7,0,0,1,1,4,5,springer
2011-01-29,1,8,0,0,1,3,31,34,springer
2011-01-29,1,9,0,0,1,0,34,34,springer
2011-01-29,1,10,0,0,2,4,51,55,springer
2011-01-29,1,11,0,0,2,4,60,64,springer
2011-01-29,1,12,0,0,2,12,66,78,springer
2011-01-29,1,13,0,0,2,9,56,65,springer
2011-01-29,1,14,0,0,2,10,89,99,springer
2011-01-29,1,15,0,0,1,22,98,120,springer
2011-01-29,1,16,0,0,1,19,88,107,springer
2011-01-29,1,17,0,0,1,9,82,91,springer
2011-01-29,1,18,0,0,1,9,59,68,springer
2011-01-29,1,19,0,0,2,6,52,58,springer
2011-01-29,1,20,0,0,1,1,42,43,springer
2011-01-29,1,21,0,0,1,1,35,36,springer
2011-01-29,1,22,0,0,1,4,28,32,springer
2011-01-29,1,23,0,0,1,3,30,33,springer
2011-01-30,1,0,0,0,1,0,33,33,springer
2011-01-30,1,1,0,0,1,7,22,29,springer
2011-01-30,1,2,0,0,1,1,10,11,springer
2011-01-30,1,3,0,0,1,1,7,8,springer
2011-01-30,1,4,0,0,1,0,1,1,springer
2011-01-30,1,5,0,0,1,0,3,3,springer
2011-01-30,1,7,0,0,1,0,3,3,springer
2011-01-30,1,8,0,0,2,1,11,12,springer
2011-01-30,1,9,0,0,2,4,34,38,springer
2011-01-30,1,10,0,0,2,7,57,64,springer
2011-01-30,1,11,0,0,1,9,50,59,springer
2011-01-30,1,12,0,0,1,10,87,97,springer
2011-01-30,1,13,0,0,1,13,71,84,springer
2011-01-30,1,14,0,0,1,18,104,122,springer
2011-01-30,1,15,0,0,1,14,95,109,springer
2011-01-30,1,16,0,0,1,19,104,123,springer
2011-01-30,1,17,0,0,1,6,71,77,springer
2011-01-30,1,18,0,0,1,8,57,65,springer
2011-01-30,1,19,0,0,1,9,46,55,springer
2011-01-30,1,20,0,0,2,3,30,33,springer
2011-01-30,1,21,0,0,2,3,25,28,springer
2011-01-30,1,22,0,0,2,2,19,21,springer
2011-01-30,1,23,0,0,2,5,16,21,springer
2011-01-31,1,0,0,1,2,1,6,7,springer
2011-01-31,1,1,0,1,1,2,5,7,springer
2011-01-31,1,2,0,1,1,0,1,1,springer
2011-01-31,1,3,0,1,1,0,2,2,springer
2011-01-31,1,4,0,1,1,0,2,2,springer
2011-01-31,1,5,0,1,1,0,8,8,springer
2011-01-31,1,6,0,1,1,0,37,37,springer
2011-01-31,1,7,0,1,2,1,71,72,springer
2011-01-31,1,8,0,1,2,3,182,185,springer
2011-01-31,1,9,0,1,2,0,112,112,springer
2011-01-31,1,10,0,1,2,1,68,69,springer
2011-01-31,1,11,0,1,2,2,46,48,springer
2011-01-31,1,12,0,1,2,6,62,68,springer
2011-01-31,1,13,0,1,2,2,52,54,springer
2011-01-31,1,14,0,1,2,1,85,86,springer
2011-01-31,1,15,0,1,2,3,41,44,springer
2011-01-31,1,16,0,1,2,3,83,86,springer
2011-01-31,1,17,0,1,2,6,155,161,springer
2011-01-31,1,18,0,1,2,3,153,156,springer
2011-01-31,1,19,0,1,1,3,108,111,springer
2011-01-31,1,20,0,1,3,0,78,78,springer
2011-01-31,1,21,0,1,3,3,53,56,springer
2011-01-31,1,22,0,1,2,0,34,34,springer
2011-01-31,1,23,0,1,2,2,15,17,springer
2011-02-01,1,0,0,1,2,2,6,8,springer
2011-02-01,1,1,0,1,2,0,3,3,springer
2011-02-01,1,2,0,1,2,0,2,2,springer
2011-02-01,1,3,0,1,2,0,2,2,springer
2011-02-01,1,5,0,1,3,0,3,3,springer
2011-02-01,1,6,0,1,3,0,22,22,springer
2011-02-01,1,7,0,1,3,0,52,52,springer
2011-02-01,1,8,0,1,3,3,132,135,springer
2011-02-01,1,9,0,1,2,2,114,116,springer
2011-02-01,1,10,0,1,2,0,47,47,springer
2011-02-01,1,11,0,1,2,2,49,51,springer
2011-02-01,1,12,0,1,2,2,53,55,springer
2011-02-01,1,13,0,1,2,3,49,52,springer
2011-02-01,1,14,0,1,2,5,49,54,springer
2011-02-01,1,15,0,1,2,7,45,52,springer
2011-02-01,1,16,0,1,2,3,61,64,springer
2011-02-01,1,17,0,1,2,4,172,176,springer
2011-02-01,1,18,0,1,2,3,165,168,springer
2011-02-01,1,19,0,1,2,3,105,108,springer
2011-02-01,1,20,0,1,2,5,69,74,springer
2011-02-01,1,21,0,1,2,0,64,64,springer
2011-02-01,1,22,0,1,2,2,34,36,springer
2011-02-01,1,23,0,1,3,1,15,16,springer
2011-02-02,1,0,0,1,3,0,2,2,springer
2011-02-02,1,1,0,1,3,0,3,3,springer
2011-02-02,1,2,0,1,3,4,0,4,springer
2011-02-02,1,3,0,1,3,0,1,1,springer
2011-02-02,1,4,0,1,3,0,1,1,springer
2011-02-02,1,5,0,1,3,0,3,3,springer
2011-02-02,1,6,0,1,3,1,17,18,springer
2011-02-02,1,7,0,1,3,1,48,49,springer
2011-02-02,1,8,0,1,3,1,154,155,springer
2011-02-02,1,9,0,1,2,4,119,123,springer
2011-02-02,1,10,0,1,2,2,59,61,springer
2011-02-02,1,11,0,1,2,5,47,52,springer
2011-02-02,1,12,0,1,2,3,61,64,springer
2011-02-02,1,13,0,1,1,1,74,75,springer
2011-02-02,1,14,0,1,1,2,61,63,springer
2011-02-02,1,15,0,1,1,10,66,76,springer
2011-02-02,1,16,0,1,1,8,95,103,springer
2011-02-02,1,17,0,1,1,7,183,190,springer
2011-02-02,1,18,0,1,1,7,175,182,springer
2011-02-02,1,19,0,1,1,3,88,91,springer
2011-02-02,1,20,0,1,1,4,71,75,springer
2011-02-02,1,21,0,1,1,1,62,63,springer
2011-02-02,1,22,0,1,1,5,35,40,springer
2011-02-02,1,23,0,1,1,3,29,32,springer
2011-02-03,1,0,0,1,1,1,11,12,springer
2011-02-03,1,1,0,1,1,0,5,5,springer
2011-02-03,1,2,0,1,1,0,2,2,springer
2011-02-03,1,3,0,1,1,0,1,1,springer
2011-02-03,1,5,0,1,1,0,2,2,springer
2011-02-03,1,6,0,1,1,0,39,39,springer
2011-02-03,1,7,0,1,1,1,86,87,springer
2011-02-03,1,8,0,1,1,4,184,188,springer
2011-02-03,1,9,0,1,1,6,127,133,springer
2011-02-03,1,10,0,1,1,2,50,52,springer
2011-02-03,1,11,0,1,1,9,55,64,springer
2011-02-03,1,12,0,1,1,2,67,69,springer
2011-02-03,1,13,0,1,1,4,47,51,springer
2011-02-03,1,14,0,1,1,4,43,47,springer
2011-02-03,1,15,0,1,1,4,56,60,springer
2011-02-03,1,16,0,1,1,5,73,78,springer
2011-02-03,1,17,0,1,1,5,170,175,springer
2011-02-03,1,18,0,1,1,2,145,147,springer
2011-02-03,1,19,0,1,1,4,92,96,springer
2011-02-03,1,20,0,1,1,1,108,109,springer
2011-02-03,1,21,0,1,1,1,53,54,springer
2011-02-03,1,22,0,1,1,2,39,41,springer
2011-02-03,1,23,0,1,1,4,34,38,springer
2011-02-04,1,0,0,1,2,3,10,13,springer
2011-02-04,1,1,0,1,2,0,7,7,springer
2011-02-04,1,2,0,1,2,0,1,1,springer
2011-02-04,1,3,0,1,2,0,1,1,springer
2011-02-04,1,5,0,1,2,0,7,7,springer
2011-02-04,1,6,0,1,2,2,26,28,springer
2011-02-04,1,7,0,1,1,0,87,87,springer
2011-02-04,1,8,0,1,1,3,217,220,springer
2011-02-04,1,9,0,1,2,3,124,127,springer
2011-02-04,1,10,0,1,2,5,46,51,springer
2011-02-04,1,11,0,1,1,3,61,64,springer
2011-02-04,1,12,0,1,2,8,78,86,springer
2011-02-04,1,13,0,1,2,9,73,82,springer
2011-02-04,1,14,0,1,2,15,76,91,springer
2011-02-04,1,15,0,1,2,9,81,90,springer
2011-02-04,1,16,0,1,2,8,91,99,springer
2011-02-04,1,17,0,1,2,10,195,205,springer
2011-02-04,1,18,0,1,2,3,152,155,springer
2011-02-04,1,19,0,1,2,1,102,103,springer
2011-02-04,1,20,0,1,2,2,69,71,springer
2011-02-04,1,21,0,1,2,2,41,43,springer
2011-02-04,1,22,0,1,2,1,45,46,springer
2011-02-04,1,23,0,1,2,1,30,31,springer
2011-02-05,1,0,0,0,2,3,36,39,springer
2011-02-05,1,1,0,0,2,1,17,18,springer
2011-02-05,1,2,0,0,2,5,12,17,springer
2011-02-05,1,3,0,0,2,1,10,11,springer
2011-02-05,1,4,0,0,3,0,8,8,springer
2011-02-05,1,5,0,0,3,0,9,9,springer
2011-02-05,1,6,0,0,3,0,4,4,springer
2011-02-05,1,7,0,0,3,0,4,4,springer
2011-02-05,1,8,0,0,3,0,10,10,springer
2011-02-05,1,9,0,0,3,3,17,20,springer
2011-02-05,1,10,0,0,3,3,31,34,springer
2011-02-05,1,11,0,0,3,1,46,47,springer
2011-02-05,1,12,0,0,3,10,42,52,springer
2011-02-05,1,13,0,0,3,10,62,72,springer
2011-02-05,1,14,0,0,3,5,50,55,springer
2011-02-05,1,15,0,0,3,11,49,60,springer
2011-02-05,1,16,0,0,3,8,63,71,springer
2011-02-05,1,17,0,0,2,14,64,78,springer
2011-02-05,1,18,0,0,2,2,81,83,springer
2011-02-05,1,19,0,0,2,6,78,84,springer
2011-02-05,1,20,0,0,1,5,64,69,springer
2011-02-05,1,21,0,0,1,3,53,56,springer
2011-02-05,1,22,0,0,1,2,43,45,springer
2011-02-05,1,23,0,0,1,7,52,59,springer
2011-02-06,1,0,0,0,1,2,37,39,springer
2011-02-06,1,1,0,0,1,4,40,44,springer
2011-02-06,1,2,0,0,1,0,20,20,springer
2011-02-06,1,3,0,0,1,3,10,13,springer
2011-02-06,1,4,0,0,1,0,2,2,springer
2011-02-06,1,5,0,0,1,0,1,1,springer
2011-02-06,1,6,0,0,1,0,1,1,springer
2011-02-06,1,7,0,0,1,0,8,8,springer
2011-02-06,1,8,0,0,1,2,21,23,springer
2011-02-06,1,9,0,0,1,7,38,45,springer
2011-02-06,1,10,0,0,1,15,74,89,springer
2011-02-06,1,11,0,0,1,28,89,117,springer
2011-02-06,1,12,0,0,1,48,126,174,springer
2011-02-06,1,13,0,0,1,47,135,182,springer
2011-02-06,1,14,0,0,1,47,114,161,springer
2011-02-06,1,15,0,0,1,52,130,182,springer
2011-02-06,1,16,0,0,1,42,115,157,springer
2011-02-06,1,17,0,0,1,24,97,121,springer
2011-02-06,1,18,0,0,1,13,65,78,springer
2011-02-06,1,19,0,0,1,1,20,21,springer
2011-02-06,1,20,0,0,1,5,21,26,springer
2011-02-06,1,21,0,0,1,5,22,27,springer
2011-02-06,1,22,0,0,1,5,57,62,springer
2011-02-06,1,23,0,0,1,4,26,30,springer
2011-02-07,1,0,0,1,1,1,14,15,springer
2011-02-07,1,1,0,1,1,1,4,5,springer
2011-02-07,1,2,0,1,1,0,3,3,springer
2011-02-07,1,3,0,1,1,0,1,1,springer
2011-02-07,1,4,0,1,1,1,1,2,springer
2011-02-07,1,5,0,1,1,1,9,10,springer
2011-02-07,1,6,0,1,1,1,29,30,springer
2011-02-07,1,7,0,1,1,6,89,95,springer
2011-02-07,1,8,0,1,2,7,223,230,springer
2011-02-07,1,9,0,1,1,3,115,118,springer
2011-02-07,1,10,0,1,1,6,49,55,springer
2011-02-07,1,11,0,1,1,11,36,47,springer
2011-02-07,1,12,0,1,2,7,59,66,springer
2011-02-07,1,13,0,1,2,10,54,64,springer
2011-02-07,1,14,0,1,2,8,52,60,springer
2011-02-07,1,15,0,1,2,4,46,50,springer
2011-02-07,1,16,0,1,2,16,98,114,springer
2011-02-07,1,17,0,1,2,9,207,216,springer
2011-02-07,1,18,0,1,2,5,170,175,springer
2011-02-07,1,19,0,1,2,5,123,128,springer
2011-02-07,1,20,0,1,2,6,82,88,springer
2011-02-07,1,21,0,1,1,3,75,78,springer
2011-02-07,1,22,0,1,1,3,34,37,springer
2011-02-07,1,23,0,1,2,6,19,25,springer
2011-02-08,1,0,0,1,2,4,6,10,springer
2011-02-08,1,1,0,1,2,0,4,4,springer
2011-02-08,1,2,0,1,2,1,1,2,springer
2011-02-08,1,3,0,1,3,0,1,1,springer
2011-02-08,1,4,0,1,1,0,3,3,springer
2011-02-08,1,5,0,1,1,0,2,2,springer
2011-02-08,1,6,0,1,1,0,39,39,springer
2011-02-08,1,7,0,1,1,3,97,100,springer
2011-02-08,1,8,0,1,1,7,236,243,springer
2011-02-08,1,9,0,1,1,7,128,135,springer
2011-02-08,1,10,0,1,1,4,44,48,springer
2011-02-08,1,11,0,1,1,1,49,50,springer
2011-02-08,1,12,0,1,1,2,63,65,springer
2011-02-08,1,13,0,1,2,2,48,50,springer
2011-02-08,1,14,0,1,1,3,61,64,springer
2011-02-08,1,15,0,1,1,6,45,51,springer
2011-02-08,1,16,0,1,1,4,79,83,springer
2011-02-08,1,17,0,1,1,4,172,176,springer
2011-02-08,1,18,0,1,1,1,151,152,springer
2011-02-08,1,19,0,1,1,1,100,101,springer
2011-02-08,1,20,0,1,1,3,53,56,springer
2011-02-08,1,21,0,1,1,8,46,54,springer
2011-02-08,1,22,0,1,1,0,29,29,springer
2011-02-08,1,23,0,1,1,3,9,12,springer
2011-02-09,1,0,0,1,1,0,17,17,springer
2011-02-09,1,1,0,1,1,0,7,7,springer
2011-02-09,1,2,0,1,1,1,2,3,springer
2011-02-09,1,3,0,1,1,0,2,2,springer
2011-02-09,1,5,0,1,1,0,7,7,springer
2011-02-09,1,6,0,1,1,0,43,43,springer
2011-02-09,1,7,0,1,1,4,95,99,springer
2011-02-09,1,8,0,1,1,1,198,199,springer
2011-02-09,1,9,0,1,1,4,119,123,springer
2011-02-09,1,10,0,1,1,8,51,59,springer
2011-02-09,1,11,0,1,2,1,40,41,springer
2011-02-09,1,12,0,1,2,4,57,61,springer
2011-02-09,1,13,0,1,1,2,67,69,springer
2011-02-09,1,14,0,1,1,2,56,58,springer
2011-02-09,1,15,0,1,2,3,61,64,springer
2011-02-09,1,16,0,1,2,7,72,79,springer
2011-02-09,1,17,0,1,2,9,157,166,springer
2011-02-09,1,18,0,1,2,2,168,170,springer
2011-02-09,1,19,0,1,3,1,87,88,springer
2011-02-09,1,20,0,1,3,0,84,84,springer
2011-02-09,1,21,0,1,2,0,83,83,springer
2011-02-09,1,22,0,1,3,4,42,46,springer
2011-02-09,1,23,0,1,3,0,37,37,springer
2011-02-10,1,0,0,1,3,0,16,16,springer
2011-02-10,1,1,0,1,3,0,7,7,springer
2011-02-10,1,2,0,1,3,0,3,3,springer
2011-02-10,1,4,0,1,2,0,1,1,springer
2011-02-10,1,5,0,1,2,0,6,6,springer
2011-02-10,1,6,0,1,2,0,26,26,springer
2011-02-10,1,7,0,1,1,0,99,99,springer
2011-02-10,1,8,0,1,1,5,173,178,springer
2011-02-10,1,9,0,1,1,1,121,122,springer
2011-02-10,1,10,0,1,1,1,34,35,springer
2011-02-10,1,11,0,1,1,1,44,45,springer
2011-02-10,1,12,0,1,1,4,65,69,springer
2011-02-10,1,13,0,1,1,3,59,62,springer
2011-02-10,1,14,0,1,1,6,42,48,springer
2011-02-10,1,15,0,1,1,0,50,50,springer
2011-02-10,1,16,0,1,1,4,76,80,springer
2011-02-10,1,17,0,1,1,6,159,165,springer
2011-02-10,1,18,0,1,1,3,157,160,springer
2011-02-10,1,19,0,1,1,2,110,112,springer
2011-02-10,1,20,0,1,1,4,93,97,springer
2011-02-10,1,21,0,1,1,2,70,72,springer
2011-02-10,1,22,0,1,1,4,47,51,springer
2011-02-10,1,23,0,1,1,1,33,34,springer
2011-02-11,1,0,0,1,1,2,12,14,springer
2011-02-11,1,1,0,1,1,1,6,7,springer
2011-02-11,1,2,0,1,1,0,3,3,springer
2011-02-11,1,5,0,1,1,0,4,4,springer
2011-02-11,1,6,0,1,1,1,23,24,springer
2011-02-11,1,7,0,1,1,1,73,74,springer
2011-02-11,1,8,0,1,1,4,212,216,springer
2011-02-11,1,9,0,1,1,8,132,140,springer
2011-02-11,1,10,0,1,1,5,39,44,springer
2011-02-11,1,11,0,1,1,12,52,64,springer
2011-02-11,1,12,0,1,1,7,64,71,springer
2011-02-11,1,13,0,1,1,21,89,110,springer
2011-02-11,1,14,0,1,1,17,67,84,springer
2011-02-11,1,15,0,1,1,12,62,74,springer
2011-02-11,1,16,0,1,1,14,111,125,springer
2011-02-11,1,17,0,1,1,18,193,211,springer
2011-02-11,1,18,0,1,1,9,165,174,springer
2011-02-11,1,19,0,1,1,7,94,101,springer
2011-02-11,1,20,0,1,1,2,61,63,springer
2011-02-11,1,21,0,1,1,1,46,47,springer
2011-02-11,1,22,0,1,1,2,41,43,springer
2011-02-11,1,23,0,1,1,5,48,53,springer
2011-02-12,1,0,0,0,1,3,27,30,springer
2011-02-12,1,1,0,0,1,2,22,24,springer
2011-02-12,1,2,0,0,1,2,13,15,springer
2011-02-12,1,3,0,0,1,3,7,10,springer
2011-02-12,1,4,0,0,1,0,4,4,springer
2011-02-12,1,5,0,0,1,0,1,1,springer
2011-02-12,1,6,0,0,1,1,1,2,springer
2011-02-12,1,7,0,0,1,2,9,11,springer
2011-02-12,1,8,0,0,1,2,28,30,springer
2011-02-12,1,9,0,0,1,5,38,43,springer
2011-02-12,1,10,0,0,1,13,71,84,springer
2011-02-12,1,11,0,0,1,30,84,114,springer
2011-02-12,1,12,0,0,1,27,93,120,springer
2011-02-12,1,13,0,0,1,32,103,135,springer
2011-02-12,1,14,0,0,1,30,90,120,springer
2011-02-12,1,15,0,0,1,47,127,174,springer
2011-02-12,1,16,0,0,1,42,103,145,springer
2011-02-12,1,17,0,0,1,24,113,137,springer
2011-02-12,1,18,0,0,1,4,60,64,springer
2011-02-12,1,19,0,0,1,2,39,41,springer
2011-02-12,1,20,0,0,1,1,39,40,springer
2011-02-12,1,21,0,0,1,9,42,51,springer
2011-02-12,1,22,0,0,1,6,39,45,springer
2011-02-12,1,23,0,0,1,1,31,32,springer
2011-02-13,1,0,0,0,1,5,34,39,springer
2011-02-13,1,1,0,0,1,1,23,24,springer
2011-02-13,1,2,0,0,2,1,19,20,springer
2011-02-13,1,3,0,0,2,4,8,12,springer
2011-02-13,1,4,0,0,2,0,2,2,springer
2011-02-13,1,6,0,0,2,2,3,5,springer
2011-02-13,1,7,0,0,2,0,3,3,springer
2011-02-13,1,8,0,0,2,1,11,12,springer
2011-02-13,1,9,0,0,2,12,35,47,springer
2011-02-13,1,10,0,0,1,19,86,105,springer
2011-02-13,1,11,0,0,1,26,86,112,springer
2011-02-13,1,12,0,0,1,58,94,152,springer
2011-02-13,1,13,0,0,1,62,92,154,springer
2011-02-13,1,14,0,0,2,51,110,161,springer
2011-02-13,1,15,0,0,2,40,122,162,springer
2011-02-13,1,16,0,0,2,28,106,134,springer
2011-02-13,1,17,0,0,1,30,95,125,springer
2011-02-13,1,18,0,0,1,17,78,95,springer
2011-02-13,1,19,0,0,1,11,50,61,springer
2011-02-13,1,20,0,0,1,15,32,47,springer
2011-02-13,1,21,0,0,1,6,45,51,springer
2011-02-13,1,22,0,0,1,5,31,36,springer
2011-02-13,1,23,0,0,1,3,27,30,springer
2011-02-14,1,0,0,1,1,3,8,11,springer
2011-02-14,1,1,0,1,1,1,6,7,springer
2011-02-14,1,2,0,1,1,0,2,2,springer
2011-02-14,1,3,0,1,1,1,1,2,springer
2011-02-14,1,4,0,1,1,0,2,2,springer
2011-02-14,1,5,0,1,1,0,3,3,springer
2011-02-14,1,6,0,1,1,1,25,26,springer
2011-02-14,1,7,0,1,1,2,96,98,springer
2011-02-14,1,8,0,1,1,7,249,256,springer
2011-02-14,1,9,0,1,1,8,122,130,springer
2011-02-14,1,10,0,1,1,9,46,55,springer
2011-02-14,1,11,0,1,1,10,43,53,springer
2011-02-14,1,12,0,1,1,27,99,126,springer
2011-02-14,1,13,0,1,1,27,93,120,springer
2011-02-14,1,14,0,1,1,14,76,90,springer
2011-02-14,1,15,0,1,1,19,71,90,springer
2011-02-14,1,16,0,1,1,16,102,118,springer
2011-02-14,1,17,0,1,1,25,218,243,springer
2011-02-14,1,18,0,1,1,11,194,205,springer
2011-02-14,1,19,0,1,1,12,86,98,springer
2011-02-14,1,20,0,1,1,5,65,70,springer
2011-02-14,1,21,0,1,1,8,35,43,springer
2011-02-14,1,22,0,1,1,1,44,45,springer
2011-02-14,1,23,0,1,1,1,19,20,springer
2011-02-15,1,0,0,1,1,7,12,19,springer
2011-02-15,1,1,0,1,1,0,5,5,springer
2011-02-15,1,2,0,1,1,1,2,3,springer
2011-02-15,1,4,0,1,1,0,1,1,springer
2011-02-15,1,5,0,1,1,0,4,4,springer
2011-02-15,1,6,0,1,1,0,30,30,springer
2011-02-15,1,7,0,1,1,2,103,105,springer
2011-02-15,1,8,0,1,1,10,213,223,springer
2011-02-15,1,9,0,1,1,2,108,110,springer
2011-02-15,1,10,0,1,1,5,47,52,springer
2011-02-15,1,11,0,1,1,11,46,57,springer
2011-02-15,1,12,0,1,1,6,65,71,springer
2011-02-15,1,13,0,1,1,14,68,82,springer
2011-02-15,1,14,0,1,1,10,69,79,springer
2011-02-15,1,15,0,1,1,11,74,85,springer
2011-02-15,1,16,0,1,1,21,77,98,springer
2011-02-15,1,17,0,1,1,15,191,206,springer
2011-02-15,1,18,0,1,1,14,198,212,springer
2011-02-15,1,19,0,1,1,3,142,145,springer
2011-02-15,1,20,0,1,1,3,98,101,springer
2011-02-15,1,21,0,1,1,5,61,66,springer
2011-02-15,1,22,0,1,1,0,41,41,springer
2011-02-15,1,23,0,1,2,0,20,20,springer
2011-02-16,1,0,0,1,1,0,15,15,springer
2011-02-16,1,1,0,1,1,0,9,9,springer
2011-02-16,1,3,0,1,2,0,1,1,springer
2011-02-16,1,4,0,1,1,0,1,1,springer
2011-02-16,1,5,0,1,1,0,5,5,springer
2011-02-16,1,6,0,1,1,1,32,33,springer
2011-02-16,1,7,0,1,2,5,103,108,springer
2011-02-16,1,8,0,1,2,6,224,230,springer
2011-02-16,1,9,0,1,1,2,122,124,springer
2011-02-16,1,10,0,1,1,14,55,69,springer
2011-02-16,1,11,0,1,1,7,59,66,springer
2011-02-16,1,12,0,1,1,14,72,86,springer
2011-02-16,1,13,0,1,1,13,80,93,springer
2011-02-16,1,14,0,1,1,17,65,82,springer
2011-02-16,1,15,0,1,1,35,82,117,springer
2011-02-16,1,16,0,1,1,26,96,122,springer
2011-02-16,1,17,0,1,1,11,244,255,springer
2011-02-16,1,18,0,1,1,20,202,222,springer
2011-02-16,1,19,0,1,1,18,143,161,springer
2011-02-16,1,20,0,1,1,10,108,118,springer
2011-02-16,1,21,0,1,1,5,87,92,springer
2011-02-16,1,22,0,1,1,12,61,73,springer
2011-02-16,1,23,0,1,1,2,31,33,springer
2011-02-17,1,0,0,1,1,1,16,17,springer
2011-02-17,1,1,0,1,1,0,6,6,springer
2011-02-17,1,2,0,1,2,2,4,6,springer
2011-02-17,1,3,0,1,1,3,1,4,springer
2011-02-17,1,4,0,1,1,3,1,4,springer
2011-02-17,1,5,0,1,1,1,11,12,springer
2011-02-17,1,6,0,1,1,3,44,47,springer
2011-02-17,1,7,0,1,1,7,119,126,springer
2011-02-17,1,8,0,1,1,18,267,285,springer
2011-02-17,1,9,0,1,1,16,163,179,springer
2011-02-17,1,10,0,1,1,18,70,88,springer
2011-02-17,1,11,0,1,2,19,71,90,springer
2011-02-17,1,12,0,1,1,15,86,101,springer
2011-02-17,1,13,0,1,1,15,108,123,springer
2011-02-17,1,14,0,1,1,26,55,81,springer
2011-02-17,1,15,0,1,1,15,91,106,springer
2011-02-17,1,16,0,1,2,29,117,146,springer
2011-02-17,1,17,0,1,2,18,256,274,springer
2011-02-17,1,18,0,1,2,11,211,222,springer
2011-02-17,1,19,0,1,1,14,161,175,springer
2011-02-17,1,20,0,1,1,8,131,139,springer
2011-02-17,1,21,0,1,1,5,119,124,springer
2011-02-17,1,22,0,1,1,8,68,76,springer
2011-02-17,1,23,0,1,1,4,40,44,springer
2011-02-18,1,0,0,1,1,12,20,32,springer
2011-02-18,1,1,0,1,1,1,7,8,springer
2011-02-18,1,2,0,1,1,2,5,7,springer
2011-02-18,1,3,0,1,1,2,6,8,springer
2011-02-18,1,4,0,1,1,0,1,1,springer
2011-02-18,1,5,0,1,2,1,6,7,springer
2011-02-18,1,6,0,1,2,2,48,50,springer
2011-02-18,1,7,0,1,2,8,108,116,springer
2011-02-18,1,8,0,1,2,26,246,272,springer
2011-02-18,1,9,0,1,2,15,154,169,springer
2011-02-18,1,10,0,1,2,17,78,95,springer
2011-02-18,1,11,0,1,1,31,82,113,springer
2011-02-18,1,12,0,1,1,59,126,185,springer
2011-02-18,1,13,0,1,1,45,131,176,springer
2011-02-18,1,14,0,1,1,73,118,191,springer
2011-02-18,1,15,0,1,1,55,117,172,springer
2011-02-18,1,16,0,1,1,68,164,232,springer
2011-02-18,1,17,0,1,1,52,275,327,springer
2011-02-18,1,18,0,1,1,29,195,224,springer
2011-02-18,1,19,0,1,1,16,146,162,springer
2011-02-18,1,20,0,1,1,19,105,124,springer
2011-02-18,1,21,0,1,1,11,61,72,springer
2011-02-18,1,22,0,1,1,19,88,107,springer
2011-02-18,1,23,0,1,1,16,61,77,springer
2011-02-19,1,0,0,0,1,6,23,29,springer
2011-02-19,1,1,0,0,1,10,21,31,springer
2011-02-19,1,2,0,0,1,3,14,17,springer
2011-02-19,1,3,0,0,1,0,7,7,springer
2011-02-19,1,4,0,0,1,0,3,3,springer
2011-02-19,1,5,0,0,1,0,3,3,springer
2011-02-19,1,6,0,0,1,3,3,6,springer
2011-02-19,1,7,0,0,1,6,16,22,springer
2011-02-19,1,8,0,0,1,9,36,45,springer
2011-02-19,1,9,0,0,1,18,37,55,springer
2011-02-19,1,10,0,0,1,34,72,106,springer
2011-02-19,1,11,0,0,1,47,76,123,springer
2011-02-19,1,12,0,0,1,38,81,119,springer
2011-02-19,1,13,0,0,1,52,103,155,springer
2011-02-19,1,14,0,0,1,102,94,196,springer
2011-02-19,1,15,0,0,1,84,87,171,springer
2011-02-19,1,16,0,0,1,39,81,120,springer
2011-02-19,1,17,0,0,1,36,91,127,springer
2011-02-19,1,18,0,0,1,21,67,88,springer
2011-02-19,1,19,0,0,1,5,54,59,springer
2011-02-19,1,20,0,0,1,9,38,47,springer
2011-02-19,1,21,0,0,1,4,29,33,springer
2011-02-19,1,22,0,0,1,2,42,44,springer
2011-02-19,1,23,0,0,1,4,25,29,springer
2011-02-20,1,0,0,0,1,3,14,17,springer
2011-02-20,1,1,0,0,1,5,11,16,springer
2011-02-20,1,2,0,0,1,0,17,17,springer
2011-02-20,1,3,0,0,1,9,9,18,springer
2011-02-20,1,4,0,0,1,0,1,1,springer
2011-02-20,1,6,0,0,1,1,1,2,springer
2011-02-20,1,7,0,0,1,0,2,2,springer
2011-02-20,1,8,0,0,1,2,22,24,springer
2011-02-20,1,9,0,0,1,7,48,55,springer
2011-02-20,1,10,0,0,2,34,70,104,springer
2011-02-20,1,11,0,0,2,72,89,161,springer
2011-02-20,1,12,0,0,1,62,120,182,springer
2011-02-20,1,13,0,0,1,76,122,198,springer
2011-02-20,1,14,0,0,1,108,104,212,springer
2011-02-20,1,15,0,0,1,66,102,168,springer
2011-02-20,1,16,0,0,1,59,88,147,springer
2011-02-20,1,17,0,0,1,60,86,146,springer
2011-02-20,1,18,0,0,2,30,71,101,springer
2011-02-20,1,19,0,0,2,3,39,42,springer
2011-02-20,1,20,0,0,2,12,30,42,springer
2011-02-20,1,21,0,0,2,17,39,56,springer
2011-02-20,1,22,0,0,2,4,43,47,springer
2011-02-20,1,23,0,0,2,9,45,54,springer
2011-02-21,1,0,1,0,2,7,30,37,springer
2011-02-21,1,1,1,0,2,2,11,13,springer
2011-02-21,1,2,1,0,2,1,3,4,springer
2011-02-21,1,3,1,0,2,2,3,5,springer
2011-02-21,1,4,1,0,1,1,0,1,springer
2011-02-21,1,5,1,0,2,1,2,3,springer
2011-02-21,1,6,1,0,2,2,6,8,springer
2011-02-21,1,7,1,0,2,3,16,19,springer
2011-02-21,1,8,1,0,2,7,56,63,springer
2011-02-21,1,9,1,0,2,11,46,57,springer
2011-02-21,1,10,1,0,2,29,52,81,springer
2011-02-21,1,11,1,0,2,20,70,90,springer
2011-02-21,1,12,1,0,2,26,67,93,springer
2011-02-21,1,13,1,0,3,28,75,103,springer
2011-02-21,1,14,1,0,2,15,101,116,springer
2011-02-21,1,15,1,0,2,11,76,87,springer
2011-02-21,1,16,1,0,3,8,48,56,springer
2011-02-21,1,17,1,0,2,18,62,80,springer
2011-02-21,1,18,1,0,2,2,64,66,springer
2011-02-21,1,19,1,0,2,0,49,49,springer
2011-02-21,1,20,1,0,3,0,29,29,springer
2011-02-21,1,21,1,0,3,1,33,34,springer
2011-02-21,1,22,1,0,3,0,11,11,springer
2011-02-21,1,23,1,0,3,0,2,2,springer
2011-02-22,1,6,0,1,2,0,7,7,springer
2011-02-22,1,7,0,1,2,0,40,40,springer
2011-02-22,1,8,0,1,2,7,107,114,springer
2011-02-22,1,9,0,1,2,5,101,106,springer
2011-02-22,1,10,0,1,1,0,44,44,springer
2011-02-22,1,11,0,1,1,7,43,50,springer
2011-02-22,1,12,0,1,1,7,48,55,springer
2011-02-22,1,13,0,1,1,3,52,55,springer
2011-02-22,1,14,0,1,1,9,49,58,springer
2011-02-22,1,15,0,1,1,2,67,69,springer
2011-02-22,1,16,0,1,1,7,79,86,springer
2011-02-22,1,17,0,1,1,8,188,196,springer
2011-02-22,1,18,0,1,1,6,161,167,springer
2011-02-22,1,19,0,1,1,4,114,118,springer
2011-02-22,1,20,0,1,1,3,102,105,springer
2011-02-22,1,21,0,1,1,2,80,82,springer
2011-02-22,1,22,0,1,1,1,76,77,springer
2011-02-22,1,23,0,1,1,3,18,21,springer
2011-02-23,1,0,0,1,1,0,6,6,springer
2011-02-23,1,1,0,1,1,0,4,4,springer
2011-02-23,1,2,0,1,1,0,1,1,springer
2011-02-23,1,3,0,1,1,0,2,2,springer
2011-02-23,1,5,0,1,1,0,8,8,springer
2011-02-23,1,6,0,1,1,0,36,36,springer
2011-02-23,1,7,0,1,1,2,94,96,springer
2011-02-23,1,8,0,1,1,8,227,235,springer
2011-02-23,1,9,0,1,1,9,130,139,springer
2011-02-23,1,10,0,1,1,4,47,51,springer
2011-02-23,1,11,0,1,1,16,53,69,springer
2011-02-23,1,12,0,1,1,11,56,67,springer
2011-02-23,1,13,0,1,1,9,78,87,springer
2011-02-23,1,14,0,1,1,17,61,78,springer
2011-02-23,1,15,0,1,1,18,54,72,springer
2011-02-23,1,16,0,1,1,15,79,94,springer
2011-02-23,1,17,0,1,1,15,207,222,springer
2011-02-23,1,18,0,1,1,3,206,209,springer
2011-02-23,1,19,0,1,1,6,135,141,springer
2011-02-23,1,20,0,1,1,2,107,109,springer
2011-02-23,1,21,0,1,1,2,89,91,springer
2011-02-23,1,22,0,1,1,1,60,61,springer
2011-02-23,1,23,0,1,1,1,38,39,springer
2011-02-24,1,0,0,1,1,0,11,11,springer
2011-02-24,1,1,0,1,1,0,7,7,springer
2011-02-24,1,2,0,1,1,0,4,4,springer
2011-02-24,1,3,0,1,1,0,2,2,springer
2011-02-24,1,5,0,1,1,1,3,4,springer
2011-02-24,1,6,0,1,1,0,58,58,springer
2011-02-24,1,7,0,1,1,0,104,104,springer
2011-02-24,1,8,0,1,1,8,244,252,springer
2011-02-24,1,9,0,1,2,4,133,137,springer
2011-02-24,1,10,0,1,2,8,49,57,springer
2011-02-24,1,11,0,1,2,8,71,79,springer
2011-02-24,1,12,0,1,2,10,85,95,springer
2011-02-24,1,13,0,1,2,16,72,88,springer
2011-02-24,1,14,0,1,2,2,67,69,springer
2011-02-24,1,15,0,1,3,5,58,63,springer
2011-02-24,1,16,0,1,3,4,67,71,springer
2011-02-24,1,17,0,1,3,9,168,177,springer
2011-02-24,1,18,0,1,2,5,132,137,springer
2011-02-24,1,19,0,1,3,3,112,115,springer
2011-02-24,1,20,0,1,2,2,87,89,springer
2011-02-24,1,21,0,1,2,7,76,83,springer
2011-02-24,1,22,0,1,3,5,50,55,springer
2011-02-24,1,23,0,1,2,3,47,50,springer
2011-02-25,1,0,0,1,3,1,8,9,springer
2011-02-25,1,1,0,1,2,1,9,10,springer
2011-02-25,1,2,0,1,2,0,3,3,springer
2011-02-25,1,3,0,1,2,1,1,2,springer
2011-02-25,1,5,0,1,2,1,5,6,springer
2011-02-25,1,6,0,1,3,0,11,11,springer
2011-02-25,1,7,0,1,3,1,34,35,springer
2011-02-25,1,8,0,1,3,3,70,73,springer
2011-02-25,1,9,0,1,3,3,111,114,springer
2011-02-25,1,10,0,1,3,7,42,49,springer
2011-02-25,1,11,0,1,1,9,50,59,springer
2011-02-25,1,12,0,1,3,20,95,115,springer
2011-02-25,1,13,0,1,3,6,77,83,springer
2011-02-25,1,14,0,1,3,14,71,85,springer
2011-02-25,1,15,0,1,1,5,50,55,springer
2011-02-25,1,16,0,1,1,11,91,102,springer
2011-02-25,1,17,0,1,1,8,181,189,springer
2011-02-25,1,18,0,1,1,7,150,157,springer
2011-02-25,1,19,0,1,1,4,86,90,springer
2011-02-25,1,20,0,1,1,2,60,62,springer
2011-02-25,1,21,0,1,1,7,56,63,springer
2011-02-25,1,22,0,1,1,7,43,50,springer
2011-02-25,1,23,0,1,1,2,37,39,springer
2011-02-26,1,0,0,0,1,3,25,28,springer
2011-02-26,1,1,0,0,1,2,25,27,springer
2011-02-26,1,2,0,0,1,3,9,12,springer
2011-02-26,1,3,0,0,1,1,7,8,springer
2011-02-26,1,4,0,0,2,1,1,2,springer
2011-02-26,1,5,0,0,2,1,9,10,springer
2011-02-26,1,6,0,0,1,1,6,7,springer
2011-02-26,1,7,0,0,1,1,21,22,springer
2011-02-26,1,8,0,0,2,2,55,57,springer
2011-02-26,1,9,0,0,2,9,65,74,springer
2011-02-26,1,10,0,0,2,14,71,85,springer
2011-02-26,1,11,0,0,1,26,100,126,springer
2011-02-26,1,12,0,0,2,45,115,160,springer
2011-02-26,1,13,0,0,2,38,136,174,springer
2011-02-26,1,14,0,0,2,57,154,211,springer
2011-02-26,1,15,0,0,2,40,125,165,springer
2011-02-26,1,16,0,0,1,41,130,171,springer
2011-02-26,1,17,0,0,1,53,130,183,springer
2011-02-26,1,18,0,0,1,26,111,137,springer
2011-02-26,1,19,0,0,1,30,64,94,springer
2011-02-26,1,20,0,0,1,8,60,68,springer
2011-02-26,1,21,0,0,1,9,59,68,springer
2011-02-26,1,22,0,0,1,8,38,46,springer
2011-02-26,1,23,0,0,1,5,29,34,springer
2011-02-27,1,0,0,0,1,8,26,34,springer
2011-02-27,1,1,0,0,1,7,30,37,springer
2011-02-27,1,2,0,0,1,2,20,22,springer
2011-02-27,1,3,0,0,1,3,8,11,springer
2011-02-27,1,4,0,0,1,0,2,2,springer
2011-02-27,1,6,0,0,1,2,1,3,springer
2011-02-27,1,7,0,0,1,6,8,14,springer
2011-02-27,1,8,0,0,1,9,26,35,springer
2011-02-27,1,9,0,0,1,17,42,59,springer
2011-02-27,1,10,0,0,1,24,79,103,springer
2011-02-27,1,11,0,0,1,33,92,125,springer
2011-02-27,1,12,0,0,1,61,132,193,springer
2011-02-27,1,13,0,0,1,90,169,259,springer
2011-02-27,1,14,0,0,1,105,177,282,springer
2011-02-27,1,15,0,0,1,98,163,261,springer
2011-02-27,1,16,0,0,1,98,170,268,springer
2011-02-27,1,17,0,0,1,66,121,187,springer
2011-02-27,1,18,0,0,1,24,103,127,springer
2011-02-27,1,19,0,0,1,16,86,102,springer
2011-02-27,1,20,0,0,1,9,72,81,springer
2011-02-27,1,21,0,0,1,8,61,69,springer
2011-02-27,1,22,0,0,2,2,67,69,springer
2011-02-27,1,23,0,0,2,6,53,59,springer
2011-02-28,1,0,0,1,2,5,25,30,springer
2011-02-28,1,1,0,1,3,1,7,8,springer
2011-02-28,1,3,0,1,3,0,1,1,springer
2011-02-28,1,5,0,1,2,1,4,5,springer
2011-02-28,1,6,0,1,2,1,27,28,springer
2011-02-28,1,7,0,1,2,2,90,92,springer
2011-02-28,1,8,0,1,2,13,242,255,springer
2011-02-28,1,9,0,1,1,15,127,142,springer
2011-02-28,1,10,0,1,2,13,79,92,springer
2011-02-28,1,11,0,1,2,13,74,87,springer
2011-02-28,1,12,0,1,2,0,36,36,springer
2011-02-28,1,13,0,1,3,1,31,32,springer
2011-02-28,1,14,0,1,3,1,24,25,springer
2011-02-28,1,15,0,1,3,0,35,35,springer
2011-02-28,1,16,0,1,3,2,40,42,springer
2011-02-28,1,17,0,1,3,2,77,79,springer
2011-02-28,1,18,0,1,3,4,127,131,springer
2011-02-28,1,19,0,1,3,1,79,80,springer
2011-02-28,1,20,0,1,3,0,45,45,springer
2011-02-28,1,21,0,1,2,2,78,80,springer
2011-02-28,1,22,0,1,3,4,72,76,springer
2011-02-28,1,23,0,1,2,0,45,45,springer
2011-03-01,1,0,0,1,1,0,7,7,springer
2011-03-01,1,1,0,1,1,0,3,3,springer
2011-03-01,1,2,0,1,1,0,4,4,springer
2011-03-01,1,3,0,1,1,0,2,2,springer
2011-03-01,1,4,0,1,1,0,1,1,springer
2011-03-01,1,5,0,1,1,1,1,2,springer
2011-03-01,1,6,0,1,1,0,46,46,springer
2011-03-01,1,7,0,1,1,2,105,107,springer
2011-03-01,1,8,0,1,1,10,204,214,springer
2011-03-01,1,9,0,1,1,8,116,124,springer
2011-03-01,1,10,0,1,1,13,55,68,springer
2011-03-01,1,11,0,1,1,8,48,56,springer
2011-03-01,1,12,0,1,1,6,80,86,springer
2011-03-01,1,13,0,1,1,13,65,78,springer
2011-03-01,1,14,0,1,1,18,61,79,springer
2011-03-01,1,15,0,1,1,7,57,64,springer
2011-03-01,1,16,0,1,1,10,92,102,springer
2011-03-01,1,17,0,1,1,12,230,242,springer
2011-03-01,1,18,0,1,1,10,214,224,springer
2011-03-01,1,19,0,1,1,4,115,119,springer
2011-03-01,1,20,0,1,1,2,86,88,springer
2011-03-01,1,21,0,1,1,8,55,63,springer
2011-03-01,1,22,0,1,1,3,44,47,springer
2011-03-01,1,23,0,1,1,2,23,25,springer
2011-03-02,1,0,0,1,1,3,5,8,springer
2011-03-02,1,1,0,1,1,0,4,4,springer
2011-03-02,1,2,0,1,1,0,2,2,springer
2011-03-02,1,3,0,1,1,3,1,4,springer
2011-03-02,1,4,0,1,1,1,0,1,springer
2011-03-02,1,5,0,1,1,0,5,5,springer
2011-03-02,1,6,0,1,1,1,39,40,springer
2011-03-02,1,7,0,1,1,2,108,110,springer
2011-03-02,1,8,0,1,1,13,243,256,springer
2011-03-02,1,9,0,1,1,7,141,148,springer
2011-03-02,1,10,0,1,1,11,65,76,springer
2011-03-02,1,11,0,1,1,8,65,73,springer
2011-03-02,1,12,0,1,1,20,62,82,springer
2011-03-02,1,13,0,1,1,35,90,125,springer
2011-03-02,1,14,0,1,1,21,75,96,springer
2011-03-02,1,15,0,1,1,19,91,110,springer
2011-03-02,1,16,0,1,1,27,112,139,springer
2011-03-02,1,17,0,1,1,30,238,268,springer
2011-03-02,1,18,0,1,1,8,193,201,springer
2011-03-02,1,19,0,1,1,6,144,150,springer
2011-03-02,1,20,0,1,1,9,86,95,springer
2011-03-02,1,21,0,1,1,3,68,71,springer
2011-03-02,1,22,0,1,1,4,44,48,springer
2011-03-02,1,23,0,1,1,0,22,22,springer
2011-03-03,1,0,0,1,1,3,10,13,springer
2011-03-03,1,1,0,1,1,0,1,1,springer
2011-03-03,1,2,0,1,1,1,2,3,springer
2011-03-03,1,3,0,1,1,0,1,1,springer
2011-03-03,1,4,0,1,1,0,1,1,springer
2011-03-03,1,5,0,1,1,1,7,8,springer
2011-03-03,1,6,0,1,1,1,34,35,springer
2011-03-03,1,7,0,1,1,1,110,111,springer
2011-03-03,1,8,0,1,1,4,216,220,springer
2011-03-03,1,9,0,1,1,10,135,145,springer
2011-03-03,1,10,0,1,1,7,49,56,springer
2011-03-03,1,11,0,1,1,10,40,50,springer
2011-03-03,1,12,0,1,1,7,65,72,springer
2011-03-03,1,13,0,1,1,13,67,80,springer
2011-03-03,1,14,0,1,1,18,60,78,springer
2011-03-03,1,15,0,1,1,6,62,68,springer
2011-03-03,1,16,0,1,1,6,65,71,springer
2011-03-03,1,17,0,1,1,17,185,202,springer
2011-03-03,1,18,0,1,1,6,161,167,springer
2011-03-03,1,19,0,1,1,5,101,106,springer
2011-03-03,1,20,0,1,1,1,69,70,springer
2011-03-03,1,21,0,1,1,3,48,51,springer
2011-03-03,1,22,0,1,1,3,50,53,springer
2011-03-03,1,23,0,1,2,0,23,23,springer
2011-03-04,1,0,0,1,2,0,12,12,springer
2011-03-04,1,1,0,1,2,0,4,4,springer
2011-03-04,1,2,0,1,2,0,2,2,springer
2011-03-04,1,3,0,1,2,0,1,1,springer
2011-03-04,1,4,0,1,2,1,0,1,springer
2011-03-04,1,5,0,1,2,0,7,7,springer
2011-03-04,1,6,0,1,2,1,28,29,springer
2011-03-04,1,7,0,1,1,0,83,83,springer
2011-03-04,1,8,0,1,1,6,222,228,springer
2011-03-04,1,9,0,1,1,12,138,150,springer
2011-03-04,1,10,0,1,1,10,56,66,springer
2011-03-04,1,11,0,1,1,16,73,89,springer
2011-03-04,1,12,0,1,1,10,87,97,springer
2011-03-04,1,13,0,1,1,13,74,87,springer
2011-03-04,1,14,0,1,1,30,65,95,springer
2011-03-04,1,15,0,1,1,31,75,106,springer
2011-03-04,1,16,0,1,1,17,101,118,springer
2011-03-04,1,17,0,1,2,22,206,228,springer
2011-03-04,1,18,0,1,2,15,172,187,springer
2011-03-04,1,19,0,1,1,5,102,107,springer
2011-03-04,1,20,0,1,2,9,78,87,springer
2011-03-04,1,21,0,1,2,6,64,70,springer
2011-03-04,1,22,0,1,1,4,40,44,springer
2011-03-04,1,23,0,1,2,6,40,46,springer
2011-03-05,1,0,0,0,2,4,15,19,springer
2011-03-05,1,1,0,0,2,5,20,25,springer
2011-03-05,1,2,0,0,2,5,15,20,springer
2011-03-05,1,3,0,0,2,0,2,2,springer
2011-03-05,1,4,0,0,2,0,1,1,springer
2011-03-05,1,5,0,0,2,0,3,3,springer
2011-03-05,1,6,0,0,2,1,3,4,springer
2011-03-05,1,7,0,0,2,5,10,15,springer
2011-03-05,1,8,0,0,2,11,34,45,springer
2011-03-05,1,9,0,0,2,15,48,63,springer
2011-03-05,1,10,0,0,2,34,69,103,springer
2011-03-05,1,11,0,0,2,43,116,159,springer
2011-03-05,1,12,0,0,2,46,121,167,springer
2011-03-05,1,13,0,0,2,60,130,190,springer
2011-03-05,1,14,0,0,2,80,118,198,springer
2011-03-05,1,15,0,0,2,83,122,205,springer
2011-03-05,1,16,0,0,2,74,130,204,springer
2011-03-05,1,17,0,0,2,60,104,164,springer
2011-03-05,1,18,0,0,2,37,115,152,springer
2011-03-05,1,19,0,0,2,27,62,89,springer
2011-03-05,1,20,0,0,2,12,58,70,springer
2011-03-05,1,21,0,0,2,12,60,72,springer
2011-03-05,1,22,0,0,2,16,47,63,springer
2011-03-05,1,23,0,0,2,10,34,44,springer
2011-03-06,1,0,0,0,2,11,41,52,springer
2011-03-06,1,1,0,0,2,12,27,39,springer
2011-03-06,1,2,0,0,2,5,27,32,springer
2011-03-06,1,3,0,0,2,2,9,11,springer
2011-03-06,1,4,0,0,2,0,3,3,springer
2011-03-06,1,6,0,0,2,1,1,2,springer
2011-03-06,1,7,0,0,3,0,5,5,springer
2011-03-06,1,8,0,0,2,1,8,9,springer
2011-03-06,1,9,0,0,2,4,18,22,springer
2011-03-06,1,10,0,0,2,4,27,31,springer
2011-03-06,1,11,0,0,2,18,44,62,springer
2011-03-06,1,12,0,0,2,10,69,79,springer
2011-03-06,1,13,0,0,2,22,83,105,springer
2011-03-06,1,14,0,0,3,12,27,39,springer
2011-03-06,1,15,0,0,3,3,4,7,springer
2011-03-06,1,16,0,0,3,3,8,11,springer
2011-03-06,1,17,0,0,3,2,23,25,springer
2011-03-06,1,18,0,0,3,0,23,23,springer
2011-03-06,1,19,0,0,3,0,11,11,springer
2011-03-06,1,20,0,0,3,3,8,11,springer
2011-03-06,1,21,0,0,3,1,6,7,springer
2011-03-06,1,22,0,0,2,0,10,10,springer
2011-03-06,1,23,0,0,2,0,9,9,springer
2011-03-07,1,0,0,1,3,0,4,4,springer
2011-03-07,1,1,0,1,3,0,2,2,springer
2011-03-07,1,3,0,1,1,0,1,1,springer
2011-03-07,1,4,0,1,1,1,0,1,springer
2011-03-07,1,5,0,1,1,0,1,1,springer
2011-03-07,1,6,0,1,1,3,31,34,springer
2011-03-07,1,7,0,1,1,3,88,91,springer
2011-03-07,1,8,0,1,1,11,200,211,springer
2011-03-07,1,9,0,1,1,5,129,134,springer
2011-03-07,1,10,0,1,1,15,43,58,springer
2011-03-07,1,11,0,1,1,19,41,60,springer
2011-03-07,1,12,0,1,1,28,68,96,springer
2011-03-07,1,13,0,1,1,16,54,70,springer
2011-03-07,1,14,0,1,1,21,56,77,springer
2011-03-07,1,15,0,1,1,32,64,96,springer
2011-03-07,1,16,0,1,1,26,96,122,springer
2011-03-07,1,17,0,1,1,27,206,233,springer
2011-03-07,1,18,0,1,1,19,214,233,springer
2011-03-07,1,19,0,1,1,11,134,145,springer
2011-03-07,1,20,0,1,1,5,87,92,springer
2011-03-07,1,21,0,1,1,1,53,54,springer
2011-03-07,1,22,0,1,1,1,34,35,springer
2011-03-07,1,23,0,1,1,0,22,22,springer
2011-03-08,1,0,0,1,1,1,9,10,springer
2011-03-08,1,1,0,1,1,0,4,4,springer
2011-03-08,1,2,0,1,1,1,0,1,springer
2011-03-08,1,3,0,1,1,5,2,7,springer
2011-03-08,1,4,0,1,1,0,2,2,springer
2011-03-08,1,5,0,1,1,2,8,10,springer
2011-03-08,1,6,0,1,1,3,42,45,springer
2011-03-08,1,7,0,1,1,9,119,128,springer
2011-03-08,1,8,0,1,1,10,247,257,springer
2011-03-08,1,9,0,1,1,11,140,151,springer
2011-03-08,1,10,0,1,2,25,46,71,springer
2011-03-08,1,11,0,1,2,26,52,78,springer
2011-03-08,1,12,0,1,2,29,70,99,springer
2011-03-08,1,13,0,1,2,25,73,98,springer
2011-03-08,1,14,0,1,2,16,56,72,springer
2011-03-08,1,15,0,1,2,35,77,112,springer
2011-03-08,1,16,0,1,1,26,82,108,springer
2011-03-08,1,17,0,1,1,39,209,248,springer
2011-03-08,1,18,0,1,1,21,214,235,springer
2011-03-08,1,19,0,1,1,9,141,150,springer
2011-03-08,1,20,0,1,1,2,74,76,springer
2011-03-08,1,21,0,1,1,7,68,75,springer
2011-03-08,1,22,0,1,1,11,44,55,springer
2011-03-08,1,23,0,1,1,3,38,41,springer
2011-03-09,1,0,0,1,1,0,9,9,springer
2011-03-09,1,1,0,1,1,0,4,4,springer
2011-03-09,1,2,0,1,1,1,1,2,springer
2011-03-09,1,3,0,1,1,1,2,3,springer
2011-03-09,1,4,0,1,1,0,2,2,springer
2011-03-09,1,5,0,1,2,1,7,8,springer
2011-03-09,1,6,0,1,2,5,44,49,springer
2011-03-09,1,7,0,1,2,18,123,141,springer
2011-03-09,1,8,0,1,2,11,238,249,springer
2011-03-09,1,9,0,1,2,5,136,141,springer
2011-03-09,1,10,0,1,2,8,49,57,springer
2011-03-09,1,11,0,1,2,15,44,59,springer
2011-03-09,1,12,0,1,2,14,84,98,springer
2011-03-09,1,13,0,1,2,17,82,99,springer
2011-03-09,1,14,0,1,2,10,61,71,springer
2011-03-09,1,15,0,1,2,15,64,79,springer
2011-03-09,1,16,0,1,2,10,102,112,springer
2011-03-09,1,17,0,1,2,18,176,194,springer
2011-03-09,1,18,0,1,2,12,176,188,springer
2011-03-09,1,19,0,1,2,11,123,134,springer
2011-03-09,1,20,0,1,2,4,87,91,springer
2011-03-09,1,21,0,1,2,10,52,62,springer
2011-03-09,1,22,0,1,3,4,17,21,springer
2011-03-09,1,23,0,1,3,1,17,18,springer
2011-03-10,1,0,0,1,3,3,0,3,springer
2011-03-10,1,1,0,1,3,0,2,2,springer
2011-03-10,1,2,0,1,3,0,1,1,springer
2011-03-10,1,5,0,1,3,1,2,3,springer
2011-03-10,1,6,0,1,3,0,12,12,springer
2011-03-10,1,7,0,1,3,1,36,37,springer
2011-03-10,1,8,0,1,3,1,43,44,springer
2011-03-10,1,9,0,1,3,1,23,24,springer
2011-03-10,1,10,0,1,3,0,17,17,springer
2011-03-10,1,11,0,1,3,6,5,11,springer
2011-03-10,1,12,0,1,3,4,30,34,springer
2011-03-10,1,13,0,1,3,1,11,12,springer
2011-03-10,1,14,0,1,3,0,12,12,springer
2011-03-10,1,15,0,1,3,3,11,14,springer
2011-03-10,1,16,0,1,3,1,20,21,springer
2011-03-10,1,17,0,1,2,2,109,111,springer
2011-03-10,1,18,0,1,3,2,80,82,springer
2011-03-10,1,19,0,1,3,5,51,56,springer
2011-03-10,1,20,0,1,3,9,29,38,springer
2011-03-10,1,21,0,1,3,1,27,28,springer
2011-03-10,1,22,0,1,2,4,30,34,springer
2011-03-10,1,23,0,1,3,1,26,27,springer
2011-03-11,1,0,0,1,2,0,6,6,springer
2011-03-11,1,1,0,1,3,0,8,8,springer
2011-03-11,1,2,0,1,3,2,3,5,springer
2011-03-11,1,3,0,1,2,0,2,2,springer
2011-03-11,1,5,0,1,1,1,6,7,springer
2011-03-11,1,6,0,1,1,1,31,32,springer
2011-03-11,1,7,0,1,1,10,104,114,springer
2011-03-11,1,8,0,1,1,15,244,259,springer
2011-03-11,1,9,0,1,2,13,143,156,springer
2011-03-11,1,10,0,1,2,18,60,78,springer
2011-03-11,1,11,0,1,2,14,67,81,springer
2011-03-11,1,12,0,1,2,15,96,111,springer
2011-03-11,1,13,0,1,1,15,92,107,springer
2011-03-11,1,14,0,1,2,25,64,89,springer
2011-03-11,1,15,0,1,2,21,64,85,springer
2011-03-11,1,16,0,1,2,18,95,113,springer
2011-03-11,1,17,0,1,1,23,200,223,springer
2011-03-11,1,18,0,1,1,19,134,153,springer
2011-03-11,1,19,0,1,1,7,111,118,springer
2011-03-11,1,20,0,1,1,6,70,76,springer
2011-03-11,1,21,0,1,2,10,43,53,springer
2011-03-11,1,22,0,1,1,11,53,64,springer
2011-03-11,1,23,0,1,1,3,34,37,springer
2011-03-12,1,0,0,0,1,4,30,34,springer
2011-03-12,1,1,0,0,1,3,15,18,springer
2011-03-12,1,2,0,0,1,0,14,14,springer
2011-03-12,1,3,0,0,1,1,6,7,springer
2011-03-12,1,4,0,0,1,0,1,1,springer
2011-03-12,1,5,0,0,1,0,2,2,springer
2011-03-12,1,6,0,0,1,2,2,4,springer
2011-03-12,1,7,0,0,1,4,19,23,springer
2011-03-12,1,8,0,0,1,9,44,53,springer
2011-03-12,1,9,0,0,1,25,76,101,springer
2011-03-12,1,10,0,0,1,21,78,99,springer
2011-03-12,1,11,0,0,1,36,83,119,springer
2011-03-12,1,12,0,0,1,51,107,158,springer
2011-03-12,1,13,0,0,1,62,95,157,springer
2011-03-12,1,14,0,0,1,70,96,166,springer
2011-03-12,1,15,0,0,1,81,101,182,springer
2011-03-12,1,16,0,0,1,100,144,244,springer
2011-03-12,1,17,0,0,1,99,114,213,springer
2011-03-12,1,18,0,0,1,54,91,145,springer
2011-03-12,1,19,0,0,1,26,86,112,springer
2011-03-12,1,20,0,0,1,22,64,86,springer
2011-03-12,1,21,0,0,1,36,46,82,springer
2011-03-12,1,22,0,0,1,7,56,63,springer
2011-03-12,1,23,0,0,1,11,38,49,springer
2011-03-13,1,0,0,0,1,3,35,38,springer
2011-03-13,1,1,0,0,1,10,23,33,springer
2011-03-13,1,3,0,0,1,6,17,23,springer
2011-03-13,1,4,0,0,1,4,9,13,springer
2011-03-13,1,5,0,0,1,0,3,3,springer
2011-03-13,1,6,0,0,1,0,2,2,springer
2011-03-13,1,7,0,0,1,2,8,10,springer
2011-03-13,1,8,0,0,1,11,23,34,springer
2011-03-13,1,9,0,0,1,8,36,44,springer
2011-03-13,1,10,0,0,1,36,86,122,springer
2011-03-13,1,11,0,0,1,88,93,181,springer
2011-03-13,1,12,0,0,1,74,120,194,springer
2011-03-13,1,13,0,0,1,97,124,221,springer
2011-03-13,1,14,0,0,1,144,106,250,springer
2011-03-13,1,15,0,0,1,149,155,304,springer
2011-03-13,1,16,0,0,1,124,132,256,springer
2011-03-13,1,17,0,0,1,98,143,241,springer
2011-03-13,1,18,0,0,1,55,92,147,springer
2011-03-13,1,19,0,0,1,28,73,101,springer
2011-03-13,1,20,0,0,1,23,54,77,springer
2011-03-13,1,21,0,0,1,9,49,58,springer
2011-03-13,1,22,0,0,1,8,29,37,springer
2011-03-13,1,23,0,0,1,5,23,28,springer
2011-03-14,1,0,0,1,1,4,7,11,springer
2011-03-14,1,1,0,1,1,0,1,1,springer
2011-03-14,1,2,0,1,1,0,1,1,springer
2011-03-14,1,3,0,1,1,0,3,3,springer
2011-03-14,1,5,0,1,1,0,8,8,springer
2011-03-14,1,6,0,1,1,1,27,28,springer
2011-03-14,1,7,0,1,2,4,84,88,springer
2011-03-14,1,8,0,1,2,24,217,241,springer
2011-03-14,1,9,0,1,1,13,127,140,springer
2011-03-14,1,10,0,1,1,27,57,84,springer
2011-03-14,1,11,0,1,1,26,45,71,springer
2011-03-14,1,12,0,1,1,40,54,94,springer
2011-03-14,1,13,0,1,1,24,51,75,springer
2011-03-14,1,14,0,1,2,27,52,79,springer
2011-03-14,1,15,0,1,1,24,77,101,springer
2011-03-14,1,16,0,1,1,27,80,107,springer
2011-03-14,1,17,0,1,1,42,229,271,springer
2011-03-14,1,18,0,1,1,25,210,235,springer
2011-03-14,1,19,0,1,1,17,133,150,springer
2011-03-14,1,20,0,1,1,23,106,129,springer
2011-03-14,1,21,0,1,1,5,58,63,springer
2011-03-14,1,22,0,1,1,4,43,47,springer
2011-03-14,1,23,0,1,1,2,17,19,springer
2011-03-15,1,0,0,1,1,7,7,14,springer
2011-03-15,1,1,0,1,1,4,6,10,springer
2011-03-15,1,2,0,1,1,1,2,3,springer
2011-03-15,1,4,0,1,1,1,1,2,springer
2011-03-15,1,5,0,1,1,0,11,11,springer
2011-03-15,1,6,0,1,1,3,32,35,springer
2011-03-15,1,7,0,1,1,10,109,119,springer
2011-03-15,1,8,0,1,1,23,259,282,springer
2011-03-15,1,9,0,1,2,10,147,157,springer
2011-03-15,1,10,0,1,2,22,56,78,springer
2011-03-15,1,11,0,1,2,27,51,78,springer
2011-03-15,1,12,0,1,2,32,70,102,springer
2011-03-15,1,13,0,1,2,23,74,97,springer
2011-03-15,1,14,0,1,2,14,74,88,springer
2011-03-15,1,15,0,1,2,24,66,90,springer
2011-03-15,1,16,0,1,2,21,93,114,springer
2011-03-15,1,17,0,1,2,22,195,217,springer
2011-03-15,1,18,0,1,2,18,207,225,springer
2011-03-15,1,19,0,1,2,14,138,152,springer
2011-03-15,1,20,0,1,2,9,79,88,springer
2011-03-15,1,21,0,1,3,2,53,55,springer
2011-03-15,1,22,0,1,2,1,20,21,springer
2011-03-15,1,23,0,1,2,1,17,18,springer
2011-03-16,1,0,0,1,3,0,8,8,springer
2011-03-16,1,1,0,1,3,1,2,3,springer
2011-03-16,1,3,0,1,2,1,2,3,springer
2011-03-16,1,4,0,1,2,0,1,1,springer
2011-03-16,1,5,0,1,2,0,3,3,springer
2011-03-16,1,6,0,1,2,1,30,31,springer
2011-03-16,1,7,0,1,2,10,101,111,springer
2011-03-16,1,8,0,1,2,26,227,253,springer
2011-03-16,1,9,0,1,2,10,144,154,springer
2011-03-16,1,10,0,1,2,19,49,68,springer
2011-03-16,1,11,0,1,2,13,62,75,springer
2011-03-16,1,12,0,1,2,23,65,88,springer
2011-03-16,1,13,0,1,2,18,81,99,springer
2011-03-16,1,14,0,1,2,33,67,100,springer
2011-03-16,1,15,0,1,2,22,79,101,springer
2011-03-16,1,16,0,1,2,30,121,151,springer
2011-03-16,1,17,0,1,2,37,216,253,springer
2011-03-16,1,18,0,1,2,26,211,237,springer
2011-03-16,1,19,0,1,2,18,150,168,springer
2011-03-16,1,20,0,1,2,10,111,121,springer
2011-03-16,1,21,0,1,2,3,75,78,springer
2011-03-16,1,22,0,1,2,11,48,59,springer
2011-03-16,1,23,0,1,1,9,18,27,springer
2011-03-17,1,0,0,1,1,4,19,23,springer
2011-03-17,1,1,0,1,1,1,11,12,springer
2011-03-17,1,2,0,1,1,3,5,8,springer
2011-03-17,1,3,0,1,1,1,1,2,springer
2011-03-17,1,4,0,1,1,0,3,3,springer
2011-03-17,1,5,0,1,1,0,13,13,springer
2011-03-17,1,6,0,1,1,4,47,51,springer
2011-03-17,1,7,0,1,1,12,128,140,springer
2011-03-17,1,8,0,1,1,17,282,299,springer
2011-03-17,1,9,0,1,1,23,162,185,springer
2011-03-17,1,10,0,1,1,9,69,78,springer
2011-03-17,1,11,0,1,1,20,66,86,springer
2011-03-17,1,12,0,1,1,24,81,105,springer
2011-03-17,1,13,0,1,2,26,85,111,springer
2011-03-17,1,14,0,1,1,32,87,119,springer
2011-03-17,1,15,0,1,1,30,95,125,springer
2011-03-17,1,16,0,1,1,34,108,142,springer
2011-03-17,1,17,0,1,1,48,265,313,springer
2011-03-17,1,18,0,1,2,50,260,310,springer
2011-03-17,1,19,0,1,1,18,189,207,springer
2011-03-17,1,20,0,1,1,25,112,137,springer
2011-03-17,1,21,0,1,1,19,119,138,springer
2011-03-17,1,22,0,1,1,17,70,87,springer
2011-03-17,1,23,0,1,1,7,43,50,springer
2011-03-18,1,0,0,1,1,5,24,29,springer
2011-03-18,1,1,0,1,1,4,12,16,springer
2011-03-18,1,2,0,1,1,5,9,14,springer
2011-03-18,1,3,0,1,1,1,4,5,springer
2011-03-18,1,5,0,1,1,2,8,10,springer
2011-03-18,1,6,0,1,1,1,35,36,springer
2011-03-18,1,7,0,1,1,11,112,123,springer
2011-03-18,1,8,0,1,1,24,256,280,springer
2011-03-18,1,9,0,1,1,18,192,210,springer
2011-03-18,1,10,0,1,1,43,74,117,springer
2011-03-18,1,11,0,1,1,55,104,159,springer
2011-03-18,1,12,0,1,2,72,123,195,springer
2011-03-18,1,13,0,1,1,57,118,175,springer
2011-03-18,1,14,0,1,1,71,103,174,springer
2011-03-18,1,15,0,1,2,62,111,173,springer
2011-03-18,1,16,0,1,1,67,137,204,springer
2011-03-18,1,17,0,1,1,95,237,332,springer
2011-03-18,1,18,0,1,1,84,247,331,springer
2011-03-18,1,19,0,1,1,58,132,190,springer
2011-03-18,1,20,0,1,1,46,103,149,springer
2011-03-18,1,21,0,1,1,22,91,113,springer
2011-03-18,1,22,0,1,1,55,63,118,springer
2011-03-18,1,23,0,1,2,26,60,86,springer
2011-03-19,1,0,0,0,2,26,50,76,springer
2011-03-19,1,1,0,0,2,16,35,51,springer
2011-03-19,1,2,0,0,2,5,20,25,springer
2011-03-19,1,3,0,0,2,1,7,8,springer
2011-03-19,1,4,0,0,1,1,2,3,springer
2011-03-19,1,5,0,0,1,0,2,2,springer
2011-03-19,1,6,0,0,1,0,10,10,springer
2011-03-19,1,7,0,0,1,4,9,13,springer
2011-03-19,1,8,0,0,1,11,37,48,springer
2011-03-19,1,9,0,0,1,35,41,76,springer
2011-03-19,1,10,0,0,1,55,85,140,springer
2011-03-19,1,11,0,0,1,90,106,196,springer
2011-03-19,1,12,0,0,1,126,141,267,springer
2011-03-19,1,13,0,0,1,174,127,301,springer
2011-03-19,1,14,0,0,1,168,144,312,springer
2011-03-19,1,15,0,0,1,170,143,313,springer
2011-03-19,1,16,0,0,1,175,129,304,springer
2011-03-19,1,17,0,0,1,138,140,278,springer
2011-03-19,1,18,0,0,1,92,125,217,springer
2011-03-19,1,19,0,0,1,38,116,154,springer
2011-03-19,1,20,0,0,1,39,69,108,springer
2011-03-19,1,21,0,0,1,20,73,93,springer
2011-03-19,1,22,0,0,1,27,45,72,springer
2011-03-19,1,23,0,0,1,13,37,50,springer
2011-03-20,1,0,0,0,1,7,33,40,springer
2011-03-20,1,1,0,0,1,2,22,24,springer
2011-03-20,1,2,0,0,1,6,24,30,springer
2011-03-20,1,3,0,0,1,1,11,12,springer
2011-03-20,1,4,0,0,1,2,1,3,springer
2011-03-20,1,5,0,0,1,3,6,9,springer
2011-03-20,1,6,0,0,1,1,3,4,springer
2011-03-20,1,7,0,0,1,5,9,14,springer
2011-03-20,1,8,0,0,1,7,30,37,springer
2011-03-20,1,9,0,0,1,35,43,78,springer
2011-03-20,1,10,0,0,2,55,81,136,springer
2011-03-20,1,11,0,0,1,92,111,203,springer
2011-03-20,1,12,0,0,1,120,108,228,springer
2011-03-20,1,13,0,0,1,88,115,203,springer
2011-03-20,1,14,0,0,1,145,134,279,springer
2011-03-20,1,15,0,0,1,172,136,308,springer
2011-03-20,1,16,0,0,1,92,132,224,springer
2011-03-20,1,17,0,0,1,83,143,226,springer
2011-03-20,1,18,0,0,1,58,98,156,springer
2011-03-20,1,19,0,0,1,21,58,79,springer
2011-03-20,1,20,0,0,1,21,46,67,springer
2011-03-20,1,21,0,0,2,10,39,49,springer
2011-03-20,1,22,0,0,2,8,30,38,springer
2011-03-20,1,23,0,0,3,13,11,24,springer
2011-03-21,2,0,0,1,3,2,11,13,summer
2011-03-21,2,1,0,1,2,1,6,7,summer
2011-03-21,2,2,0,1,2,1,5,6,summer
2011-03-21,2,3,0,1,2,0,1,1,summer
2011-03-21,2,5,0,1,1,1,1,2,summer
2011-03-21,2,6,0,1,3,2,30,32,summer
2011-03-21,2,7,0,1,3,3,15,18,summer
2011-03-21,2,8,0,1,2,3,95,98,summer
2011-03-21,2,9,0,1,2,12,115,127,summer
2011-03-21,2,10,0,1,2,17,45,62,summer
2011-03-21,2,11,0,1,2,32,47,79,summer
2011-03-21,2,12,0,1,2,25,56,81,summer
2011-03-21,2,13,0,1,2,35,77,112,summer
2011-03-21,2,14,0,1,2,36,65,101,summer
2011-03-21,2,15,0,1,2,41,66,107,summer
2011-03-21,2,16,0,1,2,29,112,141,summer
2011-03-21,2,17,0,1,2,41,231,272,summer
2011-03-21,2,18,0,1,2,44,232,276,summer
2011-03-21,2,19,0,1,1,22,199,221,summer
2011-03-21,2,20,0,1,1,16,106,122,summer
2011-03-21,2,21,0,1,1,12,79,91,summer
2011-03-21,2,22,0,1,1,18,60,78,summer
2011-03-21,2,23,0,1,1,8,22,30,summer
2011-03-22,2,0,0,1,1,4,7,11,summer
2011-03-22,2,1,0,1,1,6,13,19,summer
2011-03-22,2,2,0,1,1,0,1,1,summer
2011-03-22,2,3,0,1,1,3,2,5,summer
2011-03-22,2,4,0,1,2,0,1,1,summer
2011-03-22,2,5,0,1,2,1,11,12,summer
2011-03-22,2,6,0,1,1,2,58,60,summer
2011-03-22,2,7,0,1,2,4,132,136,summer
2011-03-22,2,8,0,1,2,24,312,336,summer
2011-03-22,2,9,0,1,2,19,159,178,summer
2011-03-22,2,10,0,1,2,29,95,124,summer
2011-03-22,2,11,0,1,1,22,64,86,summer
2011-03-22,2,12,0,1,1,35,86,121,summer
2011-03-22,2,13,0,1,1,21,85,106,summer
2011-03-22,2,14,0,1,1,30,71,101,summer
2011-03-22,2,15,0,1,1,55,79,134,summer
2011-03-22,2,16,0,1,1,40,125,165,summer
2011-03-22,2,17,0,1,1,42,265,307,summer
2011-03-22,2,18,0,1,1,41,271,312,summer
2011-03-22,2,19,0,1,2,22,142,164,summer
2011-03-22,2,20,0,1,2,19,116,135,summer
2011-03-22,2,21,0,1,2,24,63,87,summer
2011-03-22,2,22,0,1,2,13,57,70,summer
2011-03-22,2,23,0,1,2,4,28,32,summer
2011-03-23,2,0,0,1,3,3,8,11,summer
2011-03-23,2,1,0,1,3,0,7,7,summer
2011-03-23,2,2,0,1,3,1,1,2,summer
2011-03-23,2,3,0,1,2,0,3,3,summer
2011-03-23,2,5,0,1,3,0,10,10,summer
2011-03-23,2,6,0,1,2,1,43,44,summer
2011-03-23,2,7,0,1,2,7,111,118,summer
2011-03-23,2,8,0,1,2,14,247,261,summer
2011-03-23,2,9,0,1,2,8,174,182,summer
2011-03-23,2,10,0,1,2,15,60,75,summer
2011-03-23,2,11,0,1,2,18,53,71,summer
2011-03-23,2,12,0,1,2,14,73,87,summer
2011-03-23,2,13,0,1,3,14,94,108,summer
2011-03-23,2,14,0,1,2,13,71,84,summer
2011-03-23,2,15,0,1,2,11,74,85,summer
2011-03-23,2,16,0,1,2,13,123,136,summer
2011-03-23,2,17,0,1,2,28,245,273,summer
2011-03-23,2,18,0,1,3,20,218,238,summer
2011-03-23,2,19,0,1,3,12,147,159,summer
2011-03-23,2,20,0,1,3,3,72,75,summer
2011-03-23,2,21,0,1,3,0,22,22,summer
2011-03-23,2,22,0,1,2,6,38,44,summer
2011-03-23,2,23,0,1,3,2,24,26,summer
2011-03-24,2,0,0,1,2,0,11,11,summer
2011-03-24,2,1,0,1,2,0,3,3,summer
2011-03-24,2,2,0,1,2,0,6,6,summer
2011-03-24,2,3,0,1,2,1,0,1,summer
2011-03-24,2,4,0,1,2,0,1,1,summer
2011-03-24,2,5,0,1,2,1,8,9,summer
2011-03-24,2,6,0,1,2,0,41,41,summer
2011-03-24,2,7,0,1,3,2,106,108,summer
2011-03-24,2,8,0,1,3,4,120,124,summer
2011-03-24,2,9,0,1,2,3,94,97,summer
2011-03-24,2,10,0,1,2,10,55,65,summer
2011-03-24,2,11,0,1,2,10,61,71,summer
2011-03-24,2,12,0,1,2,12,82,94,summer
2011-03-24,2,13,0,1,2,11,90,101,summer
2011-03-24,2,14,0,1,2,17,66,83,summer
2011-03-24,2,15,0,1,2,13,77,90,summer
2011-03-24,2,16,0,1,2,6,78,84,summer
2011-03-24,2,17,0,1,2,12,221,233,summer
2011-03-24,2,18,0,1,2,17,197,214,summer
2011-03-24,2,19,0,1,1,16,122,138,summer
2011-03-24,2,20,0,1,1,8,110,118,summer
2011-03-24,2,21,0,1,1,11,67,78,summer
2011-03-24,2,22,0,1,1,3,59,62,summer
2011-03-24,2,23,0,1,1,9,24,33,summer
2011-03-25,2,0,0,1,1,1,17,18,summer
2011-03-25,2,1,0,1,1,0,5,5,summer
2011-03-25,2,2,0,1,1,0,5,5,summer
2011-03-25,2,3,0,1,1,0,2,2,summer
2011-03-25,2,4,0,1,1,3,2,5,summer
2011-03-25,2,5,0,1,1,0,9,9,summer
2011-03-25,2,6,0,1,1,0,32,32,summer
2011-03-25,2,7,0,1,1,4,100,104,summer
2011-03-25,2,8,0,1,1,9,228,237,summer
2011-03-25,2,9,0,1,1,16,150,166,summer
2011-03-25,2,10,0,1,1,15,53,68,summer
2011-03-25,2,11,0,1,1,17,58,75,summer
2011-03-25,2,12,0,1,1,37,108,145,summer
2011-03-25,2,13,0,1,1,34,104,138,summer
2011-03-25,2,14,0,1,1,30,103,133,summer
2011-03-25,2,15,0,1,2,43,79,122,summer
2011-03-25,2,16,0,1,2,23,127,150,summer
2011-03-25,2,17,0,1,2,23,202,225,summer
2011-03-25,2,18,0,1,1,8,190,198,summer
2011-03-25,2,19,0,1,2,9,126,135,summer
2011-03-25,2,20,0,1,2,6,75,81,summer
2011-03-25,2,21,0,1,2,11,64,75,summer
2011-03-25,2,22,0,1,2,3,40,43,summer
2011-03-25,2,23,0,1,2,8,31,39,summer
2011-03-26,2,0,0,0,2,3,25,28,summer
2011-03-26,2,1,0,0,1,3,24,27,summer
2011-03-26,2,2,0,0,1,4,21,25,summer
2011-03-26,2,3,0,0,1,2,7,9,summer
2011-03-26,2,4,0,0,1,2,4,6,summer
2011-03-26,2,5,0,0,1,0,8,8,summer
2011-03-26,2,6,0,0,1,2,8,10,summer
2011-03-26,2,7,0,0,1,18,23,41,summer
2011-03-26,2,8,0,0,1,24,42,66,summer
2011-03-26,2,9,0,0,1,32,68,100,summer
2011-03-26,2,10,0,0,1,32,93,125,summer
2011-03-26,2,11,0,0,1,75,93,168,summer
2011-03-26,2,12,0,0,1,98,129,227,summer
2011-03-26,2,13,0,0,1,94,145,239,summer
2011-03-26,2,14,0,0,1,93,123,216,summer
2011-03-26,2,15,0,0,1,110,109,219,summer
2011-03-26,2,16,0,0,1,118,130,248,summer
2011-03-26,2,17,0,0,1,102,101,203,summer
2011-03-26,2,18,0,0,2,64,89,153,summer
2011-03-26,2,19,0,0,2,45,93,138,summer
2011-03-26,2,20,0,0,2,18,67,85,summer
2011-03-26,2,21,0,0,2,15,36,51,summer
2011-03-26,2,22,0,0,2,17,46,63,summer
2011-03-26,2,23,0,0,2,10,31,41,summer
2011-03-27,2,0,0,0,2,5,26,31,summer
2011-03-27,2,1,0,0,2,3,17,20,summer
2011-03-27,2,2,0,0,3,6,15,21,summer
2011-03-27,2,3,0,0,3,0,14,14,summer
2011-03-27,2,4,0,0,3,1,5,6,summer
2011-03-27,2,6,0,0,3,0,2,2,summer
2011-03-27,2,7,0,0,3,0,7,7,summer
2011-03-27,2,8,0,0,1,6,8,14,summer
2011-03-27,2,9,0,0,1,17,37,54,summer
2011-03-27,2,10,0,0,2,27,59,86,summer
2011-03-27,2,11,0,0,2,23,85,108,summer
2011-03-27,2,12,0,0,2,43,120,163,summer
2011-03-27,2,13,0,0,1,47,100,147,summer
2011-03-27,2,14,0,0,1,61,103,164,summer
2011-03-27,2,15,0,0,1,61,111,172,summer
2011-03-27,2,16,0,0,1,45,98,143,summer
2011-03-27,2,17,0,0,1,50,109,159,summer
2011-03-27,2,18,0,0,1,32,105,137,summer
2011-03-27,2,19,0,0,1,23,80,103,summer
2011-03-27,2,20,0,0,1,7,50,57,summer
2011-03-27,2,21,0,0,1,7,29,36,summer
2011-03-27,2,22,0,0,1,5,25,30,summer
2011-03-27,2,23,0,0,1,3,16,19,summer
2011-03-28,2,0,0,1,1,1,11,12,summer
2011-03-28,2,1,0,1,1,2,4,6,summer
2011-03-28,2,2,0,1,1,0,5,5,summer
2011-03-28,2,3,0,1,1,0,2,2,summer
2011-03-28,2,5,0,1,1,0,8,8,summer
2011-03-28,2,6,0,1,1,0,40,40,summer
2011-03-28,2,7,0,1,1,6,104,110,summer
2011-03-28,2,8,0,1,1,15,239,254,summer
2011-03-28,2,9,0,1,2,12,109,121,summer
2011-03-28,2,10,0,1,1,22,47,69,summer
2011-03-28,2,11,0,1,2,18,39,57,summer
2011-03-28,2,12,0,1,2,8,71,79,summer
2011-03-28,2,13,0,1,2,14,69,83,summer
2011-03-28,2,14,0,1,1,15,65,80,summer
2011-03-28,2,15,0,1,1,19,53,72,summer
2011-03-28,2,16,0,1,1,15,117,132,summer
2011-03-28,2,17,0,1,1,25,227,252,summer
2011-03-28,2,18,0,1,1,21,220,241,summer
2011-03-28,2,19,0,1,1,17,156,173,summer
2011-03-28,2,20,0,1,1,5,107,112,summer
2011-03-28,2,21,0,1,1,6,55,61,summer
2011-03-28,2,22,0,1,1,0,40,40,summer
2011-03-28,2,23,0,1,1,1,18,19,summer
2011-03-29,2,0,0,1,1,1,15,16,summer
2011-03-29,2,1,0,1,1,0,4,4,summer
2011-03-29,2,2,0,1,1,0,3,3,summer
2011-03-29,2,3,0,1,1,2,1,3,summer
2011-03-29,2,4,0,1,1,1,1,2,summer
2011-03-29,2,5,0,1,1,0,8,8,summer
2011-03-29,2,6,0,1,1,4,46,50,summer
2011-03-29,2,7,0,1,1,5,128,133,summer
2011-03-29,2,8,0,1,1,19,268,287,summer
2011-03-29,2,9,0,1,1,16,156,172,summer
2011-03-29,2,10,0,1,1,13,46,59,summer
2011-03-29,2,11,0,1,2,18,63,81,summer
2011-03-29,2,12,0,1,1,29,77,106,summer
2011-03-29,2,13,0,1,1,24,80,104,summer
2011-03-29,2,14,0,1,1,20,66,86,summer
2011-03-29,2,15,0,1,1,22,65,87,summer
2011-03-29,2,16,0,1,1,12,124,136,summer
2011-03-29,2,17,0,1,1,34,265,299,summer
2011-03-29,2,18,0,1,1,42,252,294,summer
2011-03-29,2,19,0,1,1,20,170,190,summer
2011-03-29,2,20,0,1,1,13,119,132,summer
2011-03-29,2,21,0,1,1,8,75,83,summer
2011-03-29,2,22,0,1,1,6,49,55,summer
2011-03-29,2,23,0,1,2,8,27,35,summer
2011-03-30,2,0,0,1,2,3,8,11,summer
2011-03-30,2,1,0,1,1,1,9,10,summer
2011-03-30,2,2,0,1,2,0,4,4,summer
2011-03-30,2,3,0,1,2,0,4,4,summer
2011-03-30,2,4,0,1,2,1,0,1,summer
2011-03-30,2,5,0,1,2,0,7,7,summer
2011-03-30,2,6,0,1,2,4,44,48,summer
2011-03-30,2,7,0,1,2,8,128,136,summer
2011-03-30,2,8,0,1,2,16,247,263,summer
2011-03-30,2,9,0,1,2,7,147,154,summer
2011-03-30,2,10,0,1,2,13,51,64,summer
2011-03-30,2,11,0,1,2,26,64,90,summer
2011-03-30,2,12,0,1,2,15,65,80,summer
2011-03-30,2,13,0,1,2,14,84,98,summer
2011-03-30,2,14,0,1,2,16,64,80,summer
2011-03-30,2,15,0,1,3,14,56,70,summer
2011-03-30,2,16,0,1,3,0,36,36,summer
2011-03-30,2,17,0,1,3,11,105,116,summer
2011-03-30,2,18,0,1,2,6,79,85,summer
2011-03-30,2,19,0,1,2,5,67,72,summer
2011-03-30,2,20,0,1,3,4,40,44,summer
2011-03-30,2,21,0,1,2,0,27,27,summer
2011-03-30,2,22,0,1,3,3,21,24,summer
2011-03-30,2,23,0,1,3,1,11,12,summer
2011-03-31,2,0,0,1,3,0,3,3,summer
2011-03-31,2,1,0,1,3,1,4,5,summer
2011-03-31,2,2,0,1,3,0,5,5,summer
2011-03-31,2,3,0,1,3,0,1,1,summer
2011-03-31,2,4,0,1,3,0,2,2,summer
2011-03-31,2,5,0,1,3,0,8,8,summer
2011-03-31,2,6,0,1,3,2,34,36,summer
2011-03-31,2,7,0,1,3,5,87,92,summer
2011-03-31,2,8,0,1,2,7,185,192,summer
2011-03-31,2,9,0,1,3,6,126,132,summer
2011-03-31,2,10,0,1,3,15,54,69,summer
2011-03-31,2,11,0,1,3,6,52,58,summer
2011-03-31,2,12,0,1,3,17,73,90,summer
2011-03-31,2,13,0,1,3,13,55,68,summer
2011-03-31,2,14,0,1,3,27,49,76,summer
2011-03-31,2,15,0,1,3,4,61,65,summer
2011-03-31,2,16,0,1,2,13,72,85,summer
2011-03-31,2,17,0,1,2,15,153,168,summer
2011-03-31,2,18,0,1,2,12,165,177,summer
2011-03-31,2,19,0,1,2,12,118,130,summer
2011-03-31,2,20,0,1,3,6,79,85,summer
2011-03-31,2,21,0,1,2,7,53,60,summer
2011-03-31,2,22,0,1,3,7,44,51,summer
2011-03-31,2,23,0,1,3,4,23,27,summer
2011-04-01,2,0,0,1,3,0,6,6,summer
2011-04-01,2,1,0,1,3,0,4,4,summer
2011-04-01,2,2,0,1,3,0,7,7,summer
2011-04-01,2,3,0,1,2,0,4,4,summer
2011-04-01,2,4,0,1,2,0,3,3,summer
2011-04-01,2,5,0,1,3,1,11,12,summer
2011-04-01,2,6,0,1,3,2,26,28,summer
2011-04-01,2,7,0,1,3,4,91,95,summer
2011-04-01,2,8,0,1,2,8,198,206,summer
2011-04-01,2,9,0,1,1,11,162,173,summer
2011-04-01,2,10,0,1,1,12,63,75,summer
2011-04-01,2,11,0,1,1,17,72,89,summer
2011-04-01,2,12,0,1,1,15,80,95,summer
2011-04-01,2,13,0,1,1,18,92,110,summer
2011-04-01,2,14,0,1,2,26,61,87,summer
2011-04-01,2,15,0,1,1,30,81,111,summer
2011-04-01,2,16,0,1,1,42,125,167,summer
2011-04-01,2,17,0,1,1,36,245,281,summer
2011-04-01,2,18,0,1,1,36,205,241,summer
2011-04-01,2,19,0,1,1,16,120,136,summer
2011-04-01,2,20,0,1,1,2,75,77,summer
2011-04-01,2,21,0,1,1,9,84,93,summer
2011-04-01,2,22,0,1,1,10,64,74,summer
2011-04-01,2,23,0,1,1,12,41,53,summer
2011-04-02,2,0,0,0,2,3,29,32,summer
2011-04-02,2,1,0,0,1,4,28,32,summer
2011-04-02,2,2,0,0,1,1,20,21,summer
2011-04-02,2,3,0,0,1,1,8,9,summer
2011-04-02,2,4,0,0,1,0,5,5,summer
2011-04-02,2,5,0,0,2,1,4,5,summer
2011-04-02,2,6,0,0,1,5,7,12,summer
2011-04-02,2,7,0,0,2,2,16,18,summer
2011-04-02,2,8,0,0,1,10,45,55,summer
2011-04-02,2,9,0,0,2,22,65,87,summer
2011-04-02,2,10,0,0,2,41,113,154,summer
2011-04-02,2,11,0,0,2,72,126,198,summer
2011-04-02,2,12,0,0,3,84,100,184,summer
2011-04-02,2,13,0,0,1,56,81,137,summer
2011-04-02,2,14,0,0,3,97,93,190,summer
2011-04-02,2,15,0,0,3,72,64,136,summer
2011-04-02,2,16,0,0,1,111,85,196,summer
2011-04-02,2,17,0,0,1,89,95,184,summer
2011-04-02,2,18,0,0,1,69,110,179,summer
2011-04-02,2,19,0,0,1,71,77,148,summer
2011-04-02,2,20,0,0,1,29,56,85,summer
2011-04-02,2,21,0,0,1,24,53,77,summer
2011-04-02,2,22,0,0,1,14,41,55,summer
2011-04-02,2,23,0,0,1,20,33,53,summer
2011-04-03,2,0,0,0,1,8,31,39,summer
2011-04-03,2,1,0,0,1,8,26,34,summer
2011-04-03,2,2,0,0,1,5,19,24,summer
2011-04-03,2,3,0,0,1,3,8,11,summer
2011-04-03,2,4,0,0,1,3,0,3,summer
2011-04-03,2,5,0,0,1,1,4,5,summer
2011-04-03,2,6,0,0,1,10,23,33,summer
2011-04-03,2,7,0,0,1,13,20,33,summer
2011-04-03,2,8,0,0,1,18,44,62,summer
2011-04-03,2,9,0,0,1,68,74,142,summer
2011-04-03,2,10,0,0,1,111,104,215,summer
2011-04-03,2,11,0,0,1,139,104,243,summer
2011-04-03,2,12,0,0,1,166,147,313,summer
2011-04-03,2,13,0,0,1,219,148,367,summer
2011-04-03,2,14,0,0,1,240,109,349,summer
2011-04-03,2,15,0,0,2,174,118,292,summer
2011-04-03,2,16,0,0,2,147,156,303,summer
2011-04-03,2,17,0,0,2,148,126,274,summer
2011-04-03,2,18,0,0,2,71,101,172,summer
2011-04-03,2,19,0,0,2,51,93,144,summer
2011-04-03,2,20,0,0,3,24,55,79,summer
2011-04-03,2,21,0,0,2,8,37,45,summer
2011-04-03,2,22,0,0,1,7,29,36,summer
2011-04-03,2,23,0,0,1,9,22,31,summer
2011-04-04,2,0,0,1,1,1,5,6,summer
2011-04-04,2,1,0,1,1,7,4,11,summer
2011-04-04,2,2,0,1,1,1,1,2,summer
2011-04-04,2,3,0,1,1,1,0,1,summer
2011-04-04,2,4,0,1,1,1,1,2,summer
2011-04-04,2,5,0,1,1,0,7,7,summer
2011-04-04,2,6,0,1,1,3,43,46,summer
2011-04-04,2,7,0,1,2,7,150,157,summer
2011-04-04,2,8,0,1,2,31,308,339,summer
2011-04-04,2,9,0,1,2,24,134,158,summer
2011-04-04,2,10,0,1,2,35,55,90,summer
2011-04-04,2,11,0,1,1,58,66,124,summer
2011-04-04,2,12,0,1,1,59,98,157,summer
2011-04-04,2,13,0,1,1,47,92,139,summer
2011-04-04,2,14,0,1,2,47,76,123,summer
2011-04-04,2,15,0,1,1,47,96,143,summer
2011-04-04,2,16,0,1,1,59,130,189,summer
2011-04-04,2,17,0,1,1,83,283,366,summer
2011-04-04,2,18,0,1,2,78,308,386,summer
2011-04-04,2,19,0,1,1,51,227,278,summer
2011-04-04,2,20,0,1,2,40,133,173,summer
2011-04-04,2,21,0,1,2,19,76,95,summer
2011-04-04,2,22,0,1,2,17,58,75,summer
2011-04-04,2,23,0,1,2,18,30,48,summer
2011-04-05,2,0,0,1,1,10,12,22,summer
2011-04-05,2,1,0,1,3,10,5,15,summer
2011-04-05,2,2,0,1,2,0,5,5,summer
2011-04-05,2,3,0,1,2,1,3,4,summer
2011-04-05,2,4,0,1,3,0,2,2,summer
2011-04-05,2,5,0,1,3,0,5,5,summer
2011-04-05,2,6,0,1,2,2,36,38,summer
2011-04-05,2,7,0,1,2,10,124,134,summer
2011-04-05,2,8,0,1,3,9,148,157,summer
2011-04-05,2,9,0,1,3,2,44,46,summer
2011-04-05,2,10,0,1,3,3,25,28,summer
2011-04-05,2,11,0,1,3,1,18,19,summer
2011-04-05,2,12,0,1,2,6,32,38,summer
2011-04-05,2,13,0,1,2,5,51,56,summer
2011-04-05,2,14,0,1,2,9,67,76,summer
2011-04-05,2,15,0,1,1,6,62,68,summer
2011-04-05,2,16,0,1,1,17,113,130,summer
2011-04-05,2,17,0,1,1,27,246,273,summer
2011-04-05,2,18,0,1,1,19,248,267,summer
2011-04-05,2,19,0,1,1,12,148,160,summer
2011-04-05,2,20,0,1,1,4,87,91,summer
2011-04-05,2,21,0,1,1,8,81,89,summer
2011-04-05,2,22,0,1,1,3,43,46,summer
2011-04-05,2,23,0,1,1,3,23,26,summer
2011-04-06,2,0,0,1,1,0,15,15,summer
2011-04-06,2,1,0,1,1,0,2,2,summer
2011-04-06,2,2,0,1,1,0,5,5,summer
2011-04-06,2,3,0,1,1,0,4,4,summer
2011-04-06,2,4,0,1,1,0,1,1,summer
2011-04-06,2,5,0,1,1,1,12,13,summer
2011-04-06,2,6,0,1,1,4,52,56,summer
2011-04-06,2,7,0,1,1,3,130,133,summer
2011-04-06,2,8,0,1,1,17,308,325,summer
2011-04-06,2,9,0,1,1,8,157,165,summer
2011-04-06,2,10,0,1,1,21,48,69,summer
2011-04-06,2,11,0,1,1,23,70,93,summer
2011-04-06,2,12,0,1,1,22,112,134,summer
2011-04-06,2,13,0,1,1,29,83,112,summer
2011-04-06,2,14,0,1,1,35,80,115,summer
2011-04-06,2,15,0,1,1,34,83,117,summer
2011-04-06,2,16,0,1,1,27,142,169,summer
2011-04-06,2,17,0,1,1,53,303,356,summer
2011-04-06,2,18,0,1,1,43,282,325,summer
2011-04-06,2,19,0,1,1,36,196,232,summer
2011-04-06,2,20,0,1,1,15,126,141,summer
2011-04-06,2,21,0,1,1,18,84,102,summer
2011-04-06,2,22,0,1,1,13,71,84,summer
2011-04-06,2,23,0,1,1,11,29,40,summer
2011-04-07,2,0,0,1,1,5,15,20,summer
2011-04-07,2,1,0,1,1,2,11,13,summer
2011-04-07,2,2,0,1,1,0,7,7,summer
2011-04-07,2,3,0,1,1,0,3,3,summer
2011-04-07,2,4,0,1,1,0,1,1,summer
2011-04-07,2,5,0,1,1,0,6,6,summer
2011-04-07,2,6,0,1,1,5,59,64,summer
2011-04-07,2,7,0,1,2,8,152,160,summer
2011-04-07,2,8,0,1,1,23,291,314,summer
2011-04-07,2,9,0,1,2,15,155,170,summer
2011-04-07,2,10,0,1,2,29,66,95,summer
2011-04-07,2,11,0,1,2,36,86,122,summer
2011-04-07,2,12,0,1,2,39,114,153,summer
2011-04-07,2,13,0,1,2,36,99,135,summer
2011-04-07,2,14,0,1,1,46,111,157,summer
2011-04-07,2,15,0,1,1,27,133,160,summer
2011-04-07,2,16,0,1,1,52,161,213,summer
2011-04-07,2,17,0,1,1,63,280,343,summer
2011-04-07,2,18,0,1,1,68,265,333,summer
2011-04-07,2,19,0,1,1,34,192,226,summer
2011-04-07,2,20,0,1,1,37,166,203,summer
2011-04-07,2,21,0,1,2,19,89,108,summer
2011-04-07,2,22,0,1,2,18,63,81,summer
2011-04-07,2,23,0,1,1,9,45,54,summer
2011-04-08,2,0,0,1,2,4,21,25,summer
2011-04-08,2,1,0,1,2,3,6,9,summer
2011-04-08,2,2,0,1,3,3,10,13,summer
2011-04-08,2,3,0,1,3,0,1,1,summer
2011-04-08,2,4,0,1,2,0,1,1,summer
2011-04-08,2,5,0,1,2,1,8,9,summer
2011-04-08,2,6,0,1,2,2,33,35,summer
2011-04-08,2,7,0,1,3,4,109,113,summer
2011-04-08,2,8,0,1,3,13,208,221,summer
2011-04-08,2,9,0,1,2,17,168,185,summer
2011-04-08,2,10,0,1,2,10,63,73,summer
2011-04-08,2,11,0,1,2,19,79,98,summer
2011-04-08,2,12,0,1,3,29,51,80,summer
2011-04-08,2,13,0,1,3,7,35,42,summer
2011-04-08,2,14,0,1,3,2,13,15,summer
2011-04-08,2,15,0,1,3,1,24,25,summer
2011-04-08,2,16,0,1,2,2,58,60,summer
2011-04-08,2,17,0,1,3,10,138,148,summer
2011-04-08,2,18,0,1,3,8,54,62,summer
2011-04-08,2,19,0,1,3,1,52,53,summer
2011-04-08,2,20,0,1,2,12,51,63,summer
2011-04-08,2,21,0,1,2,11,43,54,summer
2011-04-08,2,22,0,1,2,9,42,51,summer
2011-04-08,2,23,0,1,2,4,31,35,summer
2011-04-09,2,0,0,0,2,5,26,31,summer
2011-04-09,2,1,0,0,2,3,17,20,summer
2011-04-09,2,2,0,0,2,2,15,17,summer
2011-04-09,2,3,0,0,3,3,11,14,summer
2011-04-09,2,4,0,0,3,0,3,3,summer
2011-04-09,2,5,0,0,2,0,5,5,summer
2011-04-09,2,6,0,0,2,0,13,13,summer
2011-04-09,2,7,0,0,2,8,13,21,summer
2011-04-09,2,8,0,0,2,7,47,54,summer
2011-04-09,2,9,0,0,2,27,71,98,summer
2011-04-09,2,10,0,0,2,43,90,133,summer
2011-04-09,2,11,0,0,2,51,91,142,summer
2011-04-09,2,12,0,0,2,79,123,202,summer
2011-04-09,2,13,0,0,2,114,108,222,summer
2011-04-09,2,14,0,0,2,94,118,212,summer
2011-04-09,2,15,0,0,2,85,116,201,summer
2011-04-09,2,16,0,0,2,73,118,191,summer
2011-04-09,2,17,0,0,2,128,129,257,summer
2011-04-09,2,18,0,0,2,48,129,177,summer
2011-04-09,2,19,0,0,2,47,83,130,summer
2011-04-09,2,20,0,0,2,19,74,93,summer
2011-04-09,2,21,0,0,2,10,65,75,summer
2011-04-09,2,22,0,0,2,21,66,87,summer
2011-04-09,2,23,0,0,2,12,45,57,summer
2011-04-10,2,0,0,0,2,5,48,53,summer
2011-04-10,2,1,0,0,2,6,31,37,summer
2011-04-10,2,2,0,0,2,12,24,36,summer
2011-04-10,2,3,0,0,2,5,11,16,summer
2011-04-10,2,4,0,0,2,3,2,5,summer
2011-04-10,2,5,0,0,2,0,4,4,summer
2011-04-10,2,6,0,0,2,0,4,4,summer
2011-04-10,2,7,0,0,2,3,7,10,summer
2011-04-10,2,8,0,0,2,17,38,55,summer
2011-04-10,2,9,0,0,2,31,50,81,summer
2011-04-10,2,10,0,0,2,69,81,150,summer
2011-04-10,2,11,0,0,2,93,109,202,summer
2011-04-10,2,12,0,0,2,94,136,230,summer
2011-04-10,2,13,0,0,1,121,142,263,summer
2011-04-10,2,14,0,0,1,148,133,281,summer
2011-04-10,2,15,0,0,1,156,141,297,summer
2011-04-10,2,16,0,0,2,135,153,288,summer
2011-04-10,2,17,0,0,2,84,152,236,summer
2011-04-10,2,18,0,0,1,103,137,240,summer
2011-04-10,2,19,0,0,1,47,84,131,summer
2011-04-10,2,20,0,0,1,21,71,92,summer
2011-04-10,2,21,0,0,1,18,77,95,summer
2011-04-10,2,22,0,0,1,12,45,57,summer
2011-04-10,2,23,0,0,1,5,27,32,summer
2011-04-11,2,0,0,1,1,7,16,23,summer
2011-04-11,2,1,0,1,1,1,3,4,summer
2011-04-11,2,2,0,1,1,7,2,9,summer
2011-04-11,2,4,0,1,1,0,1,1,summer
2011-04-11,2,5,0,1,1,1,12,13,summer
2011-04-11,2,6,0,1,2,2,59,61,summer
2011-04-11,2,7,0,1,2,12,164,176,summer
2011-04-11,2,8,0,1,2,28,286,314,summer
2011-04-11,2,9,0,1,2,33,132,165,summer
2011-04-11,2,10,0,1,2,41,55,96,summer
2011-04-11,2,11,0,1,2,45,59,104,summer
2011-04-11,2,12,0,1,2,37,97,134,summer
2011-04-11,2,13,0,1,2,62,77,139,summer
2011-04-11,2,14,0,1,2,60,85,145,summer
2011-04-11,2,15,0,1,1,56,85,141,summer
2011-04-11,2,16,0,1,1,73,162,235,summer
2011-04-11,2,17,0,1,1,100,352,452,summer
2011-04-11,2,18,0,1,1,93,290,383,summer
2011-04-11,2,19,0,1,1,73,211,284,summer
2011-04-11,2,20,0,1,1,44,122,166,summer
2011-04-11,2,21,0,1,1,39,119,158,summer
2011-04-11,2,22,0,1,2,25,66,91,summer
2011-04-11,2,23,0,1,3,16,38,54,summer
2011-04-12,2,0,0,1,2,11,13,24,summer
2011-04-12,2,1,0,1,2,6,7,13,summer
2011-04-12,2,2,0,1,2,7,7,14,summer
2011-04-12,2,3,0,1,2,0,1,1,summer
2011-04-12,2,4,0,1,2,4,2,6,summer
2011-04-12,2,5,0,1,2,1,15,16,summer
2011-04-12,2,6,0,1,2,3,55,58,summer
2011-04-12,2,7,0,1,2,12,177,189,summer
2011-04-12,2,8,0,1,3,15,211,226,summer
2011-04-12,2,9,0,1,3,4,50,54,summer
2011-04-12,2,10,0,1,3,6,34,40,summer
2011-04-12,2,11,0,1,1,11,38,49,summer
2011-04-12,2,12,0,1,2,9,83,92,summer
2011-04-12,2,13,0,1,3,22,84,106,summer
2011-04-12,2,14,0,1,2,16,28,44,summer
2011-04-12,2,15,0,1,2,24,54,78,summer
2011-04-12,2,16,0,1,2,19,80,99,summer
2011-04-12,2,17,0,1,3,29,262,291,summer
2011-04-12,2,18,0,1,3,21,203,224,summer
2011-04-12,2,19,0,1,2,3,127,130,summer
2011-04-12,2,20,0,1,2,9,94,103,summer
2011-04-12,2,21,0,1,2,10,74,84,summer
2011-04-12,2,22,0,1,2,7,47,54,summer
2011-04-12,2,23,0,1,2,8,31,39,summer
2011-04-13,2,0,0,1,2,3,12,15,summer
2011-04-13,2,1,0,1,2,0,1,1,summer
2011-04-13,2,2,0,1,3,0,2,2,summer
2011-04-13,2,3,0,1,3,0,2,2,summer
2011-04-13,2,4,0,1,3,1,2,3,summer
2011-04-13,2,5,0,1,3,1,4,5,summer
2011-04-13,2,6,0,1,3,1,33,34,summer
2011-04-13,2,7,0,1,3,3,67,70,summer
2011-04-13,2,8,0,1,3,6,158,164,summer
2011-04-13,2,9,0,1,2,2,63,65,summer
2011-04-13,2,10,0,1,2,4,42,46,summer
2011-04-13,2,11,0,1,2,4,57,61,summer
2011-04-13,2,12,0,1,3,12,83,95,summer
2011-04-13,2,13,0,1,2,6,55,61,summer
2011-04-13,2,14,0,1,2,24,82,106,summer
2011-04-13,2,15,0,1,2,12,69,81,summer
2011-04-13,2,16,0,1,1,23,119,142,summer
2011-04-13,2,17,0,1,1,25,284,309,summer
2011-04-13,2,18,0,1,1,28,293,321,summer
2011-04-13,2,19,0,1,1,15,160,175,summer
2011-04-13,2,20,0,1,1,7,119,126,summer
2011-04-13,2,21,0,1,1,17,100,117,summer
2011-04-13,2,22,0,1,1,10,89,99,summer
2011-04-13,2,23,0,1,1,5,57,62,summer
2011-04-14,2,0,0,1,1,3,18,21,summer
2011-04-14,2,1,0,1,1,1,9,10,summer
2011-04-14,2,2,0,1,1,0,3,3,summer
2011-04-14,2,3,0,1,1,0,2,2,summer
2011-04-14,2,4,0,1,1,1,8,9,summer
2011-04-14,2,5,0,1,1,2,12,14,summer
2011-04-14,2,6,0,1,1,4,66,70,summer
2011-04-14,2,7,0,1,1,11,182,193,summer
2011-04-14,2,8,0,1,1,21,316,337,summer
2011-04-14,2,9,0,1,1,18,152,170,summer
2011-04-14,2,10,0,1,1,21,68,89,summer
2011-04-14,2,11,0,1,1,28,87,115,summer
2011-04-14,2,12,0,1,1,35,110,145,summer
2011-04-14,2,13,0,1,1,38,121,159,summer
2011-04-14,2,14,0,1,1,36,101,137,summer
2011-04-14,2,15,0,1,1,57,85,142,summer
2011-04-14,2,16,0,1,1,49,153,202,summer
2011-04-14,2,17,0,1,1,50,338,388,summer
2011-04-14,2,18,0,1,1,47,290,337,summer
2011-04-14,2,19,0,1,1,37,222,259,summer
2011-04-14,2,20,0,1,1,22,147,169,summer
2011-04-14,2,21,0,1,1,19,126,145,summer
2011-04-14,2,22,0,1,1,22,82,104,summer
2011-04-14,2,23,0,1,1,7,40,47,summer
2011-04-15,2,0,1,0,1,6,21,27,summer
2011-04-15,2,1,1,0,1,6,9,15,summer
2011-04-15,2,2,1,0,1,8,10,18,summer
2011-04-15,2,3,1,0,1,0,3,3,summer
2011-04-15,2,4,1,0,1,0,3,3,summer
2011-04-15,2,5,1,0,1,2,11,13,summer
2011-04-15,2,6,1,0,1,5,42,47,summer
2011-04-15,2,7,1,0,1,10,139,149,summer
2011-04-15,2,8,1,0,1,21,279,300,summer
2011-04-15,2,9,1,0,1,16,162,178,summer
2011-04-15,2,10,1,0,1,31,91,122,summer
2011-04-15,2,11,1,0,1,41,95,136,summer
2011-04-15,2,12,1,0,1,45,155,200,summer
2011-04-15,2,13,1,0,1,47,133,180,summer
2011-04-15,2,14,1,0,1,57,106,163,summer
2011-04-15,2,15,1,0,1,50,112,162,summer
2011-04-15,2,16,1,0,1,70,173,243,summer
2011-04-15,2,17,1,0,2,64,267,331,summer
2011-04-15,2,18,1,0,2,47,216,263,summer
2011-04-15,2,19,1,0,1,41,168,209,summer
2011-04-15,2,20,1,0,2,26,92,118,summer
2011-04-15,2,21,1,0,2,25,77,102,summer
2011-04-15,2,22,1,0,2,16,64,80,summer
2011-04-15,2,23,1,0,2,8,56,64,summer
2011-04-16,2,0,0,0,2,7,36,43,summer
2011-04-16,2,1,0,0,2,5,28,33,summer
2011-04-16,2,2,0,0,2,5,19,24,summer
2011-04-16,2,3,0,0,2,5,9,14,summer
2011-04-16,2,4,0,0,2,1,4,5,summer
2011-04-16,2,5,0,0,2,1,3,4,summer
2011-04-16,2,6,0,0,3,1,9,10,summer
2011-04-16,2,7,0,0,2,3,18,21,summer
2011-04-16,2,8,0,0,3,7,38,45,summer
2011-04-16,2,9,0,0,3,2,27,29,summer
2011-04-16,2,10,0,0,3,1,21,22,summer
2011-04-16,2,11,0,0,3,4,27,31,summer
2011-04-16,2,12,0,0,2,6,26,32,summer
2011-04-16,2,13,0,0,3,9,49,58,summer
2011-04-16,2,14,0,0,3,14,49,63,summer
2011-04-16,2,15,0,0,3,16,62,78,summer
2011-04-16,2,16,0,0,3,6,27,33,summer
2011-04-16,2,17,0,0,3,1,14,15,summer
2011-04-16,2,18,0,0,2,6,32,38,summer
2011-04-16,2,19,0,0,2,9,62,71,summer
2011-04-16,2,20,0,0,3,4,49,53,summer
2011-04-16,2,21,0,0,2,1,13,14,summer
2011-04-16,2,22,0,0,3,2,22,24,summer
2011-04-16,2,23,0,0,2,5,30,35,summer
2011-04-17,2,0,0,0,2,4,29,33,summer
2011-04-17,2,1,0,0,1,6,25,31,summer
2011-04-17,2,2,0,0,1,4,25,29,summer
2011-04-17,2,3,0,0,1,12,13,25,summer
2011-04-17,2,4,0,0,1,2,5,7,summer
2011-04-17,2,5,0,0,1,2,1,3,summer
2011-04-17,2,6,0,0,1,3,5,8,summer
2011-04-17,2,7,0,0,1,2,14,16,summer
2011-04-17,2,8,0,0,1,7,36,43,summer
2011-04-17,2,9,0,0,1,31,71,102,summer
2011-04-17,2,10,0,0,1,91,120,211,summer
2011-04-17,2,11,0,0,1,119,185,304,summer
2011-04-17,2,12,0,0,1,167,187,354,summer
2011-04-17,2,13,0,0,1,181,162,343,summer
2011-04-17,2,14,0,0,1,170,191,361,summer
2011-04-17,2,15,0,0,1,179,209,388,summer
2011-04-17,2,16,0,0,1,161,182,343,summer
2011-04-17,2,17,0,0,1,143,163,306,summer
2011-04-17,2,18,0,0,1,102,175,277,summer
2011-04-17,2,19,0,0,1,75,135,210,summer
2011-04-17,2,20,0,0,1,44,97,141,summer
2011-04-17,2,21,0,0,1,13,70,83,summer
2011-04-17,2,22,0,0,1,21,49,70,summer
2011-04-17,2,23,0,0,1,19,37,56,summer
2011-04-18,2,0,0,1,1,15,24,39,summer
2011-04-18,2,1,0,1,1,11,8,19,summer
2011-04-18,2,2,0,1,1,14,2,16,summer
2011-04-18,2,3,0,1,1,6,1,7,summer
2011-04-18,2,4,0,1,1,2,4,6,summer
2011-04-18,2,5,0,1,1,0,16,16,summer
2011-04-18,2,6,0,1,1,3,51,54,summer
2011-04-18,2,7,0,1,1,12,156,168,summer
2011-04-18,2,8,0,1,1,20,277,297,summer
2011-04-18,2,9,0,1,2,37,132,169,summer
2011-04-18,2,10,0,1,2,41,68,109,summer
2011-04-18,2,11,0,1,2,36,87,123,summer
2011-04-18,2,12,0,1,2,60,124,184,summer
2011-04-18,2,13,0,1,2,41,128,169,summer
2011-04-18,2,14,0,1,2,49,95,144,summer
2011-04-18,2,15,0,1,2,64,112,176,summer
2011-04-18,2,16,0,1,1,40,165,205,summer
2011-04-18,2,17,0,1,1,66,362,428,summer
2011-04-18,2,18,0,1,1,41,321,362,summer
2011-04-18,2,19,0,1,1,42,244,286,summer
2011-04-18,2,20,0,1,1,29,136,165,summer
2011-04-18,2,21,0,1,1,20,131,151,summer
2011-04-18,2,22,0,1,1,9,81,90,summer
2011-04-18,2,23,0,1,1,11,35,46,summer
2011-04-19,2,0,0,1,1,2,23,25,summer
2011-04-19,2,1,0,1,1,5,2,7,summer
2011-04-19,2,2,0,1,1,8,5,13,summer
2011-04-19,2,3,0,1,1,0,3,3,summer
2011-04-19,2,4,0,1,1,1,4,5,summer
2011-04-19,2,5,0,1,2,1,17,18,summer
2011-04-19,2,6,0,1,2,2,63,65,summer
2011-04-19,2,7,0,1,2,22,166,188,summer
2011-04-19,2,8,0,1,2,20,331,351,summer
2011-04-19,2,9,0,1,3,23,139,162,summer
2011-04-19,2,10,0,1,2,15,60,75,summer
2011-04-19,2,11,0,1,2,19,53,72,summer
2011-04-19,2,12,0,1,2,19,84,103,summer
2011-04-19,2,13,0,1,2,26,103,129,summer
2011-04-19,2,14,0,1,2,19,88,107,summer
2011-04-19,2,15,0,1,2,44,83,127,summer
2011-04-19,2,16,0,1,1,30,162,192,summer
2011-04-19,2,17,0,1,1,39,372,411,summer
2011-04-19,2,18,0,1,2,44,377,421,summer
2011-04-19,2,19,0,1,2,28,248,276,summer
2011-04-19,2,20,0,1,2,20,148,168,summer
2011-04-19,2,21,0,1,2,8,114,122,summer
2011-04-19,2,22,0,1,1,3,109,112,summer
2011-04-19,2,23,0,1,1,11,41,52,summer
2011-04-20,2,0,0,1,1,4,29,33,summer
2011-04-20,2,1,0,1,1,2,5,7,summer
2011-04-20,2,2,0,1,1,0,2,2,summer
2011-04-20,2,3,0,1,1,0,2,2,summer
2011-04-20,2,4,0,1,1,5,4,9,summer
2011-04-20,2,5,0,1,1,1,14,15,summer
2011-04-20,2,6,0,1,1,2,62,64,summer
2011-04-20,2,7,0,1,1,26,211,237,summer
2011-04-20,2,8,0,1,1,22,374,396,summer
2011-04-20,2,9,0,1,1,27,170,197,summer
2011-04-20,2,10,0,1,1,45,86,131,summer
2011-04-20,2,11,0,1,1,31,87,118,summer
2011-04-20,2,12,0,1,1,28,117,145,summer
2011-04-20,2,13,0,1,1,42,135,177,summer
2011-04-20,2,14,0,1,1,33,115,148,summer
2011-04-20,2,15,0,1,2,32,113,145,summer
2011-04-20,2,16,0,1,2,54,201,255,summer
2011-04-20,2,17,0,1,2,34,398,432,summer
2011-04-20,2,18,0,1,1,56,385,441,summer
2011-04-20,2,19,0,1,1,74,309,383,summer
2011-04-20,2,20,0,1,1,31,194,225,summer
2011-04-20,2,21,0,1,1,38,134,172,summer
2011-04-20,2,22,0,1,1,12,105,117,summer
2011-04-20,2,23,0,1,1,14,79,93,summer
2011-04-21,2,0,0,1,1,11,33,44,summer
2011-04-21,2,1,0,1,1,6,20,26,summer
2011-04-21,2,2,0,1,1,3,10,13,summer
2011-04-21,2,3,0,1,2,4,3,7,summer
2011-04-21,2,4,0,1,2,2,4,6,summer
2011-04-21,2,5,0,1,2,0,14,14,summer
2011-04-21,2,6,0,1,2,2,73,75,summer
2011-04-21,2,7,0,1,2,15,183,198,summer
2011-04-21,2,8,0,1,2,19,346,365,summer
2011-04-21,2,9,0,1,2,18,178,196,summer
2011-04-21,2,10,0,1,1,25,73,98,summer
2011-04-21,2,11,0,1,1,34,99,133,summer
2011-04-21,2,12,0,1,1,49,150,199,summer
2011-04-21,2,13,0,1,1,55,122,177,summer
2011-04-21,2,14,0,1,1,68,160,228,summer
2011-04-21,2,15,0,1,1,69,166,235,summer
2011-04-21,2,16,0,1,1,66,228,294,summer
2011-04-21,2,17,0,1,1,79,402,481,summer
2011-04-21,2,18,0,1,1,71,381,452,summer
2011-04-21,2,19,0,1,1,52,272,324,summer
2011-04-21,2,20,0,1,1,28,176,204,summer
2011-04-21,2,21,0,1,1,25,159,184,summer
2011-04-21,2,22,0,1,1,31,106,137,summer
2011-04-21,2,23,0,1,1,13,86,99,summer
2011-04-22,2,0,0,1,1,3,30,33,summer
2011-04-22,2,1,0,1,1,2,22,24,summer
2011-04-22,2,2,0,1,1,2,7,9,summer
2011-04-22,2,3,0,1,1,0,2,2,summer
2011-04-22,2,4,0,1,1,1,2,3,summer
2011-04-22,2,5,0,1,1,0,16,16,summer
2011-04-22,2,6,0,1,1,2,47,49,summer
2011-04-22,2,7,0,1,2,5,175,180,summer
2011-04-22,2,8,0,1,2,15,331,346,summer
2011-04-22,2,9,0,1,3,17,178,195,summer
2011-04-22,2,10,0,1,2,32,104,136,summer
2011-04-22,2,11,0,1,3,23,83,106,summer
2011-04-22,2,12,0,1,3,19,61,80,summer
2011-04-22,2,13,0,1,3,3,37,40,summer
2011-04-22,2,14,0,1,3,3,33,36,summer
2011-04-22,2,15,0,1,3,13,62,75,summer
2011-04-22,2,16,0,1,3,4,58,62,summer
2011-04-22,2,17,0,1,3,6,63,69,summer
2011-04-22,2,18,0,1,3,4,47,51,summer
2011-04-22,2,19,0,1,3,7,48,55,summer
2011-04-22,2,20,0,1,3,8,39,47,summer
2011-04-22,2,21,0,1,3,5,23,28,summer
2011-04-22,2,22,0,1,3,3,21,24,summer
2011-04-22,2,23,0,1,3,0,17,17,summer
2011-04-23,2,0,0,0,2,0,18,18,summer
2011-04-23,2,1,0,0,2,5,11,16,summer
2011-04-23,2,2,0,0,3,3,14,17,summer
2011-04-23,2,3,0,0,3,0,4,4,summer
2011-04-23,2,4,0,0,3,2,3,5,summer
2011-04-23,2,5,0,0,3,1,6,7,summer
2011-04-23,2,6,0,0,2,0,11,11,summer
2011-04-23,2,7,0,0,3,2,17,19,summer
2011-04-23,2,8,0,0,2,15,32,47,summer
2011-04-23,2,9,0,0,2,13,55,68,summer
2011-04-23,2,10,0,0,2,36,93,129,summer
2011-04-23,2,11,0,0,2,68,164,232,summer
2011-04-23,2,12,0,0,1,94,197,291,summer
2011-04-23,2,13,0,0,1,126,186,312,summer
2011-04-23,2,14,0,0,1,182,209,391,summer
2011-04-23,2,15,0,0,1,171,226,397,summer
2011-04-23,2,16,0,0,1,180,246,426,summer
2011-04-23,2,17,0,0,1,168,215,383,summer
2011-04-23,2,18,0,0,1,149,227,376,summer
2011-04-23,2,19,0,0,1,84,199,283,summer
2011-04-23,2,20,0,0,2,45,138,183,summer
2011-04-23,2,21,0,0,2,32,103,135,summer
2011-04-23,2,22,0,0,2,55,114,169,summer
2011-04-23,2,23,0,0,2,31,86,117,summer
2011-04-24,2,0,0,0,1,30,66,96,summer
2011-04-24,2,1,0,0,1,14,40,54,summer
2011-04-24,2,2,0,0,1,27,45,72,summer
2011-04-24,2,3,0,0,1,4,20,24,summer
2011-04-24,2,4,0,0,1,0,5,5,summer
2011-04-24,2,5,0,0,1,5,7,12,summer
2011-04-24,2,6,0,0,2,10,3,13,summer
2011-04-24,2,7,0,0,2,16,11,27,summer
2011-04-24,2,8,0,0,1,38,42,80,summer
2011-04-24,2,9,0,0,1,73,104,177,summer
2011-04-24,2,10,0,0,1,118,171,289,summer
2011-04-24,2,11,0,0,1,124,193,317,summer
2011-04-24,2,12,0,0,1,168,220,388,summer
2011-04-24,2,13,0,0,1,205,236,441,summer
2011-04-24,2,14,0,0,1,197,223,420,summer
2011-04-24,2,15,0,0,1,167,202,369,summer
2011-04-24,2,16,0,0,1,162,197,359,summer
2011-04-24,2,17,0,0,1,142,189,331,summer
2011-04-24,2,18,0,0,1,96,174,270,summer
2011-04-24,2,19,0,0,3,62,132,194,summer
2011-04-24,2,20,0,0,3,34,71,105,summer
2011-04-24,2,21,0,0,3,8,53,61,summer
2011-04-24,2,22,0,0,3,5,40,45,summer
2011-04-24,2,23,0,0,3,5,37,42,summer
2011-04-25,2,0,0,1,3,2,10,12,summer
2011-04-25,2,1,0,1,1,2,8,10,summer
2011-04-25,2,2,0,1,1,1,9,10,summer
2011-04-25,2,3,0,1,2,2,8,10,summer
2011-04-25,2,4,0,1,2,1,4,5,summer
2011-04-25,2,5,0,1,2,3,14,17,summer
2011-04-25,2,6,0,1,2,7,59,66,summer
2011-04-25,2,7,0,1,2,13,183,196,summer
2011-04-25,2,8,0,1,1,27,326,353,summer
2011-04-25,2,9,0,1,1,27,147,174,summer
2011-04-25,2,10,0,1,1,61,64,125,summer
2011-04-25,2,11,0,1,1,53,94,147,summer
2011-04-25,2,12,0,1,1,48,140,188,summer
2011-04-25,2,13,0,1,1,57,146,203,summer
2011-04-25,2,14,0,1,1,47,99,146,summer
2011-04-25,2,15,0,1,1,50,125,175,summer
2011-04-25,2,16,0,1,1,41,198,239,summer
2011-04-25,2,17,0,1,1,80,441,521,summer
2011-04-25,2,18,0,1,1,74,425,499,summer
2011-04-25,2,19,0,1,1,62,320,382,summer
2011-04-25,2,20,0,1,1,42,195,237,summer
2011-04-25,2,21,0,1,1,41,149,190,summer
2011-04-25,2,22,0,1,1,23,83,106,summer
2011-04-25,2,23,0,1,1,9,53,62,summer
2011-04-26,2,0,0,1,1,10,17,27,summer
2011-04-26,2,1,0,1,1,16,5,21,summer
2011-04-26,2,2,0,1,1,17,9,26,summer
2011-04-26,2,3,0,1,1,17,4,21,summer
2011-04-26,2,4,0,1,1,2,4,6,summer
2011-04-26,2,5,0,1,1,0,16,16,summer
2011-04-26,2,6,0,1,1,0,80,80,summer
2011-04-26,2,7,0,1,1,16,254,270,summer
2011-04-26,2,8,0,1,1,32,417,449,summer
2011-04-26,2,9,0,1,1,35,164,199,summer
2011-04-26,2,10,0,1,1,22,98,120,summer
2011-04-26,2,11,0,1,1,40,132,172,summer
2011-04-26,2,12,0,1,1,40,146,186,summer
2011-04-26,2,13,0,1,1,37,139,176,summer
2011-04-26,2,14,0,1,1,40,115,155,summer
2011-04-26,2,15,0,1,1,34,119,153,summer
2011-04-26,2,16,0,1,1,40,251,291,summer
2011-04-26,2,17,0,1,1,66,455,521,summer
2011-04-26,2,18,0,1,1,65,463,528,summer
2011-04-26,2,19,0,1,1,42,286,328,summer
2011-04-26,2,20,0,1,1,35,199,234,summer
2011-04-26,2,21,0,1,1,33,162,195,summer
2011-04-26,2,22,0,1,2,32,116,148,summer
2011-04-26,2,23,0,1,2,7,71,78,summer
2011-04-27,2,0,0,1,1,3,24,27,summer
2011-04-27,2,1,0,1,1,2,15,17,summer
2011-04-27,2,2,0,1,1,0,5,5,summer
2011-04-27,2,3,0,1,2,3,4,7,summer
2011-04-27,2,4,0,1,1,0,6,6,summer
2011-04-27,2,5,0,1,2,1,16,17,summer
2011-04-27,2,6,0,1,1,5,79,84,summer
2011-04-27,2,7,0,1,2,17,229,246,summer
2011-04-27,2,8,0,1,2,31,413,444,summer
2011-04-27,2,9,0,1,2,20,161,181,summer
2011-04-27,2,10,0,1,2,26,66,92,summer
2011-04-27,2,11,0,1,2,53,103,156,summer
2011-04-27,2,12,0,1,1,38,135,173,summer
2011-04-27,2,13,0,1,1,31,119,150,summer
2011-04-27,2,14,0,1,1,29,119,148,summer
2011-04-27,2,15,0,1,1,18,120,138,summer
2011-04-27,2,16,0,1,1,29,189,218,summer
2011-04-27,2,17,0,1,3,63,458,521,summer
2011-04-27,2,18,0,1,3,46,366,412,summer
2011-04-27,2,19,0,1,1,40,220,260,summer
2011-04-27,2,20,0,1,1,30,188,218,summer
2011-04-27,2,21,0,1,1,19,126,145,summer
2011-04-27,2,22,0,1,2,18,111,129,summer
2011-04-27,2,23,0,1,2,25,53,78,summer
2011-04-28,2,0,0,1,1,13,41,54,summer
2011-04-28,2,1,0,1,2,8,12,20,summer
2011-04-28,2,2,0,1,2,14,7,21,summer
2011-04-28,2,3,0,1,2,2,1,3,summer
2011-04-28,2,4,0,1,2,4,5,9,summer
2011-04-28,2,5,0,1,2,0,13,13,summer
2011-04-28,2,6,0,1,2,7,79,86,summer
2011-04-28,2,7,0,1,2,14,201,215,summer
2011-04-28,2,8,0,1,2,31,367,398,summer
2011-04-28,2,9,0,1,3,18,165,183,summer
2011-04-28,2,10,0,1,2,9,45,54,summer
2011-04-28,2,11,0,1,2,10,74,84,summer
2011-04-28,2,12,0,1,2,23,84,107,summer
2011-04-28,2,13,0,1,2,18,103,121,summer
2011-04-28,2,14,0,1,1,21,121,142,summer
2011-04-28,2,15,0,1,1,46,117,163,summer
2011-04-28,2,16,0,1,1,42,228,270,summer
2011-04-28,2,17,0,1,1,49,406,455,summer
2011-04-28,2,18,0,1,1,44,486,530,summer
2011-04-28,2,19,0,1,1,57,347,404,summer
2011-04-28,2,20,0,1,1,49,220,269,summer
2011-04-28,2,21,0,1,1,27,167,194,summer
2011-04-28,2,22,0,1,1,34,119,153,summer
2011-04-28,2,23,0,1,1,29,81,110,summer
2011-04-29,2,0,0,1,1,11,37,48,summer
2011-04-29,2,1,0,1,1,10,21,31,summer
2011-04-29,2,2,0,1,1,2,8,10,summer
2011-04-29,2,3,0,1,1,1,4,5,summer
2011-04-29,2,4,0,1,1,0,6,6,summer
2011-04-29,2,5,0,1,1,0,25,25,summer
2011-04-29,2,6,0,1,1,4,67,71,summer
2011-04-29,2,7,0,1,1,18,222,240,summer
2011-04-29,2,8,0,1,1,35,386,421,summer
2011-04-29,2,9,0,1,1,45,185,230,summer
2011-04-29,2,10,0,1,1,57,99,156,summer
2011-04-29,2,11,0,1,1,49,108,157,summer
2011-04-29,2,12,0,1,1,63,160,223,summer
2011-04-29,2,13,0,1,1,74,234,308,summer
2011-04-29,2,14,0,1,1,58,190,248,summer
2011-04-29,2,15,0,1,2,77,175,252,summer
2011-04-29,2,16,0,1,2,59,240,299,summer
2011-04-29,2,17,0,1,2,75,433,508,summer
2011-04-29,2,18,0,1,1,55,384,439,summer
2011-04-29,2,19,0,1,1,40,230,270,summer
2011-04-29,2,20,0,1,1,34,160,194,summer
2011-04-29,2,21,0,1,1,50,145,195,summer
2011-04-29,2,22,0,1,1,36,110,146,summer
2011-04-29,2,23,0,1,2,25,88,113,summer
2011-04-30,2,0,0,0,2,33,73,106,summer
2011-04-30,2,1,0,0,2,15,59,74,summer
2011-04-30,2,2,0,0,2,12,53,65,summer
2011-04-30,2,3,0,0,2,4,13,17,summer
2011-04-30,2,4,0,0,2,2,5,7,summer
2011-04-30,2,5,0,0,1,3,4,7,summer
2011-04-30,2,6,0,0,1,10,11,21,summer
2011-04-30,2,7,0,0,1,21,27,48,summer
2011-04-30,2,8,0,0,1,21,70,91,summer
2011-04-30,2,9,0,0,1,35,121,156,summer
2011-04-30,2,10,0,0,1,94,185,279,summer
2011-04-30,2,11,0,0,1,120,201,321,summer
2011-04-30,2,12,0,0,1,178,238,416,summer
2011-04-30,2,13,0,0,1,185,270,455,summer
2011-04-30,2,14,0,0,1,184,268,452,summer
2011-04-30,2,15,0,0,1,217,282,499,summer
2011-04-30,2,16,0,0,1,191,273,464,summer
2011-04-30,2,17,0,0,1,162,245,407,summer
2011-04-30,2,18,0,0,1,134,237,371,summer
2011-04-30,2,19,0,0,1,150,237,387,summer
2011-04-30,2,20,0,0,1,65,159,224,summer
2011-04-30,2,21,0,0,1,58,119,177,summer
2011-04-30,2,22,0,0,1,37,106,143,summer
2011-04-30,2,23,0,0,1,34,91,125,summer
2011-05-01,2,0,0,0,1,19,77,96,summer
2011-05-01,2,1,0,0,1,9,50,59,summer
2011-05-01,2,2,0,0,1,7,43,50,summer
2011-05-01,2,3,0,0,1,8,15,23,summer
2011-05-01,2,4,0,0,1,6,11,17,summer
2011-05-01,2,5,0,0,1,0,10,10,summer
2011-05-01,2,6,0,0,2,4,9,13,summer
2011-05-01,2,7,0,0,2,7,26,33,summer
2011-05-01,2,8,0,0,2,16,43,59,summer
2011-05-01,2,9,0,0,2,45,96,141,summer
2011-05-01,2,10,0,0,2,109,155,264,summer
2011-05-01,2,11,0,0,1,109,141,250,summer
2011-05-01,2,12,0,0,2,109,172,281,summer
2011-05-01,2,13,0,0,2,123,209,332,summer
2011-05-01,2,14,0,0,2,85,153,238,summer
2011-05-01,2,15,0,0,2,113,153,266,summer
2011-05-01,2,16,0,0,2,75,139,214,summer
2011-05-01,2,17,0,0,2,60,136,196,summer
2011-05-01,2,18,0,0,2,33,126,159,summer
2011-05-01,2,19,0,0,2,47,131,178,summer
2011-05-01,2,20,0,0,2,35,86,121,summer
2011-05-01,2,21,0,0,2,23,82,105,summer
2011-05-01,2,22,0,0,2,32,68,100,summer
2011-05-01,2,23,0,0,1,64,82,146,summer
2011-05-02,2,0,0,1,1,68,109,177,summer
2011-05-02,2,1,0,1,1,41,73,114,summer
2011-05-02,2,2,0,1,2,16,19,35,summer
2011-05-02,2,3,0,1,1,9,7,16,summer
2011-05-02,2,4,0,1,1,9,8,17,summer
2011-05-02,2,5,0,1,2,4,16,20,summer
2011-05-02,2,6,0,1,1,3,59,62,summer
2011-05-02,2,7,0,1,2,16,193,209,summer
2011-05-02,2,8,0,1,2,21,350,371,summer
2011-05-02,2,9,0,1,2,41,131,172,summer
2011-05-02,2,10,0,1,2,31,77,108,summer
2011-05-02,2,11,0,1,1,34,96,130,summer
2011-05-02,2,12,0,1,1,40,147,187,summer
2011-05-02,2,13,0,1,2,51,119,170,summer
2011-05-02,2,14,0,1,1,48,133,181,summer
2011-05-02,2,15,0,1,1,45,110,155,summer
2011-05-02,2,16,0,1,1,49,220,269,summer
2011-05-02,2,17,0,1,1,65,472,537,summer
2011-05-02,2,18,0,1,2,68,450,518,summer
2011-05-02,2,19,0,1,2,46,268,314,summer
2011-05-02,2,20,0,1,2,44,174,218,summer
2011-05-02,2,21,0,1,2,54,178,232,summer
2011-05-02,2,22,0,1,2,28,97,125,summer
2011-05-02,2,23,0,1,2,16,48,64,summer
2011-05-03,2,0,0,1,2,0,16,16,summer
2011-05-03,2,1,0,1,2,0,14,14,summer
2011-05-03,2,2,0,1,2,0,5,5,summer
2011-05-03,2,3,0,1,1,0,2,2,summer
2011-05-03,2,4,0,1,1,3,1,4,summer
2011-05-03,2,5,0,1,1,0,14,14,summer
2011-05-03,2,6,0,1,2,7,102,109,summer
2011-05-03,2,7,0,1,2,17,248,265,summer
2011-05-03,2,8,0,1,2,24,435,459,summer
2011-05-03,2,9,0,1,2,29,157,186,summer
2011-05-03,2,10,0,1,2,36,91,127,summer
2011-05-03,2,11,0,1,2,20,120,140,summer
2011-05-03,2,12,0,1,2,48,169,217,summer
2011-05-03,2,13,0,1,2,50,144,194,summer
2011-05-03,2,14,0,1,2,36,122,158,summer
2011-05-03,2,15,0,1,2,37,117,154,summer
2011-05-03,2,16,0,1,1,46,225,271,summer
2011-05-03,2,17,0,1,1,53,464,517,summer
2011-05-03,2,18,0,1,1,59,485,544,summer
2011-05-03,2,19,0,1,1,42,323,365,summer
2011-05-03,2,20,0,1,1,28,262,290,summer
2011-05-03,2,21,0,1,2,42,183,225,summer
2011-05-03,2,22,0,1,2,14,99,113,summer
2011-05-03,2,23,0,1,2,12,50,62,summer
2011-05-04,2,0,0,1,3,5,22,27,summer
2011-05-04,2,1,0,1,3,1,6,7,summer
2011-05-04,2,2,0,1,3,0,4,4,summer
2011-05-04,2,3,0,1,3,0,1,1,summer
2011-05-04,2,4,0,1,3,1,2,3,summer
2011-05-04,2,5,0,1,3,1,8,9,summer
2011-05-04,2,6,0,1,3,0,21,21,summer
2011-05-04,2,7,0,1,3,6,46,52,summer
2011-05-04,2,8,0,1,3,5,74,79,summer
2011-05-04,2,9,0,1,3,5,35,40,summer
2011-05-04,2,10,0,1,2,5,26,31,summer
2011-05-04,2,11,0,1,1,3,69,72,summer
2011-05-04,2,12,0,1,2,19,105,124,summer
2011-05-04,2,13,0,1,2,15,128,143,summer
2011-05-04,2,14,0,1,1,13,94,107,summer
2011-05-04,2,15,0,1,1,22,107,129,summer
2011-05-04,2,16,0,1,1,22,173,195,summer
2011-05-04,2,17,0,1,1,22,388,410,summer
2011-05-04,2,18,0,1,1,29,367,396,summer
2011-05-04,2,19,0,1,1,30,266,296,summer
2011-05-04,2,20,0,1,1,17,174,191,summer
2011-05-04,2,21,0,1,1,17,133,150,summer
2011-05-04,2,22,0,1,1,9,80,89,summer
2011-05-04,2,23,0,1,1,8,49,57,summer
2011-05-05,2,0,0,1,1,4,23,27,summer
2011-05-05,2,1,0,1,1,4,6,10,summer
2011-05-05,2,2,0,1,1,1,4,5,summer
2011-05-05,2,3,0,1,1,0,4,4,summer
2011-05-05,2,4,0,1,1,4,3,7,summer
2011-05-05,2,5,0,1,1,1,29,30,summer
2011-05-05,2,6,0,1,1,3,86,89,summer
2011-05-05,2,7,0,1,1,16,255,271,summer
2011-05-05,2,8,0,1,1,25,415,440,summer
2011-05-05,2,9,0,1,1,20,164,184,summer
2011-05-05,2,10,0,1,1,30,98,128,summer
2011-05-05,2,11,0,1,1,43,105,148,summer
2011-05-05,2,12,0,1,1,27,169,196,summer
2011-05-05,2,13,0,1,1,50,142,192,summer
2011-05-05,2,14,0,1,1,19,135,154,summer
2011-05-05,2,15,0,1,1,27,120,147,summer
2011-05-05,2,16,0,1,1,36,233,269,summer
2011-05-05,2,17,0,1,1,66,467,533,summer
2011-05-05,2,18,0,1,1,64,456,520,summer
2011-05-05,2,19,0,1,1,56,305,361,summer
2011-05-05,2,20,0,1,1,33,225,258,summer
2011-05-05,2,21,0,1,1,39,141,180,summer
2011-05-05,2,22,0,1,1,30,135,165,summer
2011-05-05,2,23,0,1,1,16,99,115,summer
2011-05-06,2,0,0,1,1,13,43,56,summer
2011-05-06,2,1,0,1,1,8,24,32,summer
2011-05-06,2,2,0,1,1,1,15,16,summer
2011-05-06,2,3,0,1,1,3,6,9,summer
2011-05-06,2,4,0,1,1,0,1,1,summer
2011-05-06,2,5,0,1,1,0,16,16,summer
2011-05-06,2,6,0,1,1,8,74,82,summer
2011-05-06,2,7,0,1,1,20,202,222,summer
2011-05-06,2,8,0,1,1,35,415,450,summer
2011-05-06,2,9,0,1,1,27,161,188,summer
2011-05-06,2,10,0,1,2,30,97,127,summer
2011-05-06,2,11,0,1,2,42,123,165,summer
2011-05-06,2,12,0,1,1,48,198,246,summer
2011-05-06,2,13,0,1,1,71,182,253,summer
2011-05-06,2,14,0,1,1,86,127,213,summer
2011-05-06,2,15,0,1,1,89,171,260,summer
2011-05-06,2,16,0,1,1,82,262,344,summer
2011-05-06,2,17,0,1,1,83,470,553,summer
2011-05-06,2,18,0,1,3,85,385,470,summer
2011-05-06,2,19,0,1,3,39,253,292,summer
2011-05-06,2,20,0,1,1,29,161,190,summer
2011-05-06,2,21,0,1,1,22,130,152,summer
2011-05-06,2,22,0,1,1,46,105,151,summer
2011-05-06,2,23,0,1,1,27,93,120,summer
2011-05-07,2,0,0,0,1,10,76,86,summer
2011-05-07,2,1,0,0,1,8,50,58,summer
2011-05-07,2,2,0,0,1,5,47,52,summer
2011-05-07,2,3,0,0,1,9,9,18,summer
2011-05-07,2,4,0,0,1,1,4,5,summer
2011-05-07,2,5,0,0,1,4,3,7,summer
2011-05-07,2,6,0,0,1,1,12,13,summer
2011-05-07,2,7,0,0,1,8,32,40,summer
2011-05-07,2,8,0,0,1,19,96,115,summer
2011-05-07,2,9,0,0,1,54,164,218,summer
2011-05-07,2,10,0,0,1,90,208,298,summer
2011-05-07,2,11,0,0,1,132,215,347,summer
2011-05-07,2,12,0,0,1,129,244,373,summer
2011-05-07,2,13,0,0,1,196,240,436,summer
2011-05-07,2,14,0,0,3,143,235,378,summer
2011-05-07,2,15,0,0,1,148,230,378,summer
2011-05-07,2,16,0,0,1,119,223,342,summer
2011-05-07,2,17,0,0,1,138,216,354,summer
2011-05-07,2,18,0,0,1,114,175,289,summer
2011-05-07,2,19,0,0,1,88,179,267,summer
2011-05-07,2,20,0,0,1,82,137,219,summer
2011-05-07,2,21,0,0,1,58,124,182,summer
2011-05-07,2,22,0,0,1,26,94,120,summer
2011-05-07,2,23,0,0,1,30,89,119,summer
2011-05-08,2,0,0,0,2,22,78,100,summer
2011-05-08,2,1,0,0,2,8,56,64,summer
2011-05-08,2,2,0,0,1,17,42,59,summer
2011-05-08,2,3,0,0,1,10,21,31,summer
2011-05-08,2,4,0,0,1,2,8,10,summer
2011-05-08,2,5,0,0,2,0,5,5,summer
2011-05-08,2,6,0,0,2,2,4,6,summer
2011-05-08,2,7,0,0,2,8,15,23,summer
2011-05-08,2,8,0,0,1,28,58,86,summer
2011-05-08,2,9,0,0,1,48,112,160,summer
2011-05-08,2,10,0,0,1,91,153,244,summer
2011-05-08,2,11,0,0,1,142,198,340,summer
2011-05-08,2,12,0,0,1,139,243,382,summer
2011-05-08,2,13,0,0,1,166,224,390,summer
2011-05-08,2,14,0,0,1,126,240,366,summer
2011-05-08,2,15,0,0,1,128,230,358,summer
2011-05-08,2,16,0,0,1,122,263,385,summer
2011-05-08,2,17,0,0,3,106,245,351,summer
2011-05-08,2,18,0,0,1,63,205,268,summer
2011-05-08,2,19,0,0,1,61,178,239,summer
2011-05-08,2,20,0,0,1,42,132,174,summer
2011-05-08,2,21,0,0,1,32,95,127,summer
2011-05-08,2,22,0,0,1,29,86,115,summer
2011-05-08,2,23,0,0,1,9,41,50,summer
2011-05-09,2,0,0,1,1,31,22,53,summer
2011-05-09,2,1,0,1,1,25,8,33,summer
2011-05-09,2,2,0,1,1,6,2,8,summer
2011-05-09,2,3,0,1,1,0,7,7,summer
2011-05-09,2,4,0,1,1,0,4,4,summer
2011-05-09,2,5,0,1,1,0,23,23,summer
2011-05-09,2,6,0,1,1,2,87,89,summer
2011-05-09,2,7,0,1,1,16,221,237,summer
2011-05-09,2,8,0,1,1,23,351,374,summer
2011-05-09,2,9,0,1,1,36,142,178,summer
2011-05-09,2,10,0,1,1,24,95,119,summer
2011-05-09,2,11,0,1,1,26,99,125,summer
2011-05-09,2,12,0,1,1,35,160,195,summer
2011-05-09,2,13,0,1,1,36,138,174,summer
2011-05-09,2,14,0,1,1,44,118,162,summer
2011-05-09,2,15,0,1,1,51,148,199,summer
2011-05-09,2,16,0,1,1,49,255,304,summer
2011-05-09,2,17,0,1,1,59,539,598,summer
2011-05-09,2,18,0,1,1,66,458,524,summer
2011-05-09,2,19,0,1,1,45,339,384,summer
2011-05-09,2,20,0,1,1,25,214,239,summer
2011-05-09,2,21,0,1,1,28,128,156,summer
2011-05-09,2,22,0,1,1,21,95,116,summer
2011-05-09,2,23,0,1,1,16,45,61,summer
2011-05-10,2,0,0,1,1,6,12,18,summer
2011-05-10,2,1,0,1,1,3,12,15,summer
2011-05-10,2,2,0,1,1,1,4,5,summer
2011-05-10,2,3,0,1,1,1,3,4,summer
2011-05-10,2,4,0,1,1,0,2,2,summer
2011-05-10,2,5,0,1,1,1,28,29,summer
2011-05-10,2,6,0,1,1,9,103,112,summer
2011-05-10,2,7,0,1,2,13,301,314,summer
2011-05-10,2,8,0,1,2,28,397,425,summer
2011-05-10,2,9,0,1,2,29,176,205,summer
2011-05-10,2,10,0,1,2,27,100,127,summer
2011-05-10,2,11,0,1,2,17,108,125,summer
2011-05-10,2,12,0,1,2,47,170,217,summer
2011-05-10,2,13,0,1,2,50,152,202,summer
2011-05-10,2,14,0,1,2,42,134,176,summer
2011-05-10,2,15,0,1,2,28,152,180,summer
2011-05-10,2,16,0,1,1,56,271,327,summer
2011-05-10,2,17,0,1,1,79,532,611,summer
2011-05-10,2,18,0,1,1,70,480,550,summer
2011-05-10,2,19,0,1,1,69,365,434,summer
2011-05-10,2,20,0,1,1,50,241,291,summer
2011-05-10,2,21,0,1,1,30,173,203,summer
2011-05-10,2,22,0,1,1,29,121,150,summer
2011-05-10,2,23,0,1,2,9,72,81,summer
2011-05-11,2,0,0,1,2,8,30,38,summer
2011-05-11,2,1,0,1,2,4,16,20,summer
2011-05-11,2,2,0,1,1,6,4,10,summer
2011-05-11,2,3,0,1,1,0,3,3,summer
2011-05-11,2,4,0,1,2,0,2,2,summer
2011-05-11,2,5,0,1,1,0,20,20,summer
2011-05-11,2,6,0,1,1,6,93,99,summer
2011-05-11,2,7,0,1,1,25,293,318,summer
2011-05-11,2,8,0,1,1,21,421,442,summer
2011-05-11,2,9,0,1,1,21,182,203,summer
2011-05-11,2,10,0,1,1,30,124,154,summer
2011-05-11,2,11,0,1,1,18,123,141,summer
2011-05-11,2,12,0,1,1,41,185,226,summer
2011-05-11,2,13,0,1,1,36,157,193,summer
2011-05-11,2,14,0,1,1,36,141,177,summer
2011-05-11,2,15,0,1,1,48,131,179,summer
2011-05-11,2,16,0,1,1,49,240,289,summer
2011-05-11,2,17,0,1,1,17,242,259,summer
2011-05-11,2,18,0,1,1,40,234,274,summer
2011-05-11,2,19,0,1,1,60,341,401,summer
2011-05-11,2,20,0,1,1,28,245,273,summer
2011-05-11,2,21,0,1,1,32,202,234,summer
2011-05-11,2,22,0,1,1,12,134,146,summer
2011-05-11,2,23,0,1,1,12,69,81,summer
2011-05-12,2,0,0,1,2,5,39,44,summer
2011-05-12,2,1,0,1,1,1,16,17,summer
2011-05-12,2,2,0,1,1,1,14,15,summer
2011-05-12,2,3,0,1,1,0,5,5,summer
2011-05-12,2,4,0,1,1,1,5,6,summer
2011-05-12,2,5,0,1,1,2,27,29,summer
2011-05-12,2,6,0,1,1,9,103,112,summer
2011-05-12,2,7,0,1,1,14,283,297,summer
2011-05-12,2,8,0,1,1,27,394,421,summer
2011-05-12,2,9,0,1,2,21,191,212,summer
2011-05-12,2,10,0,1,2,28,119,147,summer
2011-05-12,2,11,0,1,1,43,136,179,summer
2011-05-12,2,12,0,1,1,43,164,207,summer
2011-05-12,2,13,0,1,2,48,170,218,summer
2011-05-12,2,14,0,1,2,43,148,191,summer
2011-05-12,2,15,0,1,2,54,163,217,summer
2011-05-12,2,16,0,1,2,50,238,288,summer
2011-05-12,2,17,0,1,2,54,540,594,summer
2011-05-12,2,18,0,1,1,64,463,527,summer
2011-05-12,2,19,0,1,2,59,305,364,summer
2011-05-12,2,20,0,1,1,56,220,276,summer
2011-05-12,2,21,0,1,1,31,192,223,summer
2011-05-12,2,22,0,1,1,25,147,172,summer
2011-05-12,2,23,0,1,2,16,87,103,summer
2011-05-13,2,0,0,1,2,6,46,52,summer
2011-05-13,2,1,0,1,1,5,15,20,summer
2011-05-13,2,2,0,1,2,3,8,11,summer
2011-05-13,2,3,0,1,2,2,2,4,summer
2011-05-13,2,4,0,1,3,2,3,5,summer
2011-05-13,2,5,0,1,2,1,24,25,summer
2011-05-13,2,6,0,1,3,6,76,82,summer
2011-05-13,2,7,0,1,3,16,141,157,summer
2011-05-13,2,8,0,1,2,26,361,387,summer
2011-05-13,2,9,0,1,2,18,215,233,summer
2011-05-13,2,10,0,1,2,31,99,130,summer
2011-05-13,2,11,0,1,2,56,90,146,summer
2011-05-13,2,12,0,1,2,53,170,223,summer
2011-05-13,2,13,0,1,2,69,157,226,summer
2011-05-13,2,14,0,1,2,70,120,190,summer
2011-05-13,2,15,0,1,2,56,142,198,summer
2011-05-13,2,16,0,1,2,44,256,300,summer
2011-05-13,2,17,0,1,3,62,429,491,summer
2011-05-13,2,18,0,1,3,39,359,398,summer
2011-05-13,2,19,0,1,2,25,245,270,summer
2011-05-13,2,20,0,1,2,22,130,152,summer
2011-05-13,2,21,0,1,2,24,130,154,summer
2011-05-13,2,22,0,1,2,25,107,132,summer
2011-05-13,2,23,0,1,3,31,88,119,summer
2011-05-14,2,0,0,0,2,24,78,102,summer
2011-05-14,2,1,0,0,2,18,64,82,summer
2011-05-14,2,2,0,0,2,15,37,52,summer
2011-05-14,2,3,0,0,2,5,30,35,summer
2011-05-14,2,4,0,0,2,1,4,5,summer
2011-05-14,2,5,0,0,2,7,7,14,summer
2011-05-14,2,6,0,0,2,2,9,11,summer
2011-05-14,2,7,0,0,3,4,28,32,summer
2011-05-14,2,8,0,0,3,16,72,88,summer
2011-05-14,2,9,0,0,2,14,86,100,summer
2011-05-14,2,10,0,0,2,34,133,167,summer
2011-05-14,2,11,0,0,2,72,207,279,summer
2011-05-14,2,12,0,0,3,75,204,279,summer
2011-05-14,2,13,0,0,3,68,180,248,summer
2011-05-14,2,14,0,0,2,57,159,216,summer
2011-05-14,2,15,0,0,2,73,221,294,summer
2011-05-14,2,16,0,0,2,107,188,295,summer
2011-05-14,2,17,0,0,2,78,194,272,summer
2011-05-14,2,18,0,0,2,88,216,304,summer
2011-05-14,2,19,0,0,3,69,179,248,summer
2011-05-14,2,20,0,0,3,42,115,157,summer
2011-05-14,2,21,0,0,3,15,44,59,summer
2011-05-14,2,22,0,0,3,7,19,26,summer
2011-05-14,2,23,0,0,3,11,33,44,summer
2011-05-15,2,0,0,0,2,5,34,39,summer
2011-05-15,2,1,0,0,2,4,43,47,summer
2011-05-15,2,2,0,0,2,13,37,50,summer
2011-05-15,2,3,0,0,2,11,21,32,summer
2011-05-15,2,4,0,0,2,5,8,13,summer
2011-05-15,2,5,0,0,3,3,11,14,summer
2011-05-15,2,6,0,0,2,3,14,17,summer
2011-05-15,2,7,0,0,2,4,38,42,summer
2011-05-15,2,8,0,0,2,24,46,70,summer
2011-05-15,2,9,0,0,1,36,98,134,summer
2011-05-15,2,10,0,0,1,73,153,226,summer
2011-05-15,2,11,0,0,1,120,202,322,summer
2011-05-15,2,12,0,0,1,120,247,367,summer
2011-05-15,2,13,0,0,1,195,261,456,summer
2011-05-15,2,14,0,0,1,183,254,437,summer
2011-05-15,2,15,0,0,1,206,253,459,summer
2011-05-15,2,16,0,0,1,158,282,440,summer
2011-05-15,2,17,0,0,3,137,255,392,summer
2011-05-15,2,18,0,0,1,60,177,237,summer
2011-05-15,2,19,0,0,1,78,153,231,summer
2011-05-15,2,20,0,0,1,53,138,191,summer
2011-05-15,2,21,0,0,1,44,107,151,summer
2011-05-15,2,22,0,0,1,29,88,117,summer
2011-05-15,2,23,0,0,1,18,51,69,summer
2011-05-16,2,0,0,1,1,17,21,38,summer
2011-05-16,2,1,0,1,1,6,8,14,summer
2011-05-16,2,2,0,1,1,4,9,13,summer
2011-05-16,2,3,0,1,1,1,3,4,summer
2011-05-16,2,4,0,1,1,1,5,6,summer
2011-05-16,2,5,0,1,1,1,20,21,summer
2011-05-16,2,6,0,1,1,11,93,104,summer
2011-05-16,2,7,0,1,1,27,245,272,summer
2011-05-16,2,8,0,1,1,28,366,394,summer
2011-05-16,2,9,0,1,1,38,156,194,summer
2011-05-16,2,10,0,1,1,37,75,112,summer
2011-05-16,2,11,0,1,1,56,129,185,summer
2011-05-16,2,12,0,1,1,72,137,209,summer
2011-05-16,2,13,0,1,1,61,153,214,summer
2011-05-16,2,14,0,1,1,76,117,193,summer
2011-05-16,2,15,0,1,1,55,110,165,summer
2011-05-16,2,16,0,1,3,45,181,226,summer
2011-05-16,2,17,0,1,1,47,227,274,summer
2011-05-16,2,18,0,1,3,55,398,453,summer
2011-05-16,2,19,0,1,1,36,272,308,summer
2011-05-16,2,20,0,1,1,31,167,198,summer
2011-05-16,2,21,0,1,1,28,149,177,summer
2011-05-16,2,22,0,1,1,22,105,127,summer
2011-05-16,2,23,0,1,1,18,39,57,summer
2011-05-17,2,0,0,1,2,13,18,31,summer
2011-05-17,2,1,0,1,3,7,6,13,summer
2011-05-17,2,2,0,1,3,4,4,8,summer
2011-05-17,2,3,0,1,3,1,3,4,summer
2011-05-17,2,4,0,1,3,2,2,4,summer
2011-05-17,2,5,0,1,3,0,22,22,summer
2011-05-17,2,6,0,1,3,0,49,49,summer
2011-05-17,2,7,0,1,2,13,138,151,summer
2011-05-17,2,8,0,1,2,22,325,347,summer
2011-05-17,2,9,0,1,2,17,190,207,summer
2011-05-17,2,10,0,1,3,31,73,104,summer
2011-05-17,2,11,0,1,2,26,104,130,summer
2011-05-17,2,12,0,1,3,38,115,153,summer
2011-05-17,2,13,0,1,2,31,141,172,summer
2011-05-17,2,14,0,1,1,61,123,184,summer
2011-05-17,2,15,0,1,1,79,131,210,summer
2011-05-17,2,16,0,1,1,73,217,290,summer
2011-05-17,2,17,0,1,1,83,521,604,summer
2011-05-17,2,18,0,1,1,54,426,480,summer
2011-05-17,2,19,0,1,1,51,298,349,summer
2011-05-17,2,20,0,1,1,30,253,283,summer
2011-05-17,2,21,0,1,1,23,151,174,summer
2011-05-17,2,22,0,1,2,12,86,98,summer
2011-05-17,2,23,0,1,2,7,49,56,summer
2011-05-18,2,0,0,1,2,8,15,23,summer
2011-05-18,2,1,0,1,2,3,9,12,summer
2011-05-18,2,2,0,1,3,1,5,6,summer
2011-05-18,2,3,0,1,3,6,3,9,summer
2011-05-18,2,4,0,1,3,1,2,3,summer
2011-05-18,2,5,0,1,1,0,9,9,summer
2011-05-18,2,6,0,1,1,2,99,101,summer
2011-05-18,2,7,0,1,1,14,260,274,summer
2011-05-18,2,8,0,1,1,25,428,453,summer
2011-05-18,2,9,0,1,3,26,176,202,summer
2011-05-18,2,10,0,1,3,33,73,106,summer
2011-05-18,2,11,0,1,2,6,17,23,summer
2011-05-18,2,12,0,1,1,12,42,54,summer
2011-05-18,2,13,0,1,2,30,92,122,summer
2011-05-18,2,14,0,1,2,44,94,138,summer
2011-05-18,2,15,0,1,1,34,133,167,summer
2011-05-18,2,16,0,1,1,53,241,294,summer
2011-05-18,2,17,0,1,1,78,487,565,summer
2011-05-18,2,18,0,1,1,58,431,489,summer
2011-05-18,2,19,0,1,3,43,288,331,summer
2011-05-18,2,20,0,1,3,24,189,213,summer
2011-05-18,2,21,0,1,1,11,74,85,summer
2011-05-18,2,22,0,1,1,14,103,117,summer
2011-05-18,2,23,0,1,1,10,49,59,summer
2011-05-19,2,0,0,1,1,6,23,29,summer
2011-05-19,2,1,0,1,1,2,4,6,summer
2011-05-19,2,2,0,1,1,3,12,15,summer
2011-05-19,2,3,0,1,1,1,3,4,summer
2011-05-19,2,4,0,1,1,2,3,5,summer
2011-05-19,2,5,0,1,1,2,24,26,summer
2011-05-19,2,6,0,1,2,17,86,103,summer
2011-05-19,2,7,0,1,2,18,239,257,summer
2011-05-19,2,8,0,1,2,34,453,487,summer
2011-05-19,2,9,0,1,2,40,176,216,summer
2011-05-19,2,10,0,1,2,35,95,130,summer
2011-05-19,2,11,0,1,3,53,111,164,summer
2011-05-19,2,12,0,1,2,38,130,168,summer
2011-05-19,2,13,0,1,3,44,139,183,summer
2011-05-19,2,14,0,1,3,43,137,180,summer
2011-05-19,2,15,0,1,1,63,125,188,summer
2011-05-19,2,16,0,1,1,55,247,302,summer
2011-05-19,2,17,0,1,1,60,487,547,summer
2011-05-19,2,18,0,1,1,59,454,513,summer
2011-05-19,2,19,0,1,1,65,345,410,summer
2011-05-19,2,20,0,1,1,46,236,282,summer
2011-05-19,2,21,0,1,1,29,180,209,summer
2011-05-19,2,22,0,1,3,11,68,79,summer
2011-05-19,2,23,0,1,1,9,63,72,summer
2011-05-20,2,0,0,1,1,15,33,48,summer
2011-05-20,2,1,0,1,1,8,17,25,summer
2011-05-20,2,2,0,1,1,4,4,8,summer
2011-05-20,2,3,0,1,1,1,4,5,summer
2011-05-20,2,4,0,1,1,1,4,5,summer
2011-05-20,2,5,0,1,1,0,28,28,summer
2011-05-20,2,6,0,1,1,15,102,117,summer
2011-05-20,2,7,0,1,1,30,289,319,summer
2011-05-20,2,8,0,1,1,41,476,517,summer
2011-05-20,2,9,0,1,1,35,199,234,summer
2011-05-20,2,10,0,1,1,44,104,148,summer
2011-05-20,2,11,0,1,2,63,133,196,summer
2011-05-20,2,12,0,1,2,69,186,255,summer
2011-05-20,2,13,0,1,3,60,172,232,summer
2011-05-20,2,14,0,1,1,66,131,197,summer
2011-05-20,2,15,0,1,2,74,168,242,summer
2011-05-20,2,16,0,1,2,61,269,330,summer
2011-05-20,2,17,0,1,1,71,483,554,summer
2011-05-20,2,18,0,1,1,79,394,473,summer
2011-05-20,2,19,0,1,1,49,253,302,summer
2011-05-20,2,20,0,1,1,40,180,220,summer
2011-05-20,2,21,0,1,1,40,155,195,summer
2011-05-20,2,22,0,1,1,28,124,152,summer
2011-05-20,2,23,0,1,1,15,100,115,summer
2011-05-21,2,0,0,0,1,20,78,98,summer
2011-05-21,2,1,0,0,1,8,64,72,summer
2011-05-21,2,2,0,0,1,5,35,40,summer
2011-05-21,2,3,0,0,1,7,12,19,summer
2011-05-21,2,4,0,0,1,1,6,7,summer
2011-05-21,2,5,0,0,1,1,4,5,summer
2011-05-21,2,6,0,0,1,6,22,28,summer
2011-05-21,2,7,0,0,1,10,33,43,summer
2011-05-21,2,8,0,0,1,29,97,126,summer
2011-05-21,2,9,0,0,1,60,165,225,summer
2011-05-21,2,10,0,0,1,122,201,323,summer
2011-05-21,2,11,0,0,1,173,245,418,summer
2011-05-21,2,12,0,0,1,222,271,493,summer
2011-05-21,2,13,0,0,1,191,271,462,summer
2011-05-21,2,14,0,0,1,187,269,456,summer
2011-05-21,2,15,0,0,1,232,274,506,summer
2011-05-21,2,16,0,0,2,204,267,471,summer
2011-05-21,2,17,0,0,2,191,253,444,summer
2011-05-21,2,18,0,0,2,191,253,444,summer
2011-05-21,2,19,0,0,1,117,184,301,summer
2011-05-21,2,20,0,0,1,84,164,248,summer
2011-05-21,2,21,0,0,1,77,150,227,summer
2011-05-21,2,22,0,0,1,78,126,204,summer
2011-05-21,2,23,0,0,1,42,103,145,summer
2011-05-22,2,0,0,0,1,31,100,131,summer
2011-05-22,2,1,0,0,1,17,81,98,summer
2011-05-22,2,2,0,0,1,18,50,68,summer
2011-05-22,2,3,0,0,1,10,23,33,summer
2011-05-22,2,4,0,0,1,3,9,12,summer
2011-05-22,2,5,0,0,1,1,5,6,summer
2011-05-22,2,6,0,0,1,5,13,18,summer
2011-05-22,2,7,0,0,1,13,27,40,summer
2011-05-22,2,8,0,0,1,29,65,94,summer
2011-05-22,2,9,0,0,1,59,130,189,summer
2011-05-22,2,10,0,0,1,135,170,305,summer
2011-05-22,2,11,0,0,1,164,209,373,summer
2011-05-22,2,12,0,0,2,146,255,401,summer
2011-05-22,2,13,0,0,2,180,275,455,summer
2011-05-22,2,14,0,0,3,125,191,316,summer
2011-05-22,2,15,0,0,2,110,221,331,summer
2011-05-22,2,16,0,0,1,72,201,273,summer
2011-05-22,2,17,0,0,1,93,213,306,summer
2011-05-22,2,18,0,0,1,120,238,358,summer
2011-05-22,2,19,0,0,1,107,193,300,summer
2011-05-22,2,20,0,0,1,57,174,231,summer
2011-05-22,2,21,0,0,1,27,109,136,summer
2011-05-22,2,22,0,0,1,35,86,121,summer
2011-05-22,2,23,0,0,2,19,46,65,summer
2011-05-23,2,0,0,1,2,23,18,41,summer
2011-05-23,2,1,0,1,1,4,5,9,summer
2011-05-23,2,2,0,1,3,2,3,5,summer
2011-05-23,2,3,0,1,3,0,4,4,summer
2011-05-23,2,4,0,1,2,2,2,4,summer
2011-05-23,2,5,0,1,2,0,11,11,summer
2011-05-23,2,6,0,1,2,4,92,96,summer
2011-05-23,2,7,0,1,2,13,223,236,summer
2011-05-23,2,8,0,1,1,50,359,409,summer
2011-05-23,2,9,0,1,1,36,131,167,summer
2011-05-23,2,10,0,1,1,49,72,121,summer
2011-05-23,2,11,0,1,1,73,107,180,summer
2011-05-23,2,12,0,1,1,65,139,204,summer
2011-05-23,2,13,0,1,2,49,155,204,summer
2011-05-23,2,14,0,1,2,57,130,187,summer
2011-05-23,2,15,0,1,2,57,119,176,summer
2011-05-23,2,16,0,1,2,56,223,279,summer
2011-05-23,2,17,0,1,3,56,373,429,summer
2011-05-23,2,18,0,1,1,68,385,453,summer
2011-05-23,2,19,0,1,1,56,302,358,summer
2011-05-23,2,20,0,1,1,39,271,310,summer
2011-05-23,2,21,0,1,1,33,155,188,summer
2011-05-23,2,22,0,1,1,25,106,131,summer
2011-05-23,2,23,0,1,2,19,53,72,summer
2011-05-24,2,0,0,1,2,12,23,35,summer
2011-05-24,2,1,0,1,2,6,9,15,summer
2011-05-24,2,2,0,1,2,2,8,10,summer
2011-05-24,2,3,0,1,2,0,2,2,summer
2011-05-24,2,4,0,1,1,1,3,4,summer
2011-05-24,2,5,0,1,2,2,22,24,summer
2011-05-24,2,6,0,1,2,10,102,112,summer
2011-05-24,2,7,0,1,3,26,288,314,summer
2011-05-24,2,8,0,1,3,31,403,434,summer
2011-05-24,2,9,0,1,2,27,111,138,summer
2011-05-24,2,10,0,1,1,18,90,108,summer
2011-05-24,2,11,0,1,1,33,142,175,summer
2011-05-24,2,12,0,1,1,41,129,170,summer
2011-05-24,2,13,0,1,1,38,152,190,summer
2011-05-24,2,14,0,1,1,27,126,153,summer
2011-05-24,2,15,0,1,3,59,129,188,summer
2011-05-24,2,16,0,1,1,52,225,277,summer
2011-05-24,2,17,0,1,1,56,492,548,summer
2011-05-24,2,18,0,1,1,74,490,564,summer
2011-05-24,2,19,0,1,1,45,310,355,summer
2011-05-24,2,20,0,1,1,39,241,280,summer
2011-05-24,2,21,0,1,1,21,168,189,summer
2011-05-24,2,22,0,1,3,26,115,141,summer
2011-05-24,2,23,0,1,3,13,53,66,summer
2011-05-25,2,0,0,1,3,3,32,35,summer
2011-05-25,2,1,0,1,3,6,2,8,summer
2011-05-25,2,2,0,1,2,0,8,8,summer
2011-05-25,2,3,0,1,1,0,9,9,summer
2011-05-25,2,4,0,1,1,0,3,3,summer
2011-05-25,2,5,0,1,1,2,23,25,summer
2011-05-25,2,6,0,1,1,4,113,117,summer
2011-05-25,2,7,0,1,1,29,284,313,summer
2011-05-25,2,8,0,1,1,36,495,531,summer
2011-05-25,2,9,0,1,1,27,207,234,summer
2011-05-25,2,10,0,1,1,30,105,135,summer
2011-05-25,2,11,0,1,1,36,104,140,summer
2011-05-25,2,12,0,1,1,32,178,210,summer
2011-05-25,2,13,0,1,1,39,163,202,summer
2011-05-25,2,14,0,1,1,47,121,168,summer
2011-05-25,2,15,0,1,1,37,145,182,summer
2011-05-25,2,16,0,1,1,61,238,299,summer
2011-05-25,2,17,0,1,1,77,524,601,summer
2011-05-25,2,18,0,1,1,66,451,517,summer
2011-05-25,2,19,0,1,1,73,332,405,summer
2011-05-25,2,20,0,1,1,56,284,340,summer
2011-05-25,2,21,0,1,1,33,203,236,summer
2011-05-25,2,22,0,1,1,34,140,174,summer
2011-05-25,2,23,0,1,1,12,74,86,summer
2011-05-26,2,0,0,1,1,11,34,45,summer
2011-05-26,2,1,0,1,1,3,13,16,summer
2011-05-26,2,2,0,1,1,7,7,14,summer
2011-05-26,2,3,0,1,1,0,4,4,summer
2011-05-26,2,4,0,1,1,0,2,2,summer
2011-05-26,2,5,0,1,2,2,25,27,summer
2011-05-26,2,6,0,1,2,4,94,98,summer
2011-05-26,2,7,0,1,2,16,270,286,summer
2011-05-26,2,8,0,1,2,31,458,489,summer
2011-05-26,2,9,0,1,1,22,194,216,summer
2011-05-26,2,10,0,1,1,49,94,143,summer
2011-05-26,2,11,0,1,1,36,124,160,summer
2011-05-26,2,12,0,1,1,53,141,194,summer
2011-05-26,2,13,0,1,1,52,145,197,summer
2011-05-26,2,14,0,1,1,44,145,189,summer
2011-05-26,2,15,0,1,2,40,101,141,summer
2011-05-26,2,16,0,1,2,58,233,291,summer
2011-05-26,2,17,0,1,1,49,445,494,summer
2011-05-26,2,18,0,1,1,74,404,478,summer
2011-05-26,2,19,0,1,1,67,311,378,summer
2011-05-26,2,20,0,1,1,55,267,322,summer
2011-05-26,2,21,0,1,1,45,178,223,summer
2011-05-26,2,22,0,1,1,23,157,180,summer
2011-05-26,2,23,0,1,1,17,73,90,summer
2011-05-27,2,0,0,1,1,14,55,69,summer
2011-05-27,2,1,0,1,1,14,36,50,summer
2011-05-27,2,2,0,1,1,6,12,18,summer
2011-05-27,2,3,0,1,1,1,11,12,summer
2011-05-27,2,4,0,1,1,2,5,7,summer
2011-05-27,2,5,0,1,1,2,29,31,summer
2011-05-27,2,6,0,1,1,8,73,81,summer
2011-05-27,2,7,0,1,1,20,229,249,summer
2011-05-27,2,8,0,1,1,25,393,418,summer
2011-05-27,2,9,0,1,1,37,190,227,summer
2011-05-27,2,10,0,1,1,42,111,153,summer
2011-05-27,2,11,0,1,2,40,126,166,summer
2011-05-27,2,12,0,1,2,53,190,243,summer
2011-05-27,2,13,0,1,1,51,158,209,summer
2011-05-27,2,14,0,1,1,51,188,239,summer
2011-05-27,2,15,0,1,1,98,258,356,summer
2011-05-27,2,16,0,1,2,63,356,419,summer
2011-05-27,2,17,0,1,1,77,414,491,summer
2011-05-27,2,18,0,1,2,89,310,399,summer
2011-05-27,2,19,0,1,3,69,210,279,summer
2011-05-27,2,20,0,1,2,24,120,144,summer
2011-05-27,2,21,0,1,1,37,114,151,summer
2011-05-27,2,22,0,1,1,25,116,141,summer
2011-05-27,2,23,0,1,1,23,104,127,summer
2011-05-28,2,0,0,0,1,15,79,94,summer
2011-05-28,2,1,0,0,1,8,47,55,summer
2011-05-28,2,2,0,0,1,13,35,48,summer
2011-05-28,2,3,0,0,1,2,13,15,summer
2011-05-28,2,4,0,0,1,0,4,4,summer
2011-05-28,2,5,0,0,1,4,3,7,summer
2011-05-28,2,6,0,0,1,3,16,19,summer
2011-05-28,2,7,0,0,1,17,33,50,summer
2011-05-28,2,8,0,0,1,27,75,102,summer
2011-05-28,2,9,0,0,1,61,116,177,summer
2011-05-28,2,10,0,0,1,110,166,276,summer
2011-05-28,2,11,0,0,1,171,178,349,summer
2011-05-28,2,12,0,0,1,145,213,358,summer
2011-05-28,2,13,0,0,1,168,217,385,summer
2011-05-28,2,14,0,0,1,172,210,382,summer
2011-05-28,2,15,0,0,1,187,187,374,summer
2011-05-28,2,16,0,0,1,201,201,402,summer
2011-05-28,2,17,0,0,1,180,161,341,summer
2011-05-28,2,18,0,0,1,173,212,385,summer
2011-05-28,2,19,0,0,1,99,153,252,summer
2011-05-28,2,20,0,0,1,68,128,196,summer
2011-05-28,2,21,0,0,1,87,114,201,summer
2011-05-28,2,22,0,0,1,46,115,161,summer
2011-05-28,2,23,0,0,1,44,81,125,summer
2011-05-29,2,0,0,0,1,32,51,83,summer
2011-05-29,2,1,0,0,1,17,49,66,summer
2011-05-29,2,2,0,0,1,12,49,61,summer
2011-05-29,2,3,0,0,1,2,24,26,summer
2011-05-29,2,4,0,0,1,13,10,23,summer
2011-05-29,2,5,0,0,1,3,3,6,summer
2011-05-29,2,6,0,0,2,5,10,15,summer
2011-05-29,2,7,0,0,2,13,17,30,summer
2011-05-29,2,8,0,0,2,34,62,96,summer
2011-05-29,2,9,0,0,2,74,78,152,summer
2011-05-29,2,10,0,0,2,130,121,251,summer
2011-05-29,2,11,0,0,2,139,180,319,summer
2011-05-29,2,12,0,0,2,216,186,402,summer
2011-05-29,2,13,0,0,1,237,181,418,summer
2011-05-29,2,14,0,0,1,183,168,351,summer
2011-05-29,2,15,0,0,1,221,155,376,summer
2011-05-29,2,16,0,0,1,194,167,361,summer
2011-05-29,2,17,0,0,1,214,169,383,summer
2011-05-29,2,18,0,0,1,151,177,328,summer
2011-05-29,2,19,0,0,1,141,146,287,summer
2011-05-29,2,20,0,0,1,91,128,219,summer
2011-05-29,2,21,0,0,1,107,122,229,summer
2011-05-29,2,22,0,0,1,78,93,171,summer
2011-05-29,2,23,0,0,1,48,87,135,summer
2011-05-30,2,0,1,0,1,38,65,103,summer
2011-05-30,2,1,1,0,1,26,53,79,summer
2011-05-30,2,2,1,0,1,17,28,45,summer
2011-05-30,2,3,1,0,1,10,8,18,summer
2011-05-30,2,4,1,0,1,2,4,6,summer
2011-05-30,2,5,1,0,2,1,6,7,summer
2011-05-30,2,6,1,0,2,6,10,16,summer
2011-05-30,2,7,1,0,2,12,19,31,summer
2011-05-30,2,8,1,0,2,36,58,94,summer
2011-05-30,2,9,1,0,1,47,81,128,summer
2011-05-30,2,10,1,0,1,116,153,269,summer
2011-05-30,2,11,1,0,1,153,168,321,summer
2011-05-30,2,12,1,0,1,179,187,366,summer
2011-05-30,2,13,1,0,1,133,217,350,summer
2011-05-30,2,14,1,0,1,142,185,327,summer
2011-05-30,2,15,1,0,1,132,179,311,summer
2011-05-30,2,16,1,0,1,101,208,309,summer
2011-05-30,2,17,1,0,1,102,202,304,summer
2011-05-30,2,18,1,0,1,77,172,249,summer
2011-05-30,2,19,1,0,2,68,157,225,summer
2011-05-30,2,20,1,0,1,69,168,237,summer
2011-05-30,2,21,1,0,1,42,107,149,summer
2011-05-30,2,22,1,0,1,26,80,106,summer
2011-05-30,2,23,1,0,1,14,34,48,summer
2011-05-31,2,0,0,1,1,9,20,29,summer
2011-05-31,2,1,0,1,1,8,9,17,summer
2011-05-31,2,2,0,1,2,5,7,12,summer
2011-05-31,2,3,0,1,2,1,3,4,summer
2011-05-31,2,4,0,1,1,0,3,3,summer
2011-05-31,2,5,0,1,1,0,26,26,summer
2011-05-31,2,6,0,1,1,11,98,109,summer
2011-05-31,2,7,0,1,1,16,219,235,summer
2011-05-31,2,8,0,1,1,34,372,406,summer
2011-05-31,2,9,0,1,1,22,153,175,summer
2011-05-31,2,10,0,1,1,37,72,109,summer
2011-05-31,2,11,0,1,1,28,78,106,summer
2011-05-31,2,12,0,1,1,37,125,162,summer
2011-05-31,2,13,0,1,1,37,110,147,summer
2011-05-31,2,14,0,1,1,41,99,140,summer
2011-05-31,2,15,0,1,1,42,133,175,summer
2011-05-31,2,16,0,1,1,44,205,249,summer
2011-05-31,2,17,0,1,1,67,428,495,summer
2011-05-31,2,18,0,1,1,55,362,417,summer
2011-05-31,2,19,0,1,1,39,246,285,summer
2011-05-31,2,20,0,1,1,38,213,251,summer
2011-05-31,2,21,0,1,1,45,165,210,summer
2011-05-31,2,22,0,1,1,42,117,159,summer
2011-05-31,2,23,0,1,1,15,46,61,summer
2011-06-01,2,0,0,1,1,9,25,34,summer
2011-06-01,2,1,0,1,1,8,9,17,summer
2011-06-01,2,2,0,1,1,0,3,3,summer
2011-06-01,2,3,0,1,1,0,6,6,summer
2011-06-01,2,4,0,1,2,0,4,4,summer
2011-06-01,2,5,0,1,2,2,19,21,summer
2011-06-01,2,6,0,1,2,7,121,128,summer
2011-06-01,2,7,0,1,2,19,265,284,summer
2011-06-01,2,8,0,1,2,37,417,454,summer
2011-06-01,2,9,0,1,2,34,173,207,summer
2011-06-01,2,10,0,1,2,31,84,115,summer
2011-06-01,2,11,0,1,2,26,86,112,summer
2011-06-01,2,12,0,1,1,32,137,169,summer
2011-06-01,2,13,0,1,1,29,125,154,summer
2011-06-01,2,14,0,1,1,40,105,145,summer
2011-06-01,2,15,0,1,1,25,127,152,summer
2011-06-01,2,16,0,1,1,39,227,266,summer
2011-06-01,2,17,0,1,1,52,434,486,summer
2011-06-01,2,18,0,1,3,31,278,309,summer
2011-06-01,2,19,0,1,2,16,248,264,summer
2011-06-01,2,20,0,1,2,23,233,256,summer
2011-06-01,2,21,0,1,1,29,161,190,summer
2011-06-01,2,22,0,1,1,14,115,129,summer
2011-06-01,2,23,0,1,1,10,59,69,summer
2011-06-02,2,0,0,1,1,11,31,42,summer
2011-06-02,2,1,0,1,1,3,12,15,summer
2011-06-02,2,2,0,1,1,0,6,6,summer
2011-06-02,2,3,0,1,1,0,4,4,summer
2011-06-02,2,4,0,1,1,0,3,3,summer
2011-06-02,2,5,0,1,1,3,28,31,summer
2011-06-02,2,6,0,1,1,7,106,113,summer
2011-06-02,2,7,0,1,1,19,285,304,summer
2011-06-02,2,8,0,1,1,25,442,467,summer
2011-06-02,2,9,0,1,1,28,197,225,summer
2011-06-02,2,10,0,1,1,33,106,139,summer
2011-06-02,2,11,0,1,1,42,123,165,summer
2011-06-02,2,12,0,1,1,39,193,232,summer
2011-06-02,2,13,0,1,1,35,168,203,summer
2011-06-02,2,14,0,1,1,43,142,185,summer
2011-06-02,2,15,0,1,1,44,144,188,summer
2011-06-02,2,16,0,1,1,63,255,318,summer
2011-06-02,2,17,0,1,1,88,484,572,summer
2011-06-02,2,18,0,1,1,74,451,525,summer
2011-06-02,2,19,0,1,1,58,321,379,summer
2011-06-02,2,20,0,1,1,51,286,337,summer
2011-06-02,2,21,0,1,1,33,215,248,summer
2011-06-02,2,22,0,1,1,14,141,155,summer
2011-06-02,2,23,0,1,1,23,89,112,summer
2011-06-03,2,0,0,1,1,15,53,68,summer
2011-06-03,2,1,0,1,1,7,15,22,summer
2011-06-03,2,2,0,1,1,0,12,12,summer
2011-06-03,2,3,0,1,1,0,5,5,summer
2011-06-03,2,4,0,1,1,1,5,6,summer
2011-06-03,2,5,0,1,1,4,24,28,summer
2011-06-03,2,6,0,1,1,8,98,106,summer
2011-06-03,2,7,0,1,1,25,252,277,summer
2011-06-03,2,8,0,1,2,31,471,502,summer
2011-06-03,2,9,0,1,1,36,194,230,summer
2011-06-03,2,10,0,1,1,54,107,161,summer
2011-06-03,2,11,0,1,1,57,135,192,summer
2011-06-03,2,12,0,1,1,51,208,259,summer
2011-06-03,2,13,0,1,1,58,190,248,summer
2011-06-03,2,14,0,1,1,66,174,240,summer
2011-06-03,2,15,0,1,1,56,156,212,summer
2011-06-03,2,16,0,1,1,63,286,349,summer
2011-06-03,2,17,0,1,1,73,485,558,summer
2011-06-03,2,18,0,1,1,76,488,564,summer
2011-06-03,2,19,0,1,1,53,338,391,summer
2011-06-03,2,20,0,1,1,57,236,293,summer
2011-06-03,2,21,0,1,1,51,196,247,summer
2011-06-03,2,22,0,1,1,26,145,171,summer
2011-06-03,2,23,0,1,1,30,141,171,summer
2011-06-04,2,0,0,0,1,24,69,93,summer
2011-06-04,2,1,0,0,1,14,80,94,summer
2011-06-04,2,2,0,0,1,18,41,59,summer
2011-06-04,2,3,0,0,1,8,10,18,summer
2011-06-04,2,4,0,0,1,4,11,15,summer
2011-06-04,2,5,0,0,1,3,5,8,summer
2011-06-04,2,6,0,0,1,11,17,28,summer
2011-06-04,2,7,0,0,1,27,60,87,summer
2011-06-04,2,8,0,0,1,29,96,125,summer
2011-06-04,2,9,0,0,1,55,169,224,summer
2011-06-04,2,10,0,0,1,115,202,317,summer
2011-06-04,2,11,0,0,1,120,249,369,summer
2011-06-04,2,12,0,0,1,150,270,420,summer
2011-06-04,2,13,0,0,1,188,268,456,summer
2011-06-04,2,14,0,0,1,193,258,451,summer
2011-06-04,2,15,0,0,2,180,224,404,summer
2011-06-04,2,16,0,0,2,168,272,440,summer
2011-06-04,2,17,0,0,2,142,202,344,summer
2011-06-04,2,18,0,0,2,127,214,341,summer
2011-06-04,2,19,0,0,2,79,206,285,summer
2011-06-04,2,20,0,0,2,90,149,239,summer
2011-06-04,2,21,0,0,2,46,139,185,summer
2011-06-04,2,22,0,0,1,49,141,190,summer
2011-06-04,2,23,0,0,2,29,121,150,summer
2011-06-05,2,0,0,0,1,23,90,113,summer
2011-06-05,2,1,0,0,2,26,70,96,summer
2011-06-05,2,2,0,0,2,16,48,64,summer
2011-06-05,2,3,0,0,2,22,25,47,summer
2011-06-05,2,4,0,0,2,4,8,12,summer
2011-06-05,2,5,0,0,2,1,5,6,summer
2011-06-05,2,6,0,0,2,10,11,21,summer
2011-06-05,2,7,0,0,2,8,19,27,summer
2011-06-05,2,8,0,0,2,24,74,98,summer
2011-06-05,2,9,0,0,2,53,111,164,summer
2011-06-05,2,10,0,0,2,83,168,251,summer
2011-06-05,2,11,0,0,2,121,214,335,summer
2011-06-05,2,12,0,0,2,123,212,335,summer
2011-06-05,2,13,0,0,1,154,213,367,summer
2011-06-05,2,14,0,0,1,161,224,385,summer
2011-06-05,2,15,0,0,1,161,256,417,summer
2011-06-05,2,16,0,0,1,138,260,398,summer
2011-06-05,2,17,0,0,1,126,264,390,summer
2011-06-05,2,18,0,0,1,124,239,363,summer
2011-06-05,2,19,0,0,1,108,249,357,summer
2011-06-05,2,20,0,0,1,84,195,279,summer
2011-06-05,2,21,0,0,1,54,111,165,summer
2011-06-05,2,22,0,0,1,36,94,130,summer
2011-06-05,2,23,0,0,1,25,61,86,summer
2011-06-06,2,0,0,1,1,11,18,29,summer
2011-06-06,2,1,0,1,1,9,5,14,summer
2011-06-06,2,2,0,1,1,4,4,8,summer
2011-06-06,2,3,0,1,1,2,3,5,summer
2011-06-06,2,4,0,1,1,4,4,8,summer
2011-06-06,2,5,0,1,1,7,24,31,summer
2011-06-06,2,6,0,1,1,11,101,112,summer
2011-06-06,2,7,0,1,1,18,281,299,summer
2011-06-06,2,8,0,1,1,28,410,438,summer
2011-06-06,2,9,0,1,1,26,162,188,summer
2011-06-06,2,10,0,1,1,31,64,95,summer
2011-06-06,2,11,0,1,1,39,72,111,summer
2011-06-06,2,12,0,1,1,25,128,153,summer
2011-06-06,2,13,0,1,1,28,152,180,summer
2011-06-06,2,14,0,1,1,46,99,145,summer
2011-06-06,2,15,0,1,1,38,127,165,summer
2011-06-06,2,16,0,1,1,34,233,267,summer
2011-06-06,2,17,0,1,1,63,516,579,summer
2011-06-06,2,18,0,1,1,56,500,556,summer
2011-06-06,2,19,0,1,1,64,343,407,summer
2011-06-06,2,20,0,1,1,59,277,336,summer
2011-06-06,2,21,0,1,1,29,160,189,summer
2011-06-06,2,22,0,1,1,36,137,173,summer
2011-06-06,2,23,0,1,1,5,55,60,summer
2011-06-07,2,0,0,1,1,5,15,20,summer
2011-06-07,2,1,0,1,1,2,2,4,summer
2011-06-07,2,2,0,1,1,3,2,5,summer
2011-06-07,2,3,0,1,1,1,1,2,summer
2011-06-07,2,4,0,1,1,2,3,5,summer
2011-06-07,2,5,0,1,1,2,30,32,summer
2011-06-07,2,6,0,1,1,10,116,126,summer
2011-06-07,2,7,0,1,2,23,311,334,summer
2011-06-07,2,8,0,1,2,45,432,477,summer
2011-06-07,2,9,0,1,2,27,190,217,summer
2011-06-07,2,10,0,1,2,37,86,123,summer
2011-06-07,2,11,0,1,2,38,113,151,summer
2011-06-07,2,12,0,1,2,42,141,183,summer
2011-06-07,2,13,0,1,2,55,141,196,summer
2011-06-07,2,14,0,1,2,34,112,146,summer
2011-06-07,2,15,0,1,2,56,127,183,summer
2011-06-07,2,16,0,1,1,55,253,308,summer
2011-06-07,2,17,0,1,1,64,475,539,summer
2011-06-07,2,18,0,1,1,72,479,551,summer
2011-06-07,2,19,0,1,1,69,355,424,summer
2011-06-07,2,20,0,1,1,45,301,346,summer
2011-06-07,2,21,0,1,1,31,187,218,summer
2011-06-07,2,22,0,1,1,27,126,153,summer
2011-06-07,2,23,0,1,1,18,72,90,summer
2011-06-08,2,0,0,1,1,12,29,41,summer
2011-06-08,2,1,0,1,1,3,20,23,summer
2011-06-08,2,2,0,1,1,0,7,7,summer
2011-06-08,2,3,0,1,1,2,1,3,summer
2011-06-08,2,4,0,1,1,0,6,6,summer
2011-06-08,2,5,0,1,1,0,21,21,summer
2011-06-08,2,6,0,1,1,13,103,116,summer
2011-06-08,2,7,0,1,1,24,329,353,summer
2011-06-08,2,8,0,1,1,46,435,481,summer
2011-06-08,2,9,0,1,1,34,168,202,summer
2011-06-08,2,10,0,1,1,27,63,90,summer
2011-06-08,2,11,0,1,1,28,106,134,summer
2011-06-08,2,12,0,1,1,15,134,149,summer
2011-06-08,2,13,0,1,1,20,116,136,summer
2011-06-08,2,14,0,1,1,44,111,155,summer
2011-06-08,2,15,0,1,1,28,100,128,summer
2011-06-08,2,16,0,1,1,34,199,233,summer
2011-06-08,2,17,0,1,1,80,426,506,summer
2011-06-08,2,18,0,1,1,61,398,459,summer
2011-06-08,2,19,0,1,1,61,323,384,summer
2011-06-08,2,20,0,1,1,55,225,280,summer
2011-06-08,2,21,0,1,1,34,168,202,summer
2011-06-08,2,22,0,1,1,37,139,176,summer
2011-06-08,2,23,0,1,1,18,98,116,summer
2011-06-09,2,0,0,1,2,7,40,47,summer
2011-06-09,2,1,0,1,1,3,13,16,summer
2011-06-09,2,2,0,1,2,0,6,6,summer
2011-06-09,2,3,0,1,2,0,2,2,summer
2011-06-09,2,4,0,1,2,2,4,6,summer
2011-06-09,2,5,0,1,2,1,19,20,summer
2011-06-09,2,6,0,1,2,13,105,118,summer
2011-06-09,2,7,0,1,2,31,283,314,summer
2011-06-09,2,8,0,1,2,32,400,432,summer
2011-06-09,2,9,0,1,1,20,148,168,summer
2011-06-09,2,10,0,1,1,20,74,94,summer
2011-06-09,2,11,0,1,1,36,82,118,summer
2011-06-09,2,12,0,1,1,40,100,140,summer
2011-06-09,2,13,0,1,1,18,118,136,summer
2011-06-09,2,14,0,1,1,25,93,118,summer
2011-06-09,2,15,0,1,1,18,86,104,summer
2011-06-09,2,16,0,1,1,30,170,200,summer
2011-06-09,2,17,0,1,1,54,355,409,summer
2011-06-09,2,18,0,1,1,52,414,466,summer
2011-06-09,2,19,0,1,2,55,271,326,summer
2011-06-09,2,20,0,1,2,40,214,254,summer
2011-06-09,2,21,0,1,3,29,142,171,summer
2011-06-09,2,22,0,1,2,22,131,153,summer
2011-06-09,2,23,0,1,2,15,82,97,summer
2011-06-10,2,0,0,1,3,8,61,69,summer
2011-06-10,2,1,0,1,3,5,18,23,summer
2011-06-10,2,2,0,1,1,6,7,13,summer
2011-06-10,2,3,0,1,1,3,3,6,summer
2011-06-10,2,4,0,1,1,0,4,4,summer
2011-06-10,2,5,0,1,1,0,28,28,summer
2011-06-10,2,6,0,1,1,10,94,104,summer
2011-06-10,2,7,0,1,1,25,242,267,summer
2011-06-10,2,8,0,1,1,29,423,452,summer
2011-06-10,2,9,0,1,1,37,176,213,summer
2011-06-10,2,10,0,1,1,23,88,111,summer
2011-06-10,2,11,0,1,1,46,107,153,summer
2011-06-10,2,12,0,1,1,40,167,207,summer
2011-06-10,2,13,0,1,1,40,149,189,summer
2011-06-10,2,14,0,1,1,44,121,165,summer
2011-06-10,2,15,0,1,1,49,163,212,summer
2011-06-10,2,16,0,1,1,46,239,285,summer
2011-06-10,2,17,0,1,1,63,454,517,summer
2011-06-10,2,18,0,1,1,96,367,463,summer
2011-06-10,2,19,0,1,1,61,245,306,summer
2011-06-10,2,20,0,1,1,53,197,250,summer
2011-06-10,2,21,0,1,1,55,163,218,summer
2011-06-10,2,22,0,1,1,40,145,185,summer
2011-06-10,2,23,0,1,1,36,110,146,summer
2011-06-11,2,0,0,0,1,28,89,117,summer
2011-06-11,2,1,0,0,1,10,67,77,summer
2011-06-11,2,2,0,0,1,10,50,60,summer
2011-06-11,2,3,0,0,1,10,18,28,summer
2011-06-11,2,4,0,0,1,4,9,13,summer
2011-06-11,2,5,0,0,1,4,12,16,summer
2011-06-11,2,6,0,0,1,9,31,40,summer
2011-06-11,2,7,0,0,1,18,50,68,summer
2011-06-11,2,8,0,0,1,32,111,143,summer
2011-06-11,2,9,0,0,1,59,171,230,summer
2011-06-11,2,10,0,0,1,91,173,264,summer
2011-06-11,2,11,0,0,1,110,215,325,summer
2011-06-11,2,12,0,0,1,112,235,347,summer
2011-06-11,2,13,0,0,1,150,237,387,summer
2011-06-11,2,14,0,0,1,148,232,380,summer
2011-06-11,2,15,0,0,1,142,232,374,summer
2011-06-11,2,16,0,0,2,169,225,394,summer
2011-06-11,2,17,0,0,2,147,190,337,summer
2011-06-11,2,18,0,0,2,131,155,286,summer
2011-06-11,2,19,0,0,1,97,167,264,summer
2011-06-11,2,20,0,0,1,95,180,275,summer
2011-06-11,2,21,0,0,1,76,144,220,summer
2011-06-11,2,22,0,0,1,53,137,190,summer
2011-06-11,2,23,0,0,1,24,107,131,summer
2011-06-12,2,0,0,0,1,19,100,119,summer
2011-06-12,2,1,0,0,1,19,74,93,summer
2011-06-12,2,2,0,0,1,9,57,66,summer
2011-06-12,2,3,0,0,1,8,20,28,summer
2011-06-12,2,4,0,0,1,8,6,14,summer
2011-06-12,2,5,0,0,1,5,5,10,summer
2011-06-12,2,6,0,0,1,5,9,14,summer
2011-06-12,2,7,0,0,1,7,27,34,summer
2011-06-12,2,8,0,0,1,28,64,92,summer
2011-06-12,2,9,0,0,1,75,107,182,summer
2011-06-12,2,10,0,0,1,120,191,311,summer
2011-06-12,2,11,0,0,1,131,236,367,summer
2011-06-12,2,12,0,0,1,176,244,420,summer
2011-06-12,2,13,0,0,1,109,264,373,summer
2011-06-12,2,14,0,0,1,96,219,315,summer
2011-06-12,2,15,0,0,1,142,218,360,summer
2011-06-12,2,16,0,0,3,115,235,350,summer
2011-06-12,2,17,0,0,3,94,158,252,summer
2011-06-12,2,18,0,0,1,69,187,256,summer
2011-06-12,2,19,0,0,1,67,156,223,summer
2011-06-12,2,20,0,0,1,62,144,206,summer
2011-06-12,2,21,0,0,1,39,101,140,summer
2011-06-12,2,22,0,0,1,31,97,128,summer
2011-06-12,2,23,0,0,1,33,74,107,summer
2011-06-13,2,0,0,1,1,8,20,28,summer
2011-06-13,2,1,0,1,1,6,10,16,summer
2011-06-13,2,2,0,1,1,2,8,10,summer
2011-06-13,2,3,0,1,1,1,6,7,summer
2011-06-13,2,4,0,1,1,1,3,4,summer
2011-06-13,2,5,0,1,1,2,27,29,summer
2011-06-13,2,6,0,1,1,7,98,105,summer
2011-06-13,2,7,0,1,1,26,302,328,summer
2011-06-13,2,8,0,1,1,44,432,476,summer
2011-06-13,2,9,0,1,1,35,189,224,summer
2011-06-13,2,10,0,1,1,38,80,118,summer
2011-06-13,2,11,0,1,1,53,106,159,summer
2011-06-13,2,12,0,1,1,35,161,196,summer
2011-06-13,2,13,0,1,1,53,174,227,summer
2011-06-13,2,14,0,1,1,55,145,200,summer
2011-06-13,2,15,0,1,1,58,127,185,summer
2011-06-13,2,16,0,1,1,64,262,326,summer
2011-06-13,2,17,0,1,1,72,529,601,summer
2011-06-13,2,18,0,1,1,76,510,586,summer
2011-06-13,2,19,0,1,1,75,348,423,summer
2011-06-13,2,20,0,1,1,78,253,331,summer
2011-06-13,2,21,0,1,1,40,178,218,summer
2011-06-13,2,22,0,1,1,20,114,134,summer
2011-06-13,2,23,0,1,1,14,75,89,summer
2011-06-14,2,0,0,1,1,13,18,31,summer
2011-06-14,2,1,0,1,1,3,10,13,summer
2011-06-14,2,2,0,1,1,2,8,10,summer
2011-06-14,2,3,0,1,1,1,1,2,summer
2011-06-14,2,4,0,1,1,0,3,3,summer
2011-06-14,2,5,0,1,1,3,23,26,summer
2011-06-14,2,6,0,1,1,6,107,113,summer
2011-06-14,2,7,0,1,1,19,346,365,summer
2011-06-14,2,8,0,1,1,45,441,486,summer
2011-06-14,2,9,0,1,1,19,174,193,summer
2011-06-14,2,10,0,1,1,33,97,130,summer
2011-06-14,2,11,0,1,1,40,103,143,summer
2011-06-14,2,12,0,1,1,30,139,169,summer
2011-06-14,2,13,0,1,1,33,176,209,summer
2011-06-14,2,14,0,1,2,41,118,159,summer
2011-06-14,2,15,0,1,1,42,136,178,summer
2011-06-14,2,16,0,1,1,51,279,330,summer
2011-06-14,2,17,0,1,3,85,484,569,summer
2011-06-14,2,18,0,1,1,65,473,538,summer
2011-06-14,2,19,0,1,1,51,335,386,summer
2011-06-14,2,20,0,1,1,60,237,297,summer
2011-06-14,2,21,0,1,1,37,206,243,summer
2011-06-14,2,22,0,1,1,29,159,188,summer
2011-06-14,2,23,0,1,1,19,91,110,summer
2011-06-15,2,0,0,1,1,8,44,52,summer
2011-06-15,2,1,0,1,1,0,14,14,summer
2011-06-15,2,2,0,1,1,0,9,9,summer
2011-06-15,2,3,0,1,1,0,1,1,summer
2011-06-15,2,4,0,1,1,0,4,4,summer
2011-06-15,2,5,0,1,1,1,20,21,summer
2011-06-15,2,6,0,1,1,11,110,121,summer
2011-06-15,2,7,0,1,1,22,348,370,summer
2011-06-15,2,8,0,1,1,53,445,498,summer
2011-06-15,2,9,0,1,1,22,185,207,summer
2011-06-15,2,10,0,1,1,27,108,135,summer
2011-06-15,2,11,0,1,1,49,115,164,summer
2011-06-15,2,12,0,1,1,33,178,211,summer
2011-06-15,2,13,0,1,1,43,146,189,summer
2011-06-15,2,14,0,1,1,50,128,178,summer
2011-06-15,2,15,0,1,1,33,131,164,summer
2011-06-15,2,16,0,1,1,47,265,312,summer
2011-06-15,2,17,0,1,1,83,555,638,summer
2011-06-15,2,18,0,1,1,80,527,607,summer
2011-06-15,2,19,0,1,1,54,362,416,summer
2011-06-15,2,20,0,1,1,57,273,330,summer
2011-06-15,2,21,0,1,1,48,209,257,summer
2011-06-15,2,22,0,1,1,31,144,175,summer
2011-06-15,2,23,0,1,1,17,90,107,summer
2011-06-16,2,0,0,1,1,9,38,47,summer
2011-06-16,2,1,0,1,1,4,13,17,summer
2011-06-16,2,2,0,1,1,1,4,5,summer
2011-06-16,2,3,0,1,2,0,4,4,summer
2011-06-16,2,4,0,1,2,0,6,6,summer
2011-06-16,2,5,0,1,1,7,18,25,summer
2011-06-16,2,6,0,1,3,8,104,112,summer
2011-06-16,2,7,0,1,3,16,172,188,summer
2011-06-16,2,8,0,1,2,24,364,388,summer
2011-06-16,2,9,0,1,2,29,232,261,summer
2011-06-16,2,10,0,1,2,18,103,121,summer
2011-06-16,2,11,0,1,2,33,117,150,summer
2011-06-16,2,12,0,1,1,41,165,206,summer
2011-06-16,2,13,0,1,2,37,114,151,summer
2011-06-16,2,14,0,1,2,39,114,153,summer
2011-06-16,2,15,0,1,2,32,127,159,summer
2011-06-16,2,16,0,1,3,36,258,294,summer
2011-06-16,2,17,0,1,2,42,230,272,summer
2011-06-16,2,18,0,1,1,26,299,325,summer
2011-06-16,2,19,0,1,1,58,269,327,summer
2011-06-16,2,20,0,1,1,25,176,201,summer
2011-06-16,2,21,0,1,3,34,154,188,summer
2011-06-16,2,22,0,1,3,24,127,151,summer
2011-06-16,2,23,0,1,3,2,14,16,summer
2011-06-17,2,0,0,1,1,3,21,24,summer
2011-06-17,2,1,0,1,1,4,19,23,summer
2011-06-17,2,2,0,1,1,2,11,13,summer
2011-06-17,2,3,0,1,1,1,5,6,summer
2011-06-17,2,4,0,1,1,1,5,6,summer
2011-06-17,2,5,0,1,1,1,12,13,summer
2011-06-17,2,6,0,1,1,8,89,97,summer
2011-06-17,2,7,0,1,1,25,225,250,summer
2011-06-17,2,8,0,1,2,28,426,454,summer
2011-06-17,2,9,0,1,1,28,196,224,summer
2011-06-17,2,10,0,1,1,44,126,170,summer
2011-06-17,2,11,0,1,1,43,138,181,summer
2011-06-17,2,12,0,1,1,49,194,243,summer
2011-06-17,2,13,0,1,1,48,156,204,summer
2011-06-17,2,14,0,1,1,73,142,215,summer
2011-06-17,2,15,0,1,1,62,181,243,summer
2011-06-17,2,16,0,1,1,69,286,355,summer
2011-06-17,2,17,0,1,3,85,467,552,summer
2011-06-17,2,18,0,1,3,62,388,450,summer
2011-06-17,2,19,0,1,3,53,275,328,summer
2011-06-17,2,20,0,1,1,40,192,232,summer
2011-06-17,2,21,0,1,1,49,159,208,summer
2011-06-17,2,22,0,1,1,48,127,175,summer
2011-06-17,2,23,0,1,1,37,141,178,summer
2011-06-18,2,0,0,0,1,21,83,104,summer
2011-06-18,2,1,0,0,1,15,80,95,summer
2011-06-18,2,2,0,0,1,16,37,53,summer
2011-06-18,2,3,0,0,1,4,16,20,summer
2011-06-18,2,4,0,0,1,1,4,5,summer
2011-06-18,2,5,0,0,1,1,6,7,summer
2011-06-18,2,6,0,0,1,9,18,27,summer
2011-06-18,2,7,0,0,1,12,45,57,summer
2011-06-18,2,8,0,0,1,28,103,131,summer
2011-06-18,2,9,0,0,1,62,156,218,summer
2011-06-18,2,10,0,0,1,68,176,244,summer
2011-06-18,2,11,0,0,1,134,270,404,summer
2011-06-18,2,12,0,0,1,162,258,420,summer
2011-06-18,2,13,0,0,1,135,192,327,summer
2011-06-18,2,14,0,0,2,138,196,334,summer
2011-06-18,2,15,0,0,2,153,214,367,summer
2011-06-18,2,16,0,0,2,193,275,468,summer
2011-06-18,2,17,0,0,2,210,239,449,summer
2011-06-18,2,18,0,0,2,118,263,381,summer
2011-06-18,2,19,0,0,2,99,227,326,summer
2011-06-18,2,20,0,0,2,61,127,188,summer
2011-06-18,2,21,0,0,2,58,125,183,summer
2011-06-18,2,22,0,0,2,56,105,161,summer
2011-06-18,2,23,0,0,2,53,97,150,summer
2011-06-19,2,0,0,0,1,18,71,89,summer
2011-06-19,2,1,0,0,2,17,59,76,summer
2011-06-19,2,2,0,0,1,13,59,72,summer
2011-06-19,2,3,0,0,2,14,16,30,summer
2011-06-19,2,4,0,0,2,7,10,17,summer
2011-06-19,2,5,0,0,2,7,12,19,summer
2011-06-19,2,6,0,0,2,11,22,33,summer
2011-06-19,2,7,0,0,2,35,36,71,summer
2011-06-19,2,8,0,0,3,25,59,84,summer
2011-06-19,2,9,0,0,2,58,111,169,summer
2011-06-19,2,10,0,0,2,86,158,244,summer
2011-06-19,2,11,0,0,2,141,236,377,summer
2011-06-19,2,12,0,0,2,141,255,396,summer
2011-06-19,2,13,0,0,2,149,214,363,summer
2011-06-19,2,14,0,0,3,124,193,317,summer
2011-06-19,2,15,0,0,2,146,216,362,summer
2011-06-19,2,16,0,0,2,121,257,378,summer
2011-06-19,2,17,0,0,1,159,238,397,summer
2011-06-19,2,18,0,0,2,78,218,296,summer
2011-06-19,2,19,0,0,1,94,217,311,summer
2011-06-19,2,20,0,0,1,86,146,232,summer
2011-06-19,2,21,0,0,1,57,110,167,summer
2011-06-19,2,22,0,0,1,38,114,152,summer
2011-06-19,2,23,0,0,1,14,78,92,summer
2011-06-20,2,0,0,1,1,7,19,26,summer
2011-06-20,2,1,0,1,1,9,3,12,summer
2011-06-20,2,2,0,1,1,2,0,2,summer
2011-06-20,2,3,0,1,3,1,0,1,summer
2011-06-20,2,4,0,1,3,1,2,3,summer
2011-06-20,2,5,0,1,3,0,3,3,summer
2011-06-20,2,6,0,1,3,1,25,26,summer
2011-06-20,2,7,0,1,3,0,46,46,summer
2011-06-20,2,8,0,1,3,12,209,221,summer
2011-06-20,2,9,0,1,2,19,200,219,summer
2011-06-20,2,10,0,1,2,33,58,91,summer
2011-06-20,2,11,0,1,2,27,67,94,summer
2011-06-20,2,12,0,1,2,33,129,162,summer
2011-06-20,2,13,0,1,1,50,129,179,summer
2011-06-20,2,14,0,1,1,45,130,175,summer
2011-06-20,2,15,0,1,1,66,139,205,summer
2011-06-20,2,16,0,1,1,61,238,299,summer
2011-06-20,2,17,0,1,1,81,484,565,summer
2011-06-20,2,18,0,1,1,64,474,538,summer
2011-06-20,2,19,0,1,1,62,369,431,summer
2011-06-20,2,20,0,1,1,52,264,316,summer
2011-06-20,2,21,0,1,1,39,167,206,summer
2011-06-20,2,22,0,1,2,24,106,130,summer
2011-06-20,2,23,0,1,1,10,50,60,summer
2011-06-21,3,0,0,1,1,10,23,33,fall
2011-06-21,3,1,0,1,3,2,12,14,fall
2011-06-21,3,2,0,1,3,1,5,6,fall
2011-06-21,3,3,0,1,3,0,2,2,fall
2011-06-21,3,4,0,1,2,2,7,9,fall
2011-06-21,3,5,0,1,2,3,22,25,fall
2011-06-21,3,6,0,1,2,8,107,115,fall
2011-06-21,3,7,0,1,2,21,288,309,fall
2011-06-21,3,8,0,1,2,33,368,401,fall
2011-06-21,3,9,0,1,2,32,243,275,fall
2011-06-21,3,10,0,1,2,41,120,161,fall
2011-06-21,3,11,0,1,1,52,119,171,fall
2011-06-21,3,12,0,1,1,40,149,189,fall
2011-06-21,3,13,0,1,1,49,158,207,fall
2011-06-21,3,14,0,1,1,44,108,152,fall
2011-06-21,3,15,0,1,1,42,128,170,fall
2011-06-21,3,16,0,1,1,62,273,335,fall
2011-06-21,3,17,0,1,1,65,507,572,fall
2011-06-21,3,18,0,1,2,67,469,536,fall
2011-06-21,3,19,0,1,2,67,358,425,fall
2011-06-21,3,20,0,1,3,72,254,326,fall
2011-06-21,3,21,0,1,1,38,191,229,fall
2011-06-21,3,22,0,1,1,12,97,109,fall
2011-06-21,3,23,0,1,1,11,53,64,fall
2011-06-22,3,0,0,1,1,15,18,33,fall
2011-06-22,3,1,0,1,1,2,19,21,fall
2011-06-22,3,2,0,1,1,2,5,7,fall
2011-06-22,3,3,0,1,1,0,7,7,fall
2011-06-22,3,4,0,1,1,3,8,11,fall
2011-06-22,3,5,0,1,1,2,21,23,fall
2011-06-22,3,6,0,1,1,12,110,122,fall
2011-06-22,3,7,0,1,1,23,288,311,fall
2011-06-22,3,8,0,1,1,27,396,423,fall
2011-06-22,3,9,0,1,1,14,205,219,fall
2011-06-22,3,10,0,1,1,31,104,135,fall
2011-06-22,3,11,0,1,1,37,108,145,fall
2011-06-22,3,12,0,1,2,44,144,188,fall
2011-06-22,3,13,0,1,2,34,113,147,fall
2011-06-22,3,14,0,1,2,32,113,145,fall
2011-06-22,3,15,0,1,2,32,114,146,fall
2011-06-22,3,16,0,1,2,34,224,258,fall
2011-06-22,3,17,0,1,2,67,462,529,fall
2011-06-22,3,18,0,1,2,66,447,513,fall
2011-06-22,3,19,0,1,2,62,280,342,fall
2011-06-22,3,20,0,1,1,52,230,282,fall
2011-06-22,3,21,0,1,1,31,216,247,fall
2011-06-22,3,22,0,1,2,25,123,148,fall
2011-06-22,3,23,0,1,2,14,91,105,fall
2011-06-23,3,0,0,1,1,5,44,49,fall
2011-06-23,3,1,0,1,1,5,26,31,fall
2011-06-23,3,2,0,1,1,0,4,4,fall
2011-06-23,3,3,0,1,2,1,4,5,fall
2011-06-23,3,4,0,1,2,0,7,7,fall
2011-06-23,3,5,0,1,1,2,22,24,fall
2011-06-23,3,6,0,1,1,8,92,100,fall
2011-06-23,3,7,0,1,2,26,301,327,fall
2011-06-23,3,8,0,1,2,20,412,432,fall
2011-06-23,3,9,0,1,2,33,194,227,fall
2011-06-23,3,10,0,1,2,39,88,127,fall
2011-06-23,3,11,0,1,3,28,108,136,fall
2011-06-23,3,12,0,1,2,30,130,160,fall
2011-06-23,3,13,0,1,2,37,149,186,fall
2011-06-23,3,14,0,1,2,46,103,149,fall
2011-06-23,3,15,0,1,2,62,127,189,fall
2011-06-23,3,16,0,1,2,58,217,275,fall
2011-06-23,3,17,0,1,2,74,495,569,fall
2011-06-23,3,18,0,1,1,57,483,540,fall
2011-06-23,3,19,0,1,1,56,344,400,fall
2011-06-23,3,20,0,1,1,75,277,352,fall
2011-06-23,3,21,0,1,1,46,188,234,fall
2011-06-23,3,22,0,1,2,23,139,162,fall
2011-06-23,3,23,0,1,1,15,90,105,fall
2011-06-24,3,0,0,1,1,10,53,63,fall
2011-06-24,3,1,0,1,1,8,20,28,fall
2011-06-24,3,2,0,1,1,4,10,14,fall
2011-06-24,3,3,0,1,1,1,4,5,fall
2011-06-24,3,4,0,1,1,1,8,9,fall
2011-06-24,3,5,0,1,1,2,18,20,fall
2011-06-24,3,6,0,1,1,4,87,91,fall
2011-06-24,3,7,0,1,2,21,247,268,fall
2011-06-24,3,8,0,1,1,27,439,466,fall
2011-06-24,3,9,0,1,1,28,203,231,fall
2011-06-24,3,10,0,1,1,43,102,145,fall
2011-06-24,3,11,0,1,1,56,147,203,fall
2011-06-24,3,12,0,1,1,51,150,201,fall
2011-06-24,3,13,0,1,1,43,178,221,fall
2011-06-24,3,14,0,1,1,67,162,229,fall
2011-06-24,3,15,0,1,1,69,147,216,fall
2011-06-24,3,16,0,1,1,80,247,327,fall
2011-06-24,3,17,0,1,1,85,472,557,fall
2011-06-24,3,18,0,1,1,87,365,452,fall
2011-06-24,3,19,0,1,1,92,293,385,fall
2011-06-24,3,20,0,1,1,66,222,288,fall
2011-06-24,3,21,0,1,1,50,183,233,fall
2011-06-24,3,22,0,1,1,41,126,167,fall
2011-06-24,3,23,0,1,1,33,139,172,fall
2011-06-25,3,0,0,0,1,19,97,116,fall
2011-06-25,3,1,0,0,1,20,75,95,fall
2011-06-25,3,2,0,0,2,8,51,59,fall
2011-06-25,3,3,0,0,1,18,21,39,fall
2011-06-25,3,4,0,0,1,7,4,11,fall
2011-06-25,3,5,0,0,1,6,8,14,fall
2011-06-25,3,6,0,0,1,12,17,29,fall
2011-06-25,3,7,0,0,1,7,35,42,fall
2011-06-25,3,8,0,0,1,27,85,112,fall
2011-06-25,3,9,0,0,1,47,139,186,fall
2011-06-25,3,10,0,0,1,99,203,302,fall
2011-06-25,3,11,0,0,1,122,209,331,fall
2011-06-25,3,12,0,0,1,140,252,392,fall
2011-06-25,3,13,0,0,1,140,231,371,fall
2011-06-25,3,14,0,0,1,151,232,383,fall
2011-06-25,3,15,0,0,1,157,235,392,fall
2011-06-25,3,16,0,0,1,175,235,410,fall
2011-06-25,3,17,0,0,1,152,247,399,fall
2011-06-25,3,18,0,0,1,108,199,307,fall
2011-06-25,3,19,0,0,1,121,254,375,fall
2011-06-25,3,20,0,0,1,74,195,269,fall
2011-06-25,3,21,0,0,1,62,140,202,fall
2011-06-25,3,22,0,0,1,61,126,187,fall
2011-06-25,3,23,0,0,2,49,130,179,fall
2011-06-26,3,0,0,0,1,30,85,115,fall
2011-06-26,3,1,0,0,1,17,73,90,fall
2011-06-26,3,2,0,0,1,17,70,87,fall
2011-06-26,3,3,0,0,1,12,22,34,fall
2011-06-26,3,4,0,0,1,3,8,11,fall
2011-06-26,3,5,0,0,1,3,9,12,fall
2011-06-26,3,6,0,0,1,7,13,20,fall
2011-06-26,3,7,0,0,1,24,27,51,fall
2011-06-26,3,8,0,0,1,29,78,107,fall
2011-06-26,3,9,0,0,1,75,131,206,fall
2011-06-26,3,10,0,0,1,136,196,332,fall
2011-06-26,3,11,0,0,1,127,219,346,fall
2011-06-26,3,12,0,0,1,175,268,443,fall
2011-06-26,3,13,0,0,1,197,245,442,fall
2011-06-26,3,14,0,0,1,197,246,443,fall
2011-06-26,3,15,0,0,1,174,229,403,fall
2011-06-26,3,16,0,0,1,177,278,455,fall
2011-06-26,3,17,0,0,2,178,243,421,fall
2011-06-26,3,18,0,0,2,117,265,382,fall
2011-06-26,3,19,0,0,2,89,228,317,fall
2011-06-26,3,20,0,0,2,55,158,213,fall
2011-06-26,3,21,0,0,2,48,135,183,fall
2011-06-26,3,22,0,0,1,19,95,114,fall
2011-06-26,3,23,0,0,1,14,64,78,fall
2011-06-27,3,0,0,1,3,7,25,32,fall
2011-06-27,3,1,0,1,2,4,11,15,fall
2011-06-27,3,2,0,1,3,3,3,6,fall
2011-06-27,3,3,0,1,3,0,2,2,fall
2011-06-27,3,4,0,1,2,1,8,9,fall
2011-06-27,3,5,0,1,2,1,21,22,fall
2011-06-27,3,6,0,1,2,4,90,94,fall
2011-06-27,3,7,0,1,2,14,247,261,fall
2011-06-27,3,8,0,1,1,29,418,447,fall
2011-06-27,3,9,0,1,2,37,150,187,fall
2011-06-27,3,10,0,1,2,55,95,150,fall
2011-06-27,3,11,0,1,2,55,95,150,fall
2011-06-27,3,12,0,1,2,40,130,170,fall
2011-06-27,3,13,0,1,2,37,127,164,fall
2011-06-27,3,14,0,1,2,58,100,158,fall
2011-06-27,3,15,0,1,2,76,126,202,fall
2011-06-27,3,16,0,1,1,53,222,275,fall
2011-06-27,3,17,0,1,1,90,514,604,fall
2011-06-27,3,18,0,1,1,79,512,591,fall
2011-06-27,3,19,0,1,1,56,340,396,fall
2011-06-27,3,20,0,1,1,54,251,305,fall
2011-06-27,3,21,0,1,1,52,190,242,fall
2011-06-27,3,22,0,1,1,33,112,145,fall
2011-06-27,3,23,0,1,1,16,65,81,fall
2011-06-28,3,0,0,1,2,5,25,30,fall
2011-06-28,3,1,0,1,1,5,8,13,fall
2011-06-28,3,2,0,1,2,2,9,11,fall
2011-06-28,3,3,0,1,2,0,2,2,fall
2011-06-28,3,4,0,1,1,1,7,8,fall
2011-06-28,3,5,0,1,1,1,20,21,fall
2011-06-28,3,6,0,1,1,7,117,124,fall
2011-06-28,3,7,0,1,1,27,320,347,fall
2011-06-28,3,8,0,1,1,39,417,456,fall
2011-06-28,3,9,0,1,1,38,208,246,fall
2011-06-28,3,10,0,1,1,45,112,157,fall
2011-06-28,3,11,0,1,1,49,118,167,fall
2011-06-28,3,12,0,1,1,41,161,202,fall
2011-06-28,3,13,0,1,1,33,156,189,fall
2011-06-28,3,14,0,1,1,43,117,160,fall
2011-06-28,3,15,0,1,1,39,127,166,fall
2011-06-28,3,16,0,1,1,41,220,261,fall
2011-06-28,3,17,0,1,3,70,509,579,fall
2011-06-28,3,18,0,1,3,68,436,504,fall
2011-06-28,3,19,0,1,2,44,255,299,fall
2011-06-28,3,20,0,1,1,50,246,296,fall
2011-06-28,3,21,0,1,1,31,164,195,fall
2011-06-28,3,22,0,1,1,30,104,134,fall
2011-06-28,3,23,0,1,1,23,58,81,fall
2011-06-29,3,0,0,1,2,11,25,36,fall
2011-06-29,3,1,0,1,1,10,18,28,fall
2011-06-29,3,2,0,1,1,7,9,16,fall
2011-06-29,3,3,0,1,2,2,3,5,fall
2011-06-29,3,4,0,1,1,0,5,5,fall
2011-06-29,3,5,0,1,1,3,19,22,fall
2011-06-29,3,6,0,1,1,12,104,116,fall
2011-06-29,3,7,0,1,1,18,318,336,fall
2011-06-29,3,8,0,1,1,41,499,540,fall
2011-06-29,3,9,0,1,1,32,189,221,fall
2011-06-29,3,10,0,1,1,31,95,126,fall
2011-06-29,3,11,0,1,1,53,117,170,fall
2011-06-29,3,12,0,1,1,55,188,243,fall
2011-06-29,3,13,0,1,1,45,186,231,fall
2011-06-29,3,14,0,1,1,50,138,188,fall
2011-06-29,3,15,0,1,1,43,146,189,fall
2011-06-29,3,16,0,1,1,60,268,328,fall
2011-06-29,3,17,0,1,1,78,492,570,fall
2011-06-29,3,18,0,1,1,78,510,588,fall
2011-06-29,3,19,0,1,1,60,341,401,fall
2011-06-29,3,20,0,1,1,69,264,333,fall
2011-06-29,3,21,0,1,1,26,195,221,fall
2011-06-29,3,22,0,1,1,32,151,183,fall
2011-06-29,3,23,0,1,1,32,97,129,fall
2011-06-30,3,0,0,1,1,15,39,54,fall
2011-06-30,3,1,0,1,1,13,19,32,fall
2011-06-30,3,2,0,1,1,2,6,8,fall
2011-06-30,3,3,0,1,1,2,7,9,fall
2011-06-30,3,4,0,1,1,2,4,6,fall
2011-06-30,3,5,0,1,1,1,24,25,fall
2011-06-30,3,6,0,1,1,4,119,123,fall
2011-06-30,3,7,0,1,1,29,291,320,fall
2011-06-30,3,8,0,1,1,44,511,555,fall
2011-06-30,3,9,0,1,1,33,227,260,fall
2011-06-30,3,10,0,1,1,35,97,132,fall
2011-06-30,3,11,0,1,1,47,122,169,fall
2011-06-30,3,12,0,1,1,50,183,233,fall
2011-06-30,3,13,0,1,1,70,162,232,fall
2011-06-30,3,14,0,1,1,46,117,163,fall
2011-06-30,3,15,0,1,1,64,176,240,fall
2011-06-30,3,16,0,1,1,63,260,323,fall
2011-06-30,3,17,0,1,1,98,496,594,fall
2011-06-30,3,18,0,1,1,114,472,586,fall
2011-06-30,3,19,0,1,1,89,366,455,fall
2011-06-30,3,20,0,1,1,55,285,340,fall
2011-06-30,3,21,0,1,1,81,242,323,fall
2011-06-30,3,22,0,1,1,43,164,207,fall
2011-06-30,3,23,0,1,1,27,99,126,fall
2011-07-01,3,0,0,1,1,20,48,68,fall
2011-07-01,3,1,0,1,1,15,16,31,fall
2011-07-01,3,2,0,1,1,6,7,13,fall
2011-07-01,3,3,0,1,1,5,6,11,fall
2011-07-01,3,4,0,1,1,1,5,6,fall
2011-07-01,3,5,0,1,1,3,27,30,fall
2011-07-01,3,6,0,1,1,11,97,108,fall
2011-07-01,3,7,0,1,1,25,218,243,fall
2011-07-01,3,8,0,1,1,39,453,492,fall
2011-07-01,3,9,0,1,1,58,202,260,fall
2011-07-01,3,10,0,1,1,61,109,170,fall
2011-07-01,3,11,0,1,1,68,146,214,fall
2011-07-01,3,12,0,1,1,83,180,263,fall
2011-07-01,3,13,0,1,1,83,209,292,fall
2011-07-01,3,14,0,1,1,78,225,303,fall
2011-07-01,3,15,0,1,1,82,299,381,fall
2011-07-01,3,16,0,1,1,85,342,427,fall
2011-07-01,3,17,0,1,1,99,362,461,fall
2011-07-01,3,18,0,1,1,98,324,422,fall
2011-07-01,3,19,0,1,1,80,238,318,fall
2011-07-01,3,20,0,1,1,84,185,269,fall
2011-07-01,3,21,0,1,1,69,149,218,fall
2011-07-01,3,22,0,1,1,49,173,222,fall
2011-07-01,3,23,0,1,1,44,96,140,fall
2011-07-02,3,0,0,0,1,31,84,115,fall
2011-07-02,3,1,0,0,1,20,58,78,fall
2011-07-02,3,2,0,0,1,9,43,52,fall
2011-07-02,3,3,0,0,1,5,21,26,fall
2011-07-02,3,4,0,0,1,3,8,11,fall
2011-07-02,3,5,0,0,1,1,13,14,fall
2011-07-02,3,6,0,0,1,11,21,32,fall
2011-07-02,3,7,0,0,1,10,35,45,fall
2011-07-02,3,8,0,0,1,38,94,132,fall
2011-07-02,3,9,0,0,1,55,124,179,fall
2011-07-02,3,10,0,0,1,103,168,271,fall
2011-07-02,3,11,0,0,1,144,213,357,fall
2011-07-02,3,12,0,0,1,142,232,374,fall
2011-07-02,3,13,0,0,1,178,226,404,fall
2011-07-02,3,14,0,0,1,177,215,392,fall
2011-07-02,3,15,0,0,1,168,163,331,fall
2011-07-02,3,16,0,0,1,206,192,398,fall
2011-07-02,3,17,0,0,1,179,170,349,fall
2011-07-02,3,18,0,0,1,193,190,383,fall
2011-07-02,3,19,0,0,1,156,149,305,fall
2011-07-02,3,20,0,0,1,136,148,284,fall
2011-07-02,3,21,0,0,1,95,137,232,fall
2011-07-02,3,22,0,0,1,78,123,201,fall
2011-07-02,3,23,0,0,1,66,88,154,fall
2011-07-03,3,0,0,0,1,47,97,144,fall
2011-07-03,3,1,0,0,2,23,55,78,fall
2011-07-03,3,2,0,0,1,19,50,69,fall
2011-07-03,3,3,0,0,3,8,25,33,fall
2011-07-03,3,4,0,0,3,3,2,5,fall
2011-07-03,3,5,0,0,3,0,1,1,fall
2011-07-03,3,6,0,0,2,0,3,3,fall
2011-07-03,3,7,0,0,2,3,22,25,fall
2011-07-03,3,8,0,0,1,39,53,92,fall
2011-07-03,3,9,0,0,1,82,99,181,fall
2011-07-03,3,10,0,0,1,131,133,264,fall
2011-07-03,3,11,0,0,1,215,175,390,fall
2011-07-03,3,12,0,0,1,198,206,404,fall
2011-07-03,3,13,0,0,1,248,173,421,fall
2011-07-03,3,14,0,0,1,225,150,375,fall
2011-07-03,3,15,0,0,1,194,182,376,fall
2011-07-03,3,16,0,0,1,195,219,414,fall
2011-07-03,3,17,0,0,3,181,177,358,fall
2011-07-03,3,18,0,0,3,74,107,181,fall
2011-07-03,3,19,0,0,2,100,83,183,fall
2011-07-03,3,20,0,0,3,83,93,176,fall
2011-07-03,3,21,0,0,2,75,92,167,fall
2011-07-03,3,22,0,0,2,69,93,162,fall
2011-07-03,3,23,0,0,1,70,77,147,fall
2011-07-04,3,0,1,0,1,63,77,140,fall
2011-07-04,3,1,1,0,1,43,76,119,fall
2011-07-04,3,2,1,0,1,33,30,63,fall
2011-07-04,3,3,1,0,1,13,13,26,fall
2011-07-04,3,4,1,0,2,8,4,12,fall
2011-07-04,3,5,1,0,2,1,3,4,fall
2011-07-04,3,6,1,0,1,5,11,16,fall
2011-07-04,3,7,1,0,1,17,19,36,fall
2011-07-04,3,8,1,0,1,42,44,86,fall
2011-07-04,3,9,1,0,2,142,96,238,fall
2011-07-04,3,10,1,0,2,166,114,280,fall
2011-07-04,3,11,1,0,2,177,172,349,fall
2011-07-04,3,12,1,0,2,237,210,447,fall
2011-07-04,3,13,1,0,2,242,181,423,fall
2011-07-04,3,14,1,0,1,235,173,408,fall
2011-07-04,3,15,1,0,1,224,184,408,fall
2011-07-04,3,16,1,0,1,236,216,452,fall
2011-07-04,3,17,1,0,1,240,196,436,fall
2011-07-04,3,18,1,0,1,222,196,418,fall
2011-07-04,3,19,1,0,2,170,205,375,fall
2011-07-04,3,20,1,0,2,195,191,386,fall
2011-07-04,3,21,1,0,2,195,262,457,fall
2011-07-04,3,22,1,0,2,115,211,326,fall
2011-07-04,3,23,1,0,2,44,94,138,fall
2011-07-05,3,0,0,1,2,19,36,55,fall
2011-07-05,3,1,0,1,1,15,24,39,fall
2011-07-05,3,2,0,1,1,8,5,13,fall
2011-07-05,3,3,0,1,1,1,7,8,fall
2011-07-05,3,4,0,1,1,1,4,5,fall
2011-07-05,3,5,0,1,1,1,19,20,fall
2011-07-05,3,6,0,1,1,3,91,94,fall
2011-07-05,3,7,0,1,1,22,248,270,fall
2011-07-05,3,8,0,1,1,41,391,432,fall
2011-07-05,3,9,0,1,1,50,177,227,fall
2011-07-05,3,10,0,1,1,55,84,139,fall
2011-07-05,3,11,0,1,1,75,97,172,fall
2011-07-05,3,12,0,1,1,71,130,201,fall
2011-07-05,3,13,0,1,1,67,136,203,fall
2011-07-05,3,14,0,1,1,66,112,178,fall
2011-07-05,3,15,0,1,1,51,111,162,fall
2011-07-05,3,16,0,1,1,79,202,281,fall
2011-07-05,3,17,0,1,1,79,466,545,fall
2011-07-05,3,18,0,1,1,70,426,496,fall
2011-07-05,3,19,0,1,1,71,297,368,fall
2011-07-05,3,20,0,1,1,59,225,284,fall
2011-07-05,3,21,0,1,1,77,168,245,fall
2011-07-05,3,22,0,1,1,31,124,155,fall
2011-07-05,3,23,0,1,1,19,54,73,fall
2011-07-06,3,0,0,1,1,11,26,37,fall
2011-07-06,3,1,0,1,1,4,11,15,fall
2011-07-06,3,2,0,1,1,1,4,5,fall
2011-07-06,3,3,0,1,1,0,6,6,fall
2011-07-06,3,4,0,1,2,0,6,6,fall
2011-07-06,3,5,0,1,1,5,30,35,fall
2011-07-06,3,6,0,1,1,9,112,121,fall
2011-07-06,3,7,0,1,2,24,288,312,fall
2011-07-06,3,8,0,1,2,31,397,428,fall
2011-07-06,3,9,0,1,3,31,158,189,fall
2011-07-06,3,10,0,1,3,13,30,43,fall
2011-07-06,3,11,0,1,2,24,103,127,fall
2011-07-06,3,12,0,1,2,38,114,152,fall
2011-07-06,3,13,0,1,2,33,107,140,fall
2011-07-06,3,14,0,1,1,50,113,163,fall
2011-07-06,3,15,0,1,1,55,130,185,fall
2011-07-06,3,16,0,1,1,57,218,275,fall
2011-07-06,3,17,0,1,1,79,517,596,fall
2011-07-06,3,18,0,1,1,77,486,563,fall
2011-07-06,3,19,0,1,1,71,323,394,fall
2011-07-06,3,20,0,1,1,55,257,312,fall
2011-07-06,3,21,0,1,1,66,175,241,fall
2011-07-06,3,22,0,1,1,30,156,186,fall
2011-07-06,3,23,0,1,1,20,78,98,fall
2011-07-07,3,0,0,1,1,6,29,35,fall
2011-07-07,3,1,0,1,1,2,14,16,fall
2011-07-07,3,2,0,1,1,1,7,8,fall
2011-07-07,3,3,0,1,1,2,2,4,fall
2011-07-07,3,4,0,1,1,0,4,4,fall
2011-07-07,3,5,0,1,1,2,30,32,fall
2011-07-07,3,6,0,1,2,11,107,118,fall
2011-07-07,3,7,0,1,2,13,279,292,fall
2011-07-07,3,8,0,1,2,28,415,443,fall
2011-07-07,3,9,0,1,1,25,154,179,fall
2011-07-07,3,10,0,1,1,29,72,101,fall
2011-07-07,3,11,0,1,1,30,112,142,fall
2011-07-07,3,12,0,1,1,32,139,171,fall
2011-07-07,3,13,0,1,1,48,107,155,fall
2011-07-07,3,14,0,1,1,39,121,160,fall
2011-07-07,3,15,0,1,1,47,119,166,fall
2011-07-07,3,16,0,1,1,47,218,265,fall
2011-07-07,3,17,0,1,1,80,489,569,fall
2011-07-07,3,18,0,1,1,70,492,562,fall
2011-07-07,3,19,0,1,1,79,286,365,fall
2011-07-07,3,20,0,1,1,61,224,285,fall
2011-07-07,3,21,0,1,1,39,170,209,fall
2011-07-07,3,22,0,1,1,32,150,182,fall
2011-07-07,3,23,0,1,1,31,98,129,fall
2011-07-08,3,0,0,1,1,6,41,47,fall
2011-07-08,3,1,0,1,1,9,25,34,fall
2011-07-08,3,2,0,1,2,10,12,22,fall
2011-07-08,3,3,0,1,1,2,4,6,fall
2011-07-08,3,4,0,1,1,7,4,11,fall
2011-07-08,3,5,0,1,1,3,24,27,fall
2011-07-08,3,6,0,1,1,11,91,102,fall
2011-07-08,3,7,0,1,2,30,302,332,fall
2011-07-08,3,8,0,1,2,36,421,457,fall
2011-07-08,3,9,0,1,2,30,211,241,fall
2011-07-08,3,10,0,1,2,30,108,138,fall
2011-07-08,3,11,0,1,2,61,104,165,fall
2011-07-08,3,12,0,1,2,49,164,213,fall
2011-07-08,3,13,0,1,2,54,175,229,fall
2011-07-08,3,14,0,1,2,53,163,216,fall
2011-07-08,3,15,0,1,2,39,102,141,fall
2011-07-08,3,16,0,1,3,27,105,132,fall
2011-07-08,3,17,0,1,3,6,161,167,fall
2011-07-08,3,18,0,1,1,35,281,316,fall
2011-07-08,3,19,0,1,1,45,225,270,fall
2011-07-08,3,20,0,1,1,30,220,250,fall
2011-07-08,3,21,0,1,2,46,158,204,fall
2011-07-08,3,22,0,1,2,33,136,169,fall
2011-07-08,3,23,0,1,2,40,111,151,fall
2011-07-09,3,0,0,0,2,31,90,121,fall
2011-07-09,3,1,0,0,2,5,48,53,fall
2011-07-09,3,2,0,0,1,12,43,55,fall
2011-07-09,3,3,0,0,1,7,23,30,fall
2011-07-09,3,4,0,0,1,2,4,6,fall
2011-07-09,3,5,0,0,2,4,11,15,fall
2011-07-09,3,6,0,0,2,11,27,38,fall
2011-07-09,3,7,0,0,1,21,50,71,fall
2011-07-09,3,8,0,0,1,68,114,182,fall
2011-07-09,3,9,0,0,1,77,170,247,fall
2011-07-09,3,10,0,0,1,87,177,264,fall
2011-07-09,3,11,0,0,1,101,189,290,fall
2011-07-09,3,12,0,0,1,145,221,366,fall
2011-07-09,3,13,0,0,1,167,249,416,fall
2011-07-09,3,14,0,0,1,158,215,373,fall
2011-07-09,3,15,0,0,1,182,220,402,fall
2011-07-09,3,16,0,0,1,171,245,416,fall
2011-07-09,3,17,0,0,1,160,241,401,fall
2011-07-09,3,18,0,0,1,132,246,378,fall
2011-07-09,3,19,0,0,1,128,178,306,fall
2011-07-09,3,20,0,0,1,129,185,314,fall
2011-07-09,3,21,0,0,1,83,155,238,fall
2011-07-09,3,22,0,0,1,60,154,214,fall
2011-07-09,3,23,0,0,1,47,93,140,fall
2011-07-10,3,0,0,0,1,42,112,154,fall
2011-07-10,3,1,0,0,1,19,94,113,fall
2011-07-10,3,2,0,0,1,28,68,96,fall
2011-07-10,3,3,0,0,1,6,19,25,fall
2011-07-10,3,4,0,0,1,0,5,5,fall
2011-07-10,3,5,0,0,1,7,10,17,fall
2011-07-10,3,6,0,0,1,8,17,25,fall
2011-07-10,3,7,0,0,1,27,38,65,fall
2011-07-10,3,8,0,0,1,27,65,92,fall
2011-07-10,3,9,0,0,1,62,107,169,fall
2011-07-10,3,10,0,0,1,95,173,268,fall
2011-07-10,3,11,0,0,1,110,177,287,fall
2011-07-10,3,12,0,0,1,133,244,377,fall
2011-07-10,3,13,0,0,1,139,228,367,fall
2011-07-10,3,14,0,0,1,122,227,349,fall
2011-07-10,3,15,0,0,1,142,219,361,fall
2011-07-10,3,16,0,0,1,128,244,372,fall
2011-07-10,3,17,0,0,1,146,217,363,fall
2011-07-10,3,18,0,0,1,141,222,363,fall
2011-07-10,3,19,0,0,1,120,183,303,fall
2011-07-10,3,20,0,0,1,101,167,268,fall
2011-07-10,3,21,0,0,1,65,162,227,fall
2011-07-10,3,22,0,0,1,56,87,143,fall
2011-07-10,3,23,0,0,1,19,53,72,fall
2011-07-11,3,0,0,1,1,10,25,35,fall
2011-07-11,3,1,0,1,1,5,5,10,fall
2011-07-11,3,2,0,1,1,8,4,12,fall
2011-07-11,3,3,0,1,1,2,8,10,fall
2011-07-11,3,4,0,1,1,0,4,4,fall
2011-07-11,3,5,0,1,1,5,21,26,fall
2011-07-11,3,6,0,1,1,19,102,121,fall
2011-07-11,3,7,0,1,1,28,289,317,fall
2011-07-11,3,8,0,1,1,35,385,420,fall
2011-07-11,3,9,0,1,1,41,167,208,fall
2011-07-11,3,10,0,1,1,44,73,117,fall
2011-07-11,3,11,0,1,1,39,89,128,fall
2011-07-11,3,12,0,1,1,40,108,148,fall
2011-07-11,3,13,0,1,1,22,119,141,fall
2011-07-11,3,14,0,1,1,40,94,134,fall
2011-07-11,3,15,0,1,1,38,108,146,fall
2011-07-11,3,16,0,1,1,57,182,239,fall
2011-07-11,3,17,0,1,1,59,455,514,fall
2011-07-11,3,18,0,1,1,57,415,472,fall
2011-07-11,3,19,0,1,1,80,293,373,fall
2011-07-11,3,20,0,1,1,42,194,236,fall
2011-07-11,3,21,0,1,1,21,109,130,fall
2011-07-11,3,22,0,1,1,20,70,90,fall
2011-07-11,3,23,0,1,1,11,44,55,fall
2011-07-12,3,0,0,1,1,3,19,22,fall
2011-07-12,3,1,0,1,1,6,8,14,fall
2011-07-12,3,2,0,1,1,2,7,9,fall
2011-07-12,3,3,0,1,2,2,6,8,fall
2011-07-12,3,4,0,1,1,0,6,6,fall
2011-07-12,3,5,0,1,1,4,21,25,fall
2011-07-12,3,6,0,1,1,13,102,115,fall
2011-07-12,3,7,0,1,1,29,301,330,fall
2011-07-12,3,8,0,1,1,35,382,417,fall
2011-07-12,3,9,0,1,1,27,149,176,fall
2011-07-12,3,10,0,1,1,38,85,123,fall
2011-07-12,3,11,0,1,1,39,86,125,fall
2011-07-12,3,12,0,1,1,38,125,163,fall
2011-07-12,3,13,0,1,1,32,104,136,fall
2011-07-12,3,14,0,1,1,33,91,124,fall
2011-07-12,3,15,0,1,1,37,111,148,fall
2011-07-12,3,16,0,1,1,25,177,202,fall
2011-07-12,3,17,0,1,1,48,380,428,fall
2011-07-12,3,18,0,1,1,39,472,511,fall
2011-07-12,3,19,0,1,1,42,295,337,fall
2011-07-12,3,20,0,1,1,57,251,308,fall
2011-07-12,3,21,0,1,1,49,209,258,fall
2011-07-12,3,22,0,1,1,44,150,194,fall
2011-07-12,3,23,0,1,1,20,59,79,fall
2011-07-13,3,0,0,1,1,9,37,46,fall
2011-07-13,3,1,0,1,1,1,11,12,fall
2011-07-13,3,2,0,1,1,2,3,5,fall
2011-07-13,3,3,0,1,1,0,4,4,fall
2011-07-13,3,4,0,1,1,0,5,5,fall
2011-07-13,3,5,0,1,1,4,22,26,fall
2011-07-13,3,6,0,1,1,18,103,121,fall
2011-07-13,3,7,0,1,1,32,281,313,fall
2011-07-13,3,8,0,1,1,31,418,449,fall
2011-07-13,3,9,0,1,1,23,163,186,fall
2011-07-13,3,10,0,1,1,33,80,113,fall
2011-07-13,3,11,0,1,1,55,110,165,fall
2011-07-13,3,12,0,1,1,40,134,174,fall
2011-07-13,3,13,0,1,3,39,119,158,fall
2011-07-13,3,14,0,1,3,27,89,116,fall
2011-07-13,3,15,0,1,3,13,33,46,fall
2011-07-13,3,16,0,1,2,23,118,141,fall
2011-07-13,3,17,0,1,1,70,418,488,fall
2011-07-13,3,18,0,1,1,51,412,463,fall
2011-07-13,3,19,0,1,1,79,340,419,fall
2011-07-13,3,20,0,1,1,61,281,342,fall
2011-07-13,3,21,0,1,1,56,194,250,fall
2011-07-13,3,22,0,1,1,48,136,184,fall
2011-07-13,3,23,0,1,1,33,83,116,fall
2011-07-14,3,0,0,1,1,14,32,46,fall
2011-07-14,3,1,0,1,1,4,21,25,fall
2011-07-14,3,2,0,1,1,3,7,10,fall
2011-07-14,3,3,0,1,1,1,5,6,fall
2011-07-14,3,4,0,1,1,0,6,6,fall
2011-07-14,3,5,0,1,1,6,22,28,fall
2011-07-14,3,6,0,1,1,14,116,130,fall
2011-07-14,3,7,0,1,1,23,311,334,fall
2011-07-14,3,8,0,1,1,53,433,486,fall
2011-07-14,3,9,0,1,1,29,195,224,fall
2011-07-14,3,10,0,1,1,32,95,127,fall
2011-07-14,3,11,0,1,1,38,110,148,fall
2011-07-14,3,12,0,1,1,51,172,223,fall
2011-07-14,3,13,0,1,1,39,138,177,fall
2011-07-14,3,14,0,1,1,49,129,178,fall
2011-07-14,3,15,0,1,1,42,138,180,fall
2011-07-14,3,16,0,1,1,43,231,274,fall
2011-07-14,3,17,0,1,1,78,517,595,fall
2011-07-14,3,18,0,1,1,94,484,578,fall
2011-07-14,3,19,0,1,1,67,333,400,fall
2011-07-14,3,20,0,1,1,81,267,348,fall
2011-07-14,3,21,0,1,1,58,203,261,fall
2011-07-14,3,22,0,1,1,42,134,176,fall
2011-07-14,3,23,0,1,1,27,97,124,fall
2011-07-15,3,0,0,1,1,23,57,80,fall
2011-07-15,3,1,0,1,1,7,13,20,fall
2011-07-15,3,2,0,1,1,16,22,38,fall
2011-07-15,3,3,0,1,1,1,6,7,fall
2011-07-15,3,4,0,1,1,2,8,10,fall
2011-07-15,3,5,0,1,1,7,16,23,fall
2011-07-15,3,6,0,1,2,12,108,120,fall
2011-07-15,3,7,0,1,1,17,257,274,fall
2011-07-15,3,8,0,1,1,50,514,564,fall
2011-07-15,3,9,0,1,1,31,176,207,fall
2011-07-15,3,10,0,1,2,59,107,166,fall
2011-07-15,3,11,0,1,1,73,137,210,fall
2011-07-15,3,12,0,1,1,61,177,238,fall
2011-07-15,3,13,0,1,1,85,162,247,fall
2011-07-15,3,14,0,1,1,105,160,265,fall
2011-07-15,3,15,0,1,1,74,163,237,fall
2011-07-15,3,16,0,1,1,96,265,361,fall
2011-07-15,3,17,0,1,1,104,483,587,fall
2011-07-15,3,18,0,1,1,102,394,496,fall
2011-07-15,3,19,0,1,1,114,280,394,fall
2011-07-15,3,20,0,1,1,92,251,343,fall
2011-07-15,3,21,0,1,1,75,186,261,fall
2011-07-15,3,22,0,1,1,71,152,223,fall
2011-07-15,3,23,0,1,1,41,126,167,fall
2011-07-16,3,0,0,0,1,42,68,110,fall
2011-07-16,3,1,0,0,1,24,51,75,fall
2011-07-16,3,2,0,0,1,10,48,58,fall
2011-07-16,3,3,0,0,1,6,20,26,fall
2011-07-16,3,4,0,0,1,9,7,16,fall
2011-07-16,3,5,0,0,1,4,6,10,fall
2011-07-16,3,6,0,0,1,16,21,37,fall
2011-07-16,3,7,0,0,1,14,38,52,fall
2011-07-16,3,8,0,0,1,37,90,127,fall
2011-07-16,3,9,0,0,1,72,150,222,fall
2011-07-16,3,10,0,0,1,114,208,322,fall
2011-07-16,3,11,0,0,1,171,225,396,fall
2011-07-16,3,12,0,0,1,187,276,463,fall
2011-07-16,3,13,0,0,1,221,276,497,fall
2011-07-16,3,14,0,0,1,201,232,433,fall
2011-07-16,3,15,0,0,1,205,223,428,fall
2011-07-16,3,16,0,0,1,183,242,425,fall
2011-07-16,3,17,0,0,1,234,241,475,fall
2011-07-16,3,18,0,0,1,185,243,428,fall
2011-07-16,3,19,0,0,1,164,242,406,fall
2011-07-16,3,20,0,0,1,108,188,296,fall
2011-07-16,3,21,0,0,1,85,167,252,fall
2011-07-16,3,22,0,0,1,65,136,201,fall
2011-07-16,3,23,0,0,1,61,107,168,fall
2011-07-17,3,0,0,0,1,34,91,125,fall
2011-07-17,3,1,0,0,1,16,86,102,fall
2011-07-17,3,2,0,0,1,28,66,94,fall
2011-07-17,3,3,0,0,1,21,26,47,fall
2011-07-17,3,4,0,0,1,4,6,10,fall
2011-07-17,3,5,0,0,1,4,8,12,fall
2011-07-17,3,6,0,0,1,10,11,21,fall
2011-07-17,3,7,0,0,1,20,30,50,fall
2011-07-17,3,8,0,0,1,45,73,118,fall
2011-07-17,3,9,0,0,1,74,110,184,fall
2011-07-17,3,10,0,0,1,127,177,304,fall
2011-07-17,3,11,0,0,1,147,244,391,fall
2011-07-17,3,12,0,0,1,177,243,420,fall
2011-07-17,3,13,0,0,1,200,272,472,fall
2011-07-17,3,14,0,0,1,168,262,430,fall
2011-07-17,3,15,0,0,1,129,195,324,fall
2011-07-17,3,16,0,0,1,129,188,317,fall
2011-07-17,3,17,0,0,1,133,236,369,fall
2011-07-17,3,18,0,0,1,147,243,390,fall
2011-07-17,3,19,0,0,1,145,234,379,fall
2011-07-17,3,20,0,0,1,85,177,262,fall
2011-07-17,3,21,0,0,1,59,148,207,fall
2011-07-17,3,22,0,0,1,65,116,181,fall
2011-07-17,3,23,0,0,1,39,54,93,fall
2011-07-18,3,0,0,1,1,21,30,51,fall
2011-07-18,3,1,0,1,1,17,8,25,fall
2011-07-18,3,2,0,1,1,2,8,10,fall
2011-07-18,3,3,0,1,1,3,4,7,fall
2011-07-18,3,4,0,1,1,1,3,4,fall
2011-07-18,3,5,0,1,1,2,15,17,fall
2011-07-18,3,6,0,1,1,10,95,105,fall
2011-07-18,3,7,0,1,1,22,255,277,fall
2011-07-18,3,8,0,1,1,18,329,347,fall
2011-07-18,3,9,0,1,1,33,170,203,fall
2011-07-18,3,10,0,1,1,52,78,130,fall
2011-07-18,3,11,0,1,1,42,99,141,fall
2011-07-18,3,12,0,1,1,39,126,165,fall
2011-07-18,3,13,0,1,1,27,125,152,fall
2011-07-18,3,14,0,1,1,32,106,138,fall
2011-07-18,3,15,0,1,1,53,111,164,fall
2011-07-18,3,16,0,1,1,45,220,265,fall
2011-07-18,3,17,0,1,1,72,473,545,fall
2011-07-18,3,18,0,1,1,80,478,558,fall
2011-07-18,3,19,0,1,1,63,335,398,fall
2011-07-18,3,20,0,1,1,91,232,323,fall
2011-07-18,3,21,0,1,1,48,154,202,fall
2011-07-18,3,22,0,1,1,36,104,140,fall
2011-07-18,3,23,0,1,1,32,59,91,fall
2011-07-19,3,0,0,1,1,25,26,51,fall
2011-07-19,3,1,0,1,2,7,6,13,fall
2011-07-19,3,2,0,1,1,9,4,13,fall
2011-07-19,3,3,0,1,1,2,1,3,fall
2011-07-19,3,4,0,1,1,1,4,5,fall
2011-07-19,3,5,0,1,2,0,19,19,fall
2011-07-19,3,6,0,1,2,8,126,134,fall
2011-07-19,3,7,0,1,2,28,287,315,fall
2011-07-19,3,8,0,1,2,31,381,412,fall
2011-07-19,3,9,0,1,2,22,177,199,fall
2011-07-19,3,10,0,1,2,29,112,141,fall
2011-07-19,3,11,0,1,1,29,98,127,fall
2011-07-19,3,12,0,1,1,26,127,153,fall
2011-07-19,3,13,0,1,1,33,139,172,fall
2011-07-19,3,14,0,1,1,41,111,152,fall
2011-07-19,3,15,0,1,1,48,110,158,fall
2011-07-19,3,16,0,1,1,61,216,277,fall
2011-07-19,3,17,0,1,1,68,445,513,fall
2011-07-19,3,18,0,1,1,80,450,530,fall
2011-07-19,3,19,0,1,1,54,334,388,fall
2011-07-19,3,20,0,1,1,48,229,277,fall
2011-07-19,3,21,0,1,1,47,194,241,fall
2011-07-19,3,22,0,1,1,36,120,156,fall
2011-07-19,3,23,0,1,3,19,73,92,fall
2011-07-20,3,0,0,1,1,11,29,40,fall
2011-07-20,3,1,0,1,1,4,7,11,fall
2011-07-20,3,2,0,1,1,2,7,9,fall
2011-07-20,3,3,0,1,1,2,4,6,fall
2011-07-20,3,4,0,1,1,0,4,4,fall
2011-07-20,3,5,0,1,1,4,19,23,fall
2011-07-20,3,6,0,1,2,5,111,116,fall
2011-07-20,3,7,0,1,2,27,276,303,fall
2011-07-20,3,8,0,1,1,34,404,438,fall
2011-07-20,3,9,0,1,1,28,181,209,fall
2011-07-20,3,10,0,1,1,34,76,110,fall
2011-07-20,3,11,0,1,1,26,116,142,fall
2011-07-20,3,12,0,1,1,28,121,149,fall
2011-07-20,3,13,0,1,1,23,97,120,fall
2011-07-20,3,14,0,1,1,44,83,127,fall
2011-07-20,3,15,0,1,1,36,102,138,fall
2011-07-20,3,16,0,1,1,30,204,234,fall
2011-07-20,3,17,0,1,1,50,405,455,fall
2011-07-20,3,18,0,1,1,68,429,497,fall
2011-07-20,3,19,0,1,1,59,323,382,fall
2011-07-20,3,20,0,1,1,45,264,309,fall
2011-07-20,3,21,0,1,1,33,209,242,fall
2011-07-20,3,22,0,1,1,25,144,169,fall
2011-07-20,3,23,0,1,1,26,73,99,fall
2011-07-21,3,0,0,1,2,13,29,42,fall
2011-07-21,3,1,0,1,2,5,16,21,fall
2011-07-21,3,2,0,1,2,2,4,6,fall
2011-07-21,3,3,0,1,2,1,5,6,fall
2011-07-21,3,4,0,1,2,0,4,4,fall
2011-07-21,3,5,0,1,2,2,16,18,fall
2011-07-21,3,6,0,1,2,6,111,117,fall
2011-07-21,3,7,0,1,2,23,251,274,fall
2011-07-21,3,8,0,1,2,23,358,381,fall
2011-07-21,3,9,0,1,2,34,166,200,fall
2011-07-21,3,10,0,1,2,31,47,78,fall
2011-07-21,3,11,0,1,2,27,79,106,fall
2011-07-21,3,12,0,1,1,29,106,135,fall
2011-07-21,3,13,0,1,1,21,81,102,fall
2011-07-21,3,14,0,1,1,50,97,147,fall
2011-07-21,3,15,0,1,1,40,93,133,fall
2011-07-21,3,16,0,1,1,43,167,210,fall
2011-07-21,3,17,0,1,1,40,374,414,fall
2011-07-21,3,18,0,1,1,39,343,382,fall
2011-07-21,3,19,0,1,1,51,233,284,fall
2011-07-21,3,20,0,1,1,38,199,237,fall
2011-07-21,3,21,0,1,1,38,187,225,fall
2011-07-21,3,22,0,1,1,36,113,149,fall
2011-07-21,3,23,0,1,1,40,73,113,fall
2011-07-22,3,0,0,1,1,9,51,60,fall
2011-07-22,3,1,0,1,1,7,17,24,fall
2011-07-22,3,2,0,1,1,0,14,14,fall
2011-07-22,3,3,0,1,1,1,6,7,fall
2011-07-22,3,4,0,1,1,8,5,13,fall
2011-07-22,3,5,0,1,1,2,17,19,fall
2011-07-22,3,6,0,1,1,13,83,96,fall
2011-07-22,3,7,0,1,2,20,232,252,fall
2011-07-22,3,8,0,1,2,30,292,322,fall
2011-07-22,3,9,0,1,1,31,177,208,fall
2011-07-22,3,10,0,1,1,32,83,115,fall
2011-07-22,3,11,0,1,1,23,86,109,fall
2011-07-22,3,12,0,1,1,20,95,115,fall
2011-07-22,3,13,0,1,1,25,98,123,fall
2011-07-22,3,14,0,1,1,24,77,101,fall
2011-07-22,3,15,0,1,1,32,101,133,fall
2011-07-22,3,16,0,1,3,29,153,182,fall
2011-07-22,3,17,0,1,1,35,271,306,fall
2011-07-22,3,18,0,1,1,34,250,284,fall
2011-07-22,3,19,0,1,2,40,210,250,fall
2011-07-22,3,20,0,1,1,46,166,212,fall
2011-07-22,3,21,0,1,1,38,152,190,fall
2011-07-22,3,22,0,1,2,44,105,149,fall
2011-07-22,3,23,0,1,1,19,84,103,fall
2011-07-23,3,0,0,0,1,16,85,101,fall
2011-07-23,3,1,0,0,1,13,57,70,fall
2011-07-23,3,2,0,0,1,13,48,61,fall
2011-07-23,3,3,0,0,1,6,16,22,fall
2011-07-23,3,4,0,0,1,5,4,9,fall
2011-07-23,3,5,0,0,1,1,6,7,fall
2011-07-23,3,6,0,0,1,6,19,25,fall
2011-07-23,3,7,0,0,1,7,38,45,fall
2011-07-23,3,8,0,0,1,24,85,109,fall
2011-07-23,3,9,0,0,1,30,102,132,fall
2011-07-23,3,10,0,0,1,61,137,198,fall
2011-07-23,3,11,0,0,1,62,154,216,fall
2011-07-23,3,12,0,0,1,71,164,235,fall
2011-07-23,3,13,0,0,1,78,167,245,fall
2011-07-23,3,14,0,0,1,84,152,236,fall
2011-07-23,3,15,0,0,1,78,137,215,fall
2011-07-23,3,16,0,0,1,70,151,221,fall
2011-07-23,3,17,0,0,1,70,127,197,fall
2011-07-23,3,18,0,0,1,62,134,196,fall
2011-07-23,3,19,0,0,2,80,137,217,fall
2011-07-23,3,20,0,0,1,47,98,145,fall
2011-07-23,3,21,0,0,1,39,115,154,fall
2011-07-23,3,22,0,0,1,37,88,125,fall
2011-07-23,3,23,0,0,1,27,77,104,fall
2011-07-24,3,0,0,0,1,42,77,119,fall
2011-07-24,3,1,0,0,1,33,63,96,fall
2011-07-24,3,2,0,0,1,12,48,60,fall
2011-07-24,3,3,0,0,1,17,20,37,fall
2011-07-24,3,4,0,0,1,1,5,6,fall
2011-07-24,3,5,0,0,1,5,3,8,fall
2011-07-24,3,6,0,0,2,9,13,22,fall
2011-07-24,3,7,0,0,1,6,29,35,fall
2011-07-24,3,8,0,0,1,22,82,104,fall
2011-07-24,3,9,0,0,1,42,112,154,fall
2011-07-24,3,10,0,0,1,61,165,226,fall
2011-07-24,3,11,0,0,1,74,169,243,fall
2011-07-24,3,12,0,0,1,85,161,246,fall
2011-07-24,3,13,0,0,1,90,162,252,fall
2011-07-24,3,14,0,0,1,79,204,283,fall
2011-07-24,3,15,0,0,1,68,170,238,fall
2011-07-24,3,16,0,0,1,62,187,249,fall
2011-07-24,3,17,0,0,1,75,174,249,fall
2011-07-24,3,18,0,0,1,67,176,243,fall
2011-07-24,3,19,0,0,1,70,170,240,fall
2011-07-24,3,20,0,0,1,52,143,195,fall
2011-07-24,3,21,0,0,1,42,111,153,fall
2011-07-24,3,22,0,0,1,23,75,98,fall
2011-07-24,3,23,0,0,2,13,37,50,fall
2011-07-25,3,0,0,1,2,17,17,34,fall
2011-07-25,3,1,0,1,2,4,8,12,fall
2011-07-25,3,2,0,1,2,3,3,6,fall
2011-07-25,3,3,0,1,1,2,2,4,fall
2011-07-25,3,4,0,1,1,0,6,6,fall
2011-07-25,3,5,0,1,1,2,22,24,fall
2011-07-25,3,6,0,1,2,7,100,107,fall
2011-07-25,3,7,0,1,2,20,257,277,fall
2011-07-25,3,8,0,1,2,34,353,387,fall
2011-07-25,3,9,0,1,1,11,124,135,fall
2011-07-25,3,10,0,1,1,30,54,84,fall
2011-07-25,3,11,0,1,2,24,83,107,fall
2011-07-25,3,12,0,1,2,17,50,67,fall
2011-07-25,3,13,0,1,2,14,64,78,fall
2011-07-25,3,14,0,1,2,28,62,90,fall
2011-07-25,3,15,0,1,1,16,96,112,fall
2011-07-25,3,16,0,1,1,37,161,198,fall
2011-07-25,3,17,0,1,1,48,437,485,fall
2011-07-25,3,18,0,1,1,60,473,533,fall
2011-07-25,3,19,0,1,1,62,324,386,fall
2011-07-25,3,20,0,1,1,55,247,302,fall
2011-07-25,3,21,0,1,1,41,153,194,fall
2011-07-25,3,22,0,1,1,13,112,125,fall
2011-07-25,3,23,0,1,1,23,64,87,fall
2011-07-26,3,0,0,1,1,8,20,28,fall
2011-07-26,3,1,0,1,1,6,6,12,fall
2011-07-26,3,2,0,1,1,1,6,7,fall
2011-07-26,3,3,0,1,1,2,2,4,fall
2011-07-26,3,4,0,1,1,0,6,6,fall
2011-07-26,3,5,0,1,1,3,24,27,fall
2011-07-26,3,6,0,1,1,2,108,110,fall
2011-07-26,3,7,0,1,1,30,288,318,fall
2011-07-26,3,8,0,1,1,32,392,424,fall
2011-07-26,3,9,0,1,1,25,162,187,fall
2011-07-26,3,10,0,1,1,42,96,138,fall
2011-07-26,3,11,0,1,1,49,102,151,fall
2011-07-26,3,12,0,1,1,25,122,147,fall
2011-07-26,3,13,0,1,1,43,139,182,fall
2011-07-26,3,14,0,1,1,46,101,147,fall
2011-07-26,3,15,0,1,1,49,114,163,fall
2011-07-26,3,16,0,1,1,41,213,254,fall
2011-07-26,3,17,0,1,1,72,465,537,fall
2011-07-26,3,18,0,1,1,68,478,546,fall
2011-07-26,3,19,0,1,1,69,329,398,fall
2011-07-26,3,20,0,1,1,47,243,290,fall
2011-07-26,3,21,0,1,1,45,222,267,fall
2011-07-26,3,22,0,1,1,27,131,158,fall
2011-07-26,3,23,0,1,1,18,71,89,fall
2011-07-27,3,0,0,1,2,19,26,45,fall
2011-07-27,3,1,0,1,1,1,9,10,fall
2011-07-27,3,2,0,1,1,1,5,6,fall
2011-07-27,3,3,0,1,1,0,4,4,fall
2011-07-27,3,4,0,1,1,1,3,4,fall
2011-07-27,3,5,0,1,1,0,18,18,fall
2011-07-27,3,6,0,1,1,4,119,123,fall
2011-07-27,3,7,0,1,1,34,313,347,fall
2011-07-27,3,8,0,1,1,28,405,433,fall
2011-07-27,3,9,0,1,1,27,189,216,fall
2011-07-27,3,10,0,1,1,32,82,114,fall
2011-07-27,3,11,0,1,1,42,94,136,fall
2011-07-27,3,12,0,1,1,37,132,169,fall
2011-07-27,3,13,0,1,1,29,151,180,fall
2011-07-27,3,14,0,1,1,20,107,127,fall
2011-07-27,3,15,0,1,1,37,103,140,fall
2011-07-27,3,16,0,1,1,40,228,268,fall
2011-07-27,3,17,0,1,1,81,491,572,fall
2011-07-27,3,18,0,1,1,78,463,541,fall
2011-07-27,3,19,0,1,1,87,288,375,fall
2011-07-27,3,20,0,1,1,55,239,294,fall
2011-07-27,3,21,0,1,1,49,196,245,fall
2011-07-27,3,22,0,1,1,37,143,180,fall
2011-07-27,3,23,0,1,1,16,93,109,fall
2011-07-28,3,0,0,1,1,14,31,45,fall
2011-07-28,3,1,0,1,1,3,26,29,fall
2011-07-28,3,2,0,1,1,2,5,7,fall
2011-07-28,3,3,0,1,1,0,5,5,fall
2011-07-28,3,4,0,1,1,0,6,6,fall
2011-07-28,3,5,0,1,1,1,26,27,fall
2011-07-28,3,6,0,1,1,6,110,116,fall
2011-07-28,3,7,0,1,1,27,278,305,fall
2011-07-28,3,8,0,1,1,47,409,456,fall
2011-07-28,3,9,0,1,1,21,189,210,fall
2011-07-28,3,10,0,1,1,30,86,116,fall
2011-07-28,3,11,0,1,1,41,113,154,fall
2011-07-28,3,12,0,1,1,35,151,186,fall
2011-07-28,3,13,0,1,1,26,126,152,fall
2011-07-28,3,14,0,1,2,27,111,138,fall
2011-07-28,3,15,0,1,1,22,124,146,fall
2011-07-28,3,16,0,1,1,42,214,256,fall
2011-07-28,3,17,0,1,1,45,423,468,fall
2011-07-28,3,18,0,1,1,55,428,483,fall
2011-07-28,3,19,0,1,1,37,285,322,fall
2011-07-28,3,20,0,1,1,41,229,270,fall
2011-07-28,3,21,0,1,1,31,165,196,fall
2011-07-28,3,22,0,1,1,25,149,174,fall
2011-07-28,3,23,0,1,1,28,95,123,fall
2011-07-29,3,0,0,1,1,12,45,57,fall
2011-07-29,3,1,0,1,1,12,22,34,fall
2011-07-29,3,2,0,1,1,3,10,13,fall
2011-07-29,3,3,0,1,1,2,9,11,fall
2011-07-29,3,4,0,1,1,2,4,6,fall
2011-07-29,3,5,0,1,1,4,23,27,fall
2011-07-29,3,6,0,1,2,7,83,90,fall
2011-07-29,3,7,0,1,2,26,228,254,fall
2011-07-29,3,8,0,1,2,30,354,384,fall
2011-07-29,3,9,0,1,1,28,151,179,fall
2011-07-29,3,10,0,1,1,37,69,106,fall
2011-07-29,3,11,0,1,1,43,118,161,fall
2011-07-29,3,12,0,1,1,40,95,135,fall
2011-07-29,3,13,0,1,1,42,114,156,fall
2011-07-29,3,14,0,1,1,34,114,148,fall
2011-07-29,3,15,0,1,1,40,129,169,fall
2011-07-29,3,16,0,1,1,35,198,233,fall
2011-07-29,3,17,0,1,1,47,374,421,fall
2011-07-29,3,18,0,1,1,49,313,362,fall
2011-07-29,3,19,0,1,1,22,219,241,fall
2011-07-29,3,20,0,1,1,53,153,206,fall
2011-07-29,3,21,0,1,1,29,134,163,fall
2011-07-29,3,22,0,1,1,47,127,174,fall
2011-07-29,3,23,0,1,1,26,90,116,fall
2011-07-30,3,0,0,0,1,60,73,133,fall
2011-07-30,3,1,0,0,1,15,75,90,fall
2011-07-30,3,2,0,0,1,11,31,42,fall
2011-07-30,3,3,0,0,1,18,25,43,fall
2011-07-30,3,4,0,0,1,4,6,10,fall
2011-07-30,3,5,0,0,1,4,9,13,fall
2011-07-30,3,6,0,0,1,6,18,24,fall
2011-07-30,3,7,0,0,1,3,39,42,fall
2011-07-30,3,8,0,0,1,27,87,114,fall
2011-07-30,3,9,0,0,1,49,125,174,fall
2011-07-30,3,10,0,0,1,79,182,261,fall
2011-07-30,3,11,0,0,1,111,206,317,fall
2011-07-30,3,12,0,0,1,111,230,341,fall
2011-07-30,3,13,0,0,1,125,183,308,fall
2011-07-30,3,14,0,0,1,112,193,305,fall
2011-07-30,3,15,0,0,1,113,189,302,fall
2011-07-30,3,16,0,0,1,126,176,302,fall
2011-07-30,3,17,0,0,1,93,209,302,fall
2011-07-30,3,18,0,0,1,92,207,299,fall
2011-07-30,3,19,0,0,1,101,155,256,fall
2011-07-30,3,20,0,0,1,74,132,206,fall
2011-07-30,3,21,0,0,1,82,123,205,fall
2011-07-30,3,22,0,0,1,80,129,209,fall
2011-07-30,3,23,0,0,1,63,114,177,fall
2011-07-31,3,0,0,0,1,33,80,113,fall
2011-07-31,3,1,0,0,1,8,71,79,fall
2011-07-31,3,2,0,0,1,19,48,67,fall
2011-07-31,3,3,0,0,1,24,26,50,fall
2011-07-31,3,4,0,0,1,6,7,13,fall
2011-07-31,3,5,0,0,1,4,4,8,fall
2011-07-31,3,6,0,0,1,5,8,13,fall
2011-07-31,3,7,0,0,1,19,26,45,fall
2011-07-31,3,8,0,0,1,54,88,142,fall
2011-07-31,3,9,0,0,1,55,128,183,fall
2011-07-31,3,10,0,0,1,91,163,254,fall
2011-07-31,3,11,0,0,1,112,163,275,fall
2011-07-31,3,12,0,0,1,146,192,338,fall
2011-07-31,3,13,0,0,1,142,152,294,fall
2011-07-31,3,14,0,0,1,130,196,326,fall
2011-07-31,3,15,0,0,1,109,184,293,fall
2011-07-31,3,16,0,0,1,98,208,306,fall
2011-07-31,3,17,0,0,1,114,206,320,fall
2011-07-31,3,18,0,0,1,91,213,304,fall
2011-07-31,3,19,0,0,1,87,187,274,fall
2011-07-31,3,20,0,0,1,70,205,275,fall
2011-07-31,3,21,0,0,1,68,96,164,fall
2011-07-31,3,22,0,0,1,25,71,96,fall
2011-07-31,3,23,0,0,1,14,56,70,fall
2011-08-01,3,0,0,1,1,7,22,29,fall
2011-08-01,3,1,0,1,1,5,12,17,fall
2011-08-01,3,2,0,1,1,4,7,11,fall
2011-08-01,3,3,0,1,1,0,4,4,fall
2011-08-01,3,4,0,1,1,2,2,4,fall
2011-08-01,3,5,0,1,1,2,24,26,fall
2011-08-01,3,6,0,1,1,3,97,100,fall
2011-08-01,3,7,0,1,1,24,258,282,fall
2011-08-01,3,8,0,1,1,35,347,382,fall
2011-08-01,3,9,0,1,1,27,139,166,fall
2011-08-01,3,10,0,1,1,27,70,97,fall
2011-08-01,3,11,0,1,1,53,66,119,fall
2011-08-01,3,12,0,1,1,53,115,168,fall
2011-08-01,3,13,0,1,1,38,112,150,fall
2011-08-01,3,14,0,1,1,37,86,123,fall
2011-08-01,3,15,0,1,1,52,77,129,fall
2011-08-01,3,16,0,1,1,34,197,231,fall
2011-08-01,3,17,0,1,1,69,445,514,fall
2011-08-01,3,18,0,1,1,68,475,543,fall
2011-08-01,3,19,0,1,1,63,350,413,fall
2011-08-01,3,20,0,1,1,49,256,305,fall
2011-08-01,3,21,0,1,1,42,178,220,fall
2011-08-01,3,22,0,1,1,21,116,137,fall
2011-08-01,3,23,0,1,1,14,82,96,fall
2011-08-02,3,0,0,1,1,11,18,29,fall
2011-08-02,3,1,0,1,1,4,8,12,fall
2011-08-02,3,2,0,1,1,2,6,8,fall
2011-08-02,3,3,0,1,1,0,5,5,fall
2011-08-02,3,4,0,1,1,0,10,10,fall
2011-08-02,3,5,0,1,1,4,17,21,fall
2011-08-02,3,6,0,1,1,12,105,117,fall
2011-08-02,3,7,0,1,1,15,320,335,fall
2011-08-02,3,8,0,1,1,37,398,435,fall
2011-08-02,3,9,0,1,1,31,182,213,fall
2011-08-02,3,10,0,1,1,50,90,140,fall
2011-08-02,3,11,0,1,1,32,96,128,fall
2011-08-02,3,12,0,1,1,45,112,157,fall
2011-08-02,3,13,0,1,1,50,153,203,fall
2011-08-02,3,14,0,1,1,45,114,159,fall
2011-08-02,3,15,0,1,1,48,120,168,fall
2011-08-02,3,16,0,1,1,58,216,274,fall
2011-08-02,3,17,0,1,2,63,493,556,fall
2011-08-02,3,18,0,1,2,65,491,556,fall
2011-08-02,3,19,0,1,2,85,369,454,fall
2011-08-02,3,20,0,1,2,40,248,288,fall
2011-08-02,3,21,0,1,1,53,201,254,fall
2011-08-02,3,22,0,1,2,22,169,191,fall
2011-08-02,3,23,0,1,2,29,103,132,fall
2011-08-03,3,0,0,1,2,11,32,43,fall
2011-08-03,3,1,0,1,2,7,9,16,fall
2011-08-03,3,2,0,1,2,2,9,11,fall
2011-08-03,3,3,0,1,2,0,4,4,fall
2011-08-03,3,4,0,1,2,0,7,7,fall
2011-08-03,3,5,0,1,2,2,22,24,fall
2011-08-03,3,6,0,1,3,9,101,110,fall
2011-08-03,3,7,0,1,2,19,252,271,fall
2011-08-03,3,8,0,1,2,29,408,437,fall
2011-08-03,3,9,0,1,2,23,172,195,fall
2011-08-03,3,10,0,1,3,9,59,68,fall
2011-08-03,3,11,0,1,2,29,93,122,fall
2011-08-03,3,12,0,1,3,19,142,161,fall
2011-08-03,3,13,0,1,2,37,107,144,fall
2011-08-03,3,14,0,1,2,43,104,147,fall
2011-08-03,3,15,0,1,2,31,87,118,fall
2011-08-03,3,16,0,1,3,21,129,150,fall
2011-08-03,3,17,0,1,2,47,378,425,fall
2011-08-03,3,18,0,1,3,49,443,492,fall
2011-08-03,3,19,0,1,3,51,270,321,fall
2011-08-03,3,20,0,1,3,7,80,87,fall
2011-08-03,3,21,0,1,2,7,81,88,fall
2011-08-03,3,22,0,1,3,11,66,77,fall
2011-08-03,3,23,0,1,2,4,52,56,fall
2011-08-04,3,0,0,1,2,2,15,17,fall
2011-08-04,3,1,0,1,2,3,14,17,fall
2011-08-04,3,2,0,1,2,2,5,7,fall
2011-08-04,3,3,0,1,3,0,3,3,fall
2011-08-04,3,4,0,1,2,0,7,7,fall
2011-08-04,3,5,0,1,2,3,17,20,fall
2011-08-04,3,6,0,1,2,7,90,97,fall
2011-08-04,3,7,0,1,2,11,271,282,fall
2011-08-04,3,8,0,1,2,29,369,398,fall
2011-08-04,3,9,0,1,1,25,162,187,fall
2011-08-04,3,10,0,1,1,24,89,113,fall
2011-08-04,3,11,0,1,2,37,112,149,fall
2011-08-04,3,12,0,1,2,53,152,205,fall
2011-08-04,3,13,0,1,1,63,142,205,fall
2011-08-04,3,14,0,1,1,53,114,167,fall
2011-08-04,3,15,0,1,1,50,115,165,fall
2011-08-04,3,16,0,1,1,70,220,290,fall
2011-08-04,3,17,0,1,1,91,464,555,fall
2011-08-04,3,18,0,1,1,88,435,523,fall
2011-08-04,3,19,0,1,1,65,301,366,fall
2011-08-04,3,20,0,1,2,41,245,286,fall
2011-08-04,3,21,0,1,2,25,186,211,fall
2011-08-04,3,22,0,1,1,33,141,174,fall
2011-08-04,3,23,0,1,1,24,108,132,fall
2011-08-05,3,0,0,1,1,13,41,54,fall
2011-08-05,3,1,0,1,1,3,16,19,fall
2011-08-05,3,2,0,1,1,5,14,19,fall
2011-08-05,3,3,0,1,1,0,6,6,fall
2011-08-05,3,4,0,1,1,1,6,7,fall
2011-08-05,3,5,0,1,1,0,16,16,fall
2011-08-05,3,6,0,1,1,7,94,101,fall
2011-08-05,3,7,0,1,1,23,247,270,fall
2011-08-05,3,8,0,1,1,39,415,454,fall
2011-08-05,3,9,0,1,1,43,183,226,fall
2011-08-05,3,10,0,1,1,50,113,163,fall
2011-08-05,3,11,0,1,2,44,103,147,fall
2011-08-05,3,12,0,1,1,57,159,216,fall
2011-08-05,3,13,0,1,1,40,164,204,fall
2011-08-05,3,14,0,1,2,81,164,245,fall
2011-08-05,3,15,0,1,1,50,160,210,fall
2011-08-05,3,16,0,1,1,76,254,330,fall
2011-08-05,3,17,0,1,1,84,466,550,fall
2011-08-05,3,18,0,1,1,105,361,466,fall
2011-08-05,3,19,0,1,1,90,282,372,fall
2011-08-05,3,20,0,1,1,70,221,291,fall
2011-08-05,3,21,0,1,1,54,119,173,fall
2011-08-05,3,22,0,1,1,51,137,188,fall
2011-08-05,3,23,0,1,1,37,102,139,fall
2011-08-06,3,0,0,0,1,29,104,133,fall
2011-08-06,3,1,0,0,1,17,50,67,fall
2011-08-06,3,2,0,0,1,14,39,53,fall
2011-08-06,3,3,0,0,2,14,28,42,fall
2011-08-06,3,4,0,0,2,5,5,10,fall
2011-08-06,3,5,0,0,1,2,4,6,fall
2011-08-06,3,6,0,0,1,5,22,27,fall
2011-08-06,3,7,0,0,1,14,49,63,fall
2011-08-06,3,8,0,0,1,27,94,121,fall
2011-08-06,3,9,0,0,1,60,155,215,fall
2011-08-06,3,10,0,0,2,91,199,290,fall
2011-08-06,3,11,0,0,1,138,211,349,fall
2011-08-06,3,12,0,0,1,130,252,382,fall
2011-08-06,3,13,0,0,2,176,265,441,fall
2011-08-06,3,14,0,0,1,176,204,380,fall
2011-08-06,3,15,0,0,2,130,232,362,fall
2011-08-06,3,16,0,0,3,155,188,343,fall
2011-08-06,3,17,0,0,3,61,88,149,fall
2011-08-06,3,18,0,0,2,81,130,211,fall
2011-08-06,3,19,0,0,3,57,114,171,fall
2011-08-06,3,20,0,0,3,58,79,137,fall
2011-08-06,3,21,0,0,2,28,86,114,fall
2011-08-06,3,22,0,0,2,24,96,120,fall
2011-08-06,3,23,0,0,3,29,79,108,fall
2011-08-07,3,0,0,0,2,14,66,80,fall
2011-08-07,3,1,0,0,2,10,63,73,fall
2011-08-07,3,2,0,0,2,18,48,66,fall
2011-08-07,3,3,0,0,2,9,23,32,fall
2011-08-07,3,4,0,0,1,1,5,6,fall
2011-08-07,3,5,0,0,1,1,4,5,fall
2011-08-07,3,6,0,0,1,3,10,13,fall
2011-08-07,3,7,0,0,1,11,28,39,fall
2011-08-07,3,8,0,0,1,23,66,89,fall
2011-08-07,3,9,0,0,1,82,102,184,fall
2011-08-07,3,10,0,0,1,88,178,266,fall
2011-08-07,3,11,0,0,1,113,156,269,fall
2011-08-07,3,12,0,0,1,161,209,370,fall
2011-08-07,3,13,0,0,1,118,206,324,fall
2011-08-07,3,14,0,0,1,130,192,322,fall
2011-08-07,3,15,0,0,3,118,208,326,fall
2011-08-07,3,16,0,0,3,74,119,193,fall
2011-08-07,3,17,0,0,3,63,131,194,fall
2011-08-07,3,18,0,0,1,74,155,229,fall
2011-08-07,3,19,0,0,1,68,160,228,fall
2011-08-07,3,20,0,0,1,50,133,183,fall
2011-08-07,3,21,0,0,1,36,100,136,fall
2011-08-07,3,22,0,0,1,21,82,103,fall
2011-08-07,3,23,0,0,1,12,43,55,fall
2011-08-08,3,0,0,1,1,13,17,30,fall
2011-08-08,3,1,0,1,1,4,8,12,fall
2011-08-08,3,2,0,1,1,4,3,7,fall
2011-08-08,3,3,0,1,1,1,0,1,fall
2011-08-08,3,4,0,1,1,2,8,10,fall
2011-08-08,3,5,0,1,1,1,14,15,fall
2011-08-08,3,6,0,1,1,8,87,95,fall
2011-08-08,3,7,0,1,1,18,249,267,fall
2011-08-08,3,8,0,1,1,29,320,349,fall
2011-08-08,3,9,0,1,1,37,146,183,fall
2011-08-08,3,10,0,1,1,62,62,124,fall
2011-08-08,3,11,0,1,1,90,89,179,fall
2011-08-08,3,12,0,1,1,48,134,182,fall
2011-08-08,3,13,0,1,1,43,108,151,fall
2011-08-08,3,14,0,1,1,41,109,150,fall
2011-08-08,3,15,0,1,1,40,86,126,fall
2011-08-08,3,16,0,1,1,64,218,282,fall
2011-08-08,3,17,0,1,1,67,460,527,fall
2011-08-08,3,18,0,1,1,64,465,529,fall
2011-08-08,3,19,0,1,1,64,352,416,fall
2011-08-08,3,20,0,1,1,71,215,286,fall
2011-08-08,3,21,0,1,1,30,156,186,fall
2011-08-08,3,22,0,1,1,26,121,147,fall
2011-08-08,3,23,0,1,1,19,53,72,fall
2011-08-09,3,0,0,1,1,10,25,35,fall
2011-08-09,3,1,0,1,1,5,9,14,fall
2011-08-09,3,2,0,1,1,9,3,12,fall
2011-08-09,3,3,0,1,1,0,3,3,fall
2011-08-09,3,4,0,1,1,1,6,7,fall
2011-08-09,3,5,0,1,1,5,25,30,fall
2011-08-09,3,6,0,1,1,6,95,101,fall
2011-08-09,3,7,0,1,1,30,313,343,fall
2011-08-09,3,8,0,1,1,40,352,392,fall
2011-08-09,3,9,0,1,2,34,141,175,fall
2011-08-09,3,10,0,1,2,55,89,144,fall
2011-08-09,3,11,0,1,1,61,88,149,fall
2011-08-09,3,12,0,1,1,60,125,185,fall
2011-08-09,3,13,0,1,1,48,127,175,fall
2011-08-09,3,14,0,1,1,53,95,148,fall
2011-08-09,3,15,0,1,1,58,106,164,fall
2011-08-09,3,16,0,1,1,57,228,285,fall
2011-08-09,3,17,0,1,1,79,453,532,fall
2011-08-09,3,18,0,1,1,97,488,585,fall
2011-08-09,3,19,0,1,1,69,302,371,fall
2011-08-09,3,20,0,1,1,34,258,292,fall
2011-08-09,3,21,0,1,1,46,184,230,fall
2011-08-09,3,22,0,1,1,28,127,155,fall
2011-08-09,3,23,0,1,1,22,53,75,fall
2011-08-10,3,0,0,1,1,19,18,37,fall
2011-08-10,3,1,0,1,1,7,10,17,fall
2011-08-10,3,2,0,1,1,1,10,11,fall
2011-08-10,3,3,0,1,1,1,3,4,fall
2011-08-10,3,4,0,1,1,1,4,5,fall
2011-08-10,3,5,0,1,1,2,30,32,fall
2011-08-10,3,6,0,1,1,9,110,119,fall
2011-08-10,3,7,0,1,1,16,289,305,fall
2011-08-10,3,8,0,1,1,38,361,399,fall
2011-08-10,3,9,0,1,1,32,148,180,fall
2011-08-10,3,10,0,1,1,41,72,113,fall
2011-08-10,3,11,0,1,1,54,95,149,fall
2011-08-10,3,12,0,1,1,74,166,240,fall
2011-08-10,3,13,0,1,1,41,150,191,fall
2011-08-10,3,14,0,1,1,62,116,178,fall
2011-08-10,3,15,0,1,1,53,141,194,fall
2011-08-10,3,16,0,1,1,76,206,282,fall
2011-08-10,3,17,0,1,1,71,513,584,fall
2011-08-10,3,18,0,1,1,70,489,559,fall
2011-08-10,3,19,0,1,1,79,334,413,fall
2011-08-10,3,20,0,1,1,59,253,312,fall
2011-08-10,3,21,0,1,1,47,162,209,fall
2011-08-10,3,22,0,1,1,17,122,139,fall
2011-08-10,3,23,0,1,1,14,94,108,fall
2011-08-11,3,0,0,1,1,6,40,46,fall
2011-08-11,3,1,0,1,1,9,17,26,fall
2011-08-11,3,2,0,1,1,3,8,11,fall
2011-08-11,3,3,0,1,1,2,7,9,fall
2011-08-11,3,4,0,1,1,1,4,5,fall
2011-08-11,3,5,0,1,1,2,23,25,fall
2011-08-11,3,6,0,1,1,5,101,106,fall
2011-08-11,3,7,0,1,1,15,292,307,fall
2011-08-11,3,8,0,1,1,29,361,390,fall
2011-08-11,3,9,0,1,1,31,166,197,fall
2011-08-11,3,10,0,1,1,36,96,132,fall
2011-08-11,3,11,0,1,1,59,128,187,fall
2011-08-11,3,12,0,1,1,50,164,214,fall
2011-08-11,3,13,0,1,1,51,166,217,fall
2011-08-11,3,14,0,1,1,39,103,142,fall
2011-08-11,3,15,0,1,1,52,126,178,fall
2011-08-11,3,16,0,1,1,57,241,298,fall
2011-08-11,3,17,0,1,1,96,486,582,fall
2011-08-11,3,18,0,1,1,74,497,571,fall
2011-08-11,3,19,0,1,1,48,323,371,fall
2011-08-11,3,20,0,1,1,56,232,288,fall
2011-08-11,3,21,0,1,1,35,171,206,fall
2011-08-11,3,22,0,1,1,34,123,157,fall
2011-08-11,3,23,0,1,1,22,105,127,fall
2011-08-12,3,0,0,1,1,12,53,65,fall
2011-08-12,3,1,0,1,1,4,19,23,fall
2011-08-12,3,2,0,1,1,0,15,15,fall
2011-08-12,3,3,0,1,1,0,9,9,fall
2011-08-12,3,4,0,1,1,0,5,5,fall
2011-08-12,3,5,0,1,1,2,24,26,fall
2011-08-12,3,6,0,1,1,3,73,76,fall
2011-08-12,3,7,0,1,1,17,247,264,fall
2011-08-12,3,8,0,1,1,29,397,426,fall
2011-08-12,3,9,0,1,1,27,178,205,fall
2011-08-12,3,10,0,1,1,44,86,130,fall
2011-08-12,3,11,0,1,1,48,108,156,fall
2011-08-12,3,12,0,1,1,55,167,222,fall
2011-08-12,3,13,0,1,1,74,179,253,fall
2011-08-12,3,14,0,1,1,51,135,186,fall
2011-08-12,3,15,0,1,1,59,190,249,fall
2011-08-12,3,16,0,1,1,68,266,334,fall
2011-08-12,3,17,0,1,1,93,423,516,fall
2011-08-12,3,18,0,1,1,89,376,465,fall
2011-08-12,3,19,0,1,1,101,284,385,fall
2011-08-12,3,20,0,1,1,77,210,287,fall
2011-08-12,3,21,0,1,1,73,153,226,fall
2011-08-12,3,22,0,1,1,74,157,231,fall
2011-08-12,3,23,0,1,1,51,100,151,fall
2011-08-13,3,0,0,0,1,15,69,84,fall
2011-08-13,3,1,0,0,2,13,64,77,fall
2011-08-13,3,2,0,0,1,16,58,74,fall
2011-08-13,3,3,0,0,1,9,18,27,fall
2011-08-13,3,4,0,0,2,5,5,10,fall
2011-08-13,3,5,0,0,1,3,15,18,fall
2011-08-13,3,6,0,0,1,3,19,22,fall
2011-08-13,3,7,0,0,2,10,34,44,fall
2011-08-13,3,8,0,0,2,28,90,118,fall
2011-08-13,3,9,0,0,2,70,138,208,fall
2011-08-13,3,10,0,0,2,97,163,260,fall
2011-08-13,3,11,0,0,2,122,192,314,fall
2011-08-13,3,12,0,0,2,175,246,421,fall
2011-08-13,3,13,0,0,2,61,92,153,fall
2011-08-13,3,14,0,0,1,113,146,259,fall
2011-08-13,3,15,0,0,3,150,208,358,fall
2011-08-13,3,16,0,0,2,148,133,281,fall
2011-08-13,3,17,0,0,2,97,172,269,fall
2011-08-13,3,18,0,0,1,123,169,292,fall
2011-08-13,3,19,0,0,2,67,170,237,fall
2011-08-13,3,20,0,0,2,78,105,183,fall
2011-08-13,3,21,0,0,2,40,127,167,fall
2011-08-13,3,22,0,0,2,36,118,154,fall
2011-08-13,3,23,0,0,2,25,95,120,fall
2011-08-14,3,0,0,0,3,19,71,90,fall
2011-08-14,3,1,0,0,3,16,57,73,fall
2011-08-14,3,2,0,0,3,13,49,62,fall
2011-08-14,3,3,0,0,2,5,22,27,fall
2011-08-14,3,4,0,0,3,1,2,3,fall
2011-08-14,3,5,0,0,2,1,9,10,fall
2011-08-14,3,6,0,0,2,2,4,6,fall
2011-08-14,3,7,0,0,2,4,20,24,fall
2011-08-14,3,8,0,0,2,20,21,41,fall
2011-08-14,3,9,0,0,3,27,76,103,fall
2011-08-14,3,10,0,0,1,67,116,183,fall
2011-08-14,3,11,0,0,1,81,117,198,fall
2011-08-14,3,12,0,0,2,98,183,281,fall
2011-08-14,3,13,0,0,1,144,233,377,fall
2011-08-14,3,14,0,0,1,126,244,370,fall
2011-08-14,3,15,0,0,1,128,203,331,fall
2011-08-14,3,16,0,0,1,116,176,292,fall
2011-08-14,3,17,0,0,1,133,196,329,fall
2011-08-14,3,18,0,0,1,125,222,347,fall
2011-08-14,3,19,0,0,1,75,184,259,fall
2011-08-14,3,20,0,0,1,67,126,193,fall
2011-08-14,3,21,0,0,3,51,104,155,fall
2011-08-14,3,22,0,0,3,14,25,39,fall
2011-08-14,3,23,0,0,3,5,22,27,fall
2011-08-15,3,0,0,1,3,7,18,25,fall
2011-08-15,3,1,0,1,2,1,9,10,fall
2011-08-15,3,2,0,1,2,0,3,3,fall
2011-08-15,3,3,0,1,1,1,6,7,fall
2011-08-15,3,4,0,1,1,1,4,5,fall
2011-08-15,3,5,0,1,2,3,14,17,fall
2011-08-15,3,6,0,1,1,3,87,90,fall
2011-08-15,3,7,0,1,1,10,248,258,fall
2011-08-15,3,8,0,1,1,29,326,355,fall
2011-08-15,3,9,0,1,1,52,170,222,fall
2011-08-15,3,10,0,1,1,54,87,141,fall
2011-08-15,3,11,0,1,2,41,112,153,fall
2011-08-15,3,12,0,1,1,62,116,178,fall
2011-08-15,3,13,0,1,1,53,140,193,fall
2011-08-15,3,14,0,1,1,56,95,151,fall
2011-08-15,3,15,0,1,3,49,133,182,fall
2011-08-15,3,16,0,1,1,58,225,283,fall
2011-08-15,3,17,0,1,1,59,471,530,fall
2011-08-15,3,18,0,1,1,70,413,483,fall
2011-08-15,3,19,0,1,1,54,343,397,fall
2011-08-15,3,20,0,1,1,45,240,285,fall
2011-08-15,3,21,0,1,1,34,150,184,fall
2011-08-15,3,22,0,1,1,22,76,98,fall
2011-08-15,3,23,0,1,1,11,77,88,fall
2011-08-16,3,0,0,1,1,8,23,31,fall
2011-08-16,3,1,0,1,1,4,12,16,fall
2011-08-16,3,2,0,1,1,1,3,4,fall
2011-08-16,3,3,0,1,1,1,5,6,fall
2011-08-16,3,4,0,1,1,0,5,5,fall
2011-08-16,3,5,0,1,1,1,29,30,fall
2011-08-16,3,6,0,1,1,4,115,119,fall
2011-08-16,3,7,0,1,1,18,328,346,fall
2011-08-16,3,8,0,1,1,24,417,441,fall
2011-08-16,3,9,0,1,1,27,171,198,fall
2011-08-16,3,10,0,1,1,28,83,111,fall
2011-08-16,3,11,0,1,1,40,110,150,fall
2011-08-16,3,12,0,1,1,42,120,162,fall
2011-08-16,3,13,0,1,1,45,147,192,fall
2011-08-16,3,14,0,1,1,65,117,182,fall
2011-08-16,3,15,0,1,1,36,123,159,fall
2011-08-16,3,16,0,1,1,55,248,303,fall
2011-08-16,3,17,0,1,1,75,525,600,fall
2011-08-16,3,18,0,1,1,54,516,570,fall
2011-08-16,3,19,0,1,1,56,320,376,fall
2011-08-16,3,20,0,1,1,48,232,280,fall
2011-08-16,3,21,0,1,1,38,177,215,fall
2011-08-16,3,22,0,1,1,31,121,152,fall
2011-08-16,3,23,0,1,1,20,57,77,fall
2011-08-17,3,0,0,1,1,8,16,24,fall
2011-08-17,3,1,0,1,1,2,12,14,fall
2011-08-17,3,2,0,1,1,0,6,6,fall
2011-08-17,3,3,0,1,1,1,4,5,fall
2011-08-17,3,4,0,1,1,0,5,5,fall
2011-08-17,3,5,0,1,1,0,28,28,fall
2011-08-17,3,6,0,1,1,4,101,105,fall
2011-08-17,3,7,0,1,1,12,296,308,fall
2011-08-17,3,8,0,1,1,35,452,487,fall
2011-08-17,3,9,0,1,1,31,178,209,fall
2011-08-17,3,10,0,1,1,27,91,118,fall
2011-08-17,3,11,0,1,1,20,108,128,fall
2011-08-17,3,12,0,1,1,26,163,189,fall
2011-08-17,3,13,0,1,1,38,138,176,fall
2011-08-17,3,14,0,1,1,54,138,192,fall
2011-08-17,3,15,0,1,1,42,117,159,fall
2011-08-17,3,16,0,1,1,62,238,300,fall
2011-08-17,3,17,0,1,1,46,506,552,fall
2011-08-17,3,18,0,1,1,86,470,556,fall
2011-08-17,3,19,0,1,1,50,297,347,fall
2011-08-17,3,20,0,1,1,37,243,280,fall
2011-08-17,3,21,0,1,1,38,192,230,fall
2011-08-17,3,22,0,1,1,29,142,171,fall
2011-08-17,3,23,0,1,1,20,85,105,fall
2011-08-18,3,0,0,1,1,18,38,56,fall
2011-08-18,3,1,0,1,2,13,11,24,fall
2011-08-18,3,2,0,1,1,2,4,6,fall
2011-08-18,3,3,0,1,1,0,6,6,fall
2011-08-18,3,4,0,1,1,0,9,9,fall
2011-08-18,3,5,0,1,1,0,27,27,fall
2011-08-18,3,6,0,1,2,6,97,103,fall
2011-08-18,3,7,0,1,1,19,289,308,fall
2011-08-18,3,8,0,1,1,27,393,420,fall
2011-08-18,3,9,0,1,1,42,186,228,fall
2011-08-18,3,10,0,1,1,37,92,129,fall
2011-08-18,3,11,0,1,1,44,97,141,fall
2011-08-18,3,12,0,1,1,34,139,173,fall
2011-08-18,3,13,0,1,1,33,154,187,fall
2011-08-18,3,14,0,1,1,67,115,182,fall
2011-08-18,3,15,0,1,1,56,118,174,fall
2011-08-18,3,16,0,1,1,49,196,245,fall
2011-08-18,3,17,0,1,3,44,365,409,fall
2011-08-18,3,18,0,1,3,48,226,274,fall
2011-08-18,3,19,0,1,1,26,115,141,fall
2011-08-18,3,20,0,1,1,24,141,165,fall
2011-08-18,3,21,0,1,2,12,137,149,fall
2011-08-18,3,22,0,1,2,18,117,135,fall
2011-08-18,3,23,0,1,2,20,94,114,fall
2011-08-19,3,0,0,1,3,9,53,62,fall
2011-08-19,3,1,0,1,3,1,19,20,fall
2011-08-19,3,2,0,1,3,0,8,8,fall
2011-08-19,3,3,0,1,1,2,1,3,fall
2011-08-19,3,4,0,1,1,1,7,8,fall
2011-08-19,3,5,0,1,1,1,16,17,fall
2011-08-19,3,6,0,1,1,2,91,93,fall
2011-08-19,3,7,0,1,2,12,251,263,fall
2011-08-19,3,8,0,1,2,30,368,398,fall
2011-08-19,3,9,0,1,1,31,187,218,fall
2011-08-19,3,10,0,1,1,57,108,165,fall
2011-08-19,3,11,0,1,2,45,120,165,fall
2011-08-19,3,12,0,1,2,54,168,222,fall
2011-08-19,3,13,0,1,2,63,169,232,fall
2011-08-19,3,14,0,1,1,78,142,220,fall
2011-08-19,3,15,0,1,1,66,156,222,fall
2011-08-19,3,16,0,1,1,66,261,327,fall
2011-08-19,3,17,0,1,1,85,442,527,fall
2011-08-19,3,18,0,1,1,88,337,425,fall
2011-08-19,3,19,0,1,3,33,132,165,fall
2011-08-19,3,20,0,1,3,12,46,58,fall
2011-08-19,3,21,0,1,1,18,89,107,fall
2011-08-19,3,22,0,1,1,25,97,122,fall
2011-08-19,3,23,0,1,2,18,88,106,fall
2011-08-20,3,0,0,0,1,21,107,128,fall
2011-08-20,3,1,0,0,1,12,35,47,fall
2011-08-20,3,2,0,0,1,10,59,69,fall
2011-08-20,3,3,0,0,1,9,42,51,fall
2011-08-20,3,4,0,0,2,1,6,7,fall
2011-08-20,3,5,0,0,1,0,8,8,fall
2011-08-20,3,6,0,0,2,6,18,24,fall
2011-08-20,3,7,0,0,1,8,36,44,fall
2011-08-20,3,8,0,0,1,27,106,133,fall
2011-08-20,3,9,0,0,1,51,139,190,fall
2011-08-20,3,10,0,0,1,114,192,306,fall
2011-08-20,3,11,0,0,1,115,223,338,fall
2011-08-20,3,12,0,0,1,156,253,409,fall
2011-08-20,3,13,0,0,1,158,220,378,fall
2011-08-20,3,14,0,0,1,147,228,375,fall
2011-08-20,3,15,0,0,1,175,215,390,fall
2011-08-20,3,16,0,0,1,151,222,373,fall
2011-08-20,3,17,0,0,1,180,203,383,fall
2011-08-20,3,18,0,0,1,169,225,394,fall
2011-08-20,3,19,0,0,1,109,182,291,fall
2011-08-20,3,20,0,0,1,78,170,248,fall
2011-08-20,3,21,0,0,1,81,144,225,fall
2011-08-20,3,22,0,0,2,77,146,223,fall
2011-08-20,3,23,0,0,1,59,98,157,fall
2011-08-21,3,0,0,0,1,6,68,74,fall
2011-08-21,3,1,0,0,1,17,69,86,fall
2011-08-21,3,2,0,0,1,13,51,64,fall
2011-08-21,3,3,0,0,1,25,26,51,fall
2011-08-21,3,4,0,0,1,1,5,6,fall
2011-08-21,3,5,0,0,1,0,8,8,fall
2011-08-21,3,6,0,0,1,4,10,14,fall
2011-08-21,3,7,0,0,1,12,19,31,fall
2011-08-21,3,8,0,0,1,30,62,92,fall
2011-08-21,3,9,0,0,1,80,151,231,fall
2011-08-21,3,10,0,0,1,97,177,274,fall
2011-08-21,3,11,0,0,1,132,181,313,fall
2011-08-21,3,12,0,0,1,135,239,374,fall
2011-08-21,3,13,0,0,1,94,216,310,fall
2011-08-21,3,14,0,0,3,78,157,235,fall
2011-08-21,3,15,0,0,1,17,51,68,fall
2011-08-21,3,16,0,0,1,97,161,258,fall
2011-08-21,3,17,0,0,1,91,179,270,fall
2011-08-21,3,18,0,0,1,96,215,311,fall
2011-08-21,3,19,0,0,1,81,201,282,fall
2011-08-21,3,20,0,0,1,41,140,181,fall
2011-08-21,3,21,0,0,1,45,93,138,fall
2011-08-21,3,22,0,0,2,37,97,134,fall
2011-08-21,3,23,0,0,1,20,48,68,fall
2011-08-22,3,0,0,1,1,18,22,40,fall
2011-08-22,3,1,0,1,1,8,13,21,fall
2011-08-22,3,2,0,1,2,2,6,8,fall
2011-08-22,3,3,0,1,3,0,5,5,fall
2011-08-22,3,4,0,1,1,2,10,12,fall
2011-08-22,3,5,0,1,1,1,23,24,fall
2011-08-22,3,6,0,1,1,6,106,112,fall
2011-08-22,3,7,0,1,1,11,270,281,fall
2011-08-22,3,8,0,1,1,20,331,351,fall
2011-08-22,3,9,0,1,1,36,151,187,fall
2011-08-22,3,10,0,1,1,36,85,121,fall
2011-08-22,3,11,0,1,1,46,85,131,fall
2011-08-22,3,12,0,1,1,54,153,207,fall
2011-08-22,3,13,0,1,1,47,158,205,fall
2011-08-22,3,14,0,1,1,88,137,225,fall
2011-08-22,3,15,0,1,1,72,127,199,fall
2011-08-22,3,16,0,1,1,66,254,320,fall
2011-08-22,3,17,0,1,1,82,509,591,fall
2011-08-22,3,18,0,1,1,72,537,609,fall
2011-08-22,3,19,0,1,1,66,350,416,fall
2011-08-22,3,20,0,1,1,21,247,268,fall
2011-08-22,3,21,0,1,1,28,180,208,fall
2011-08-22,3,22,0,1,1,32,121,153,fall
2011-08-22,3,23,0,1,1,19,45,64,fall
2011-08-23,3,0,0,1,1,13,22,35,fall
2011-08-23,3,1,0,1,1,6,13,19,fall
2011-08-23,3,2,0,1,1,2,4,6,fall
2011-08-23,3,3,0,1,1,2,4,6,fall
2011-08-23,3,4,0,1,1,0,5,5,fall
2011-08-23,3,5,0,1,1,1,35,36,fall
2011-08-23,3,6,0,1,1,3,111,114,fall
2011-08-23,3,7,0,1,1,11,333,344,fall
2011-08-23,3,8,0,1,2,43,461,504,fall
2011-08-23,3,9,0,1,2,34,191,225,fall
2011-08-23,3,10,0,1,1,56,92,148,fall
2011-08-23,3,11,0,1,1,62,124,186,fall
2011-08-23,3,12,0,1,1,60,177,237,fall
2011-08-23,3,13,0,1,1,70,164,234,fall
2011-08-23,3,14,0,1,1,149,502,651,fall
2011-08-23,3,15,0,1,1,178,423,601,fall
2011-08-23,3,16,0,1,1,133,311,444,fall
2011-08-23,3,17,0,1,1,133,339,472,fall
2011-08-23,3,18,0,1,1,98,421,519,fall
2011-08-23,3,19,0,1,1,70,297,367,fall
2011-08-23,3,20,0,1,1,54,206,260,fall
2011-08-23,3,21,0,1,1,38,173,211,fall
2011-08-23,3,22,0,1,1,46,145,191,fall
2011-08-23,3,23,0,1,1,19,61,80,fall
2011-08-24,3,0,0,1,1,9,29,38,fall
2011-08-24,3,1,0,1,1,7,17,24,fall
2011-08-24,3,2,0,1,1,2,4,6,fall
2011-08-24,3,3,0,1,1,0,1,1,fall
2011-08-24,3,4,0,1,1,0,7,7,fall
2011-08-24,3,5,0,1,1,1,26,27,fall
2011-08-24,3,6,0,1,1,3,105,108,fall
2011-08-24,3,7,0,1,1,11,297,308,fall
2011-08-24,3,8,0,1,1,32,436,468,fall
2011-08-24,3,9,0,1,1,44,169,213,fall
2011-08-24,3,10,0,1,1,51,95,146,fall
2011-08-24,3,11,0,1,1,57,128,185,fall
2011-08-24,3,12,0,1,1,60,175,235,fall
2011-08-24,3,13,0,1,1,56,180,236,fall
2011-08-24,3,14,0,1,1,77,127,204,fall
2011-08-24,3,15,0,1,1,63,141,204,fall
2011-08-24,3,16,0,1,1,49,222,271,fall
2011-08-24,3,17,0,1,1,83,484,567,fall
2011-08-24,3,18,0,1,1,102,519,621,fall
2011-08-24,3,19,0,1,1,93,347,440,fall
2011-08-24,3,20,0,1,1,45,289,334,fall
2011-08-24,3,21,0,1,1,47,189,236,fall
2011-08-24,3,22,0,1,1,41,140,181,fall
2011-08-24,3,23,0,1,1,16,54,70,fall
2011-08-25,3,0,0,1,1,11,41,52,fall
2011-08-25,3,1,0,1,1,4,11,15,fall
2011-08-25,3,2,0,1,1,3,2,5,fall
2011-08-25,3,3,0,1,1,2,2,4,fall
2011-08-25,3,4,0,1,1,1,6,7,fall
2011-08-25,3,5,0,1,1,1,25,26,fall
2011-08-25,3,6,0,1,1,1,101,102,fall
2011-08-25,3,7,0,1,2,17,296,313,fall
2011-08-25,3,8,0,1,2,23,461,484,fall
2011-08-25,3,9,0,1,2,21,141,162,fall
2011-08-25,3,10,0,1,2,37,105,142,fall
2011-08-25,3,11,0,1,3,39,112,151,fall
2011-08-25,3,12,0,1,3,9,32,41,fall
2011-08-25,3,13,0,1,1,7,30,37,fall
2011-08-25,3,14,0,1,2,27,86,113,fall
2011-08-25,3,15,0,1,2,28,104,132,fall
2011-08-25,3,16,0,1,1,16,105,121,fall
2011-08-25,3,17,0,1,1,28,284,312,fall
2011-08-25,3,18,0,1,2,31,377,408,fall
2011-08-25,3,19,0,1,2,31,241,272,fall
2011-08-25,3,20,0,1,1,33,192,225,fall
2011-08-25,3,21,0,1,1,29,158,187,fall
2011-08-25,3,22,0,1,1,21,126,147,fall
2011-08-25,3,23,0,1,1,15,69,84,fall
2011-08-26,3,0,0,1,1,9,42,51,fall
2011-08-26,3,1,0,1,1,10,13,23,fall
2011-08-26,3,2,0,1,1,4,16,20,fall
2011-08-26,3,3,0,1,1,3,8,11,fall
2011-08-26,3,4,0,1,1,2,6,8,fall
2011-08-26,3,5,0,1,2,3,23,26,fall
2011-08-26,3,6,0,1,1,5,100,105,fall
2011-08-26,3,7,0,1,1,3,263,266,fall
2011-08-26,3,8,0,1,1,17,387,404,fall
2011-08-26,3,9,0,1,1,39,191,230,fall
2011-08-26,3,10,0,1,1,34,89,123,fall
2011-08-26,3,11,0,1,2,63,151,214,fall
2011-08-26,3,12,0,1,2,70,173,243,fall
2011-08-26,3,13,0,1,2,72,165,237,fall
2011-08-26,3,14,0,1,1,55,164,219,fall
2011-08-26,3,15,0,1,2,53,196,249,fall
2011-08-26,3,16,0,1,1,50,293,343,fall
2011-08-26,3,17,0,1,1,56,433,489,fall
2011-08-26,3,18,0,1,2,40,370,410,fall
2011-08-26,3,19,0,1,1,55,235,290,fall
2011-08-26,3,20,0,1,1,39,183,222,fall
2011-08-26,3,21,0,1,1,38,152,190,fall
2011-08-26,3,22,0,1,1,26,126,152,fall
2011-08-26,3,23,0,1,1,22,114,136,fall
2011-08-27,3,0,0,0,1,33,112,145,fall
2011-08-27,3,1,0,0,1,13,51,64,fall
2011-08-27,3,2,0,0,1,18,59,77,fall
2011-08-27,3,3,0,0,2,8,22,30,fall
2011-08-27,3,4,0,0,2,1,3,4,fall
2011-08-27,3,5,0,0,2,1,11,12,fall
2011-08-27,3,6,0,0,2,3,15,18,fall
2011-08-27,3,7,0,0,2,2,26,28,fall
2011-08-27,3,8,0,0,2,14,62,76,fall
2011-08-27,3,9,0,0,2,28,128,156,fall
2011-08-27,3,10,0,0,2,51,154,205,fall
2011-08-27,3,11,0,0,3,15,73,88,fall
2011-08-27,3,12,0,0,3,11,65,76,fall
2011-08-27,3,13,0,0,3,10,33,43,fall
2011-08-27,3,14,0,0,3,4,19,23,fall
2011-08-27,3,15,0,0,3,2,28,30,fall
2011-08-27,3,16,0,0,3,10,14,24,fall
2011-08-27,3,17,0,0,3,2,14,16,fall
2011-08-28,3,7,0,0,3,0,1,1,fall
2011-08-28,3,8,0,0,3,2,6,8,fall
2011-08-28,3,9,0,0,1,7,46,53,fall
2011-08-28,3,10,0,0,1,27,115,142,fall
2011-08-28,3,11,0,0,1,59,178,237,fall
2011-08-28,3,12,0,0,1,88,218,306,fall
2011-08-28,3,13,0,0,1,129,302,431,fall
2011-08-28,3,14,0,0,1,157,290,447,fall
2011-08-28,3,15,0,0,1,155,314,469,fall
2011-08-28,3,16,0,0,1,196,295,491,fall
2011-08-28,3,17,0,0,1,145,253,398,fall
2011-08-28,3,18,0,0,1,145,257,402,fall
2011-08-28,3,19,0,0,1,140,247,387,fall
2011-08-28,3,20,0,0,1,64,150,214,fall
2011-08-28,3,21,0,0,1,60,126,186,fall
2011-08-28,3,22,0,0,1,25,73,98,fall
2011-08-28,3,23,0,0,1,16,48,64,fall
2011-08-29,3,0,0,1,1,13,21,34,fall
2011-08-29,3,1,0,1,1,5,15,20,fall
2011-08-29,3,2,0,1,1,8,5,13,fall
2011-08-29,3,3,0,1,1,1,5,6,fall
2011-08-29,3,4,0,1,1,0,3,3,fall
2011-08-29,3,5,0,1,1,0,17,17,fall
2011-08-29,3,6,0,1,1,3,99,102,fall
2011-08-29,3,7,0,1,1,11,273,284,fall
2011-08-29,3,8,0,1,1,20,384,404,fall
2011-08-29,3,9,0,1,1,22,166,188,fall
2011-08-29,3,10,0,1,1,42,73,115,fall
2011-08-29,3,11,0,1,1,38,100,138,fall
2011-08-29,3,12,0,1,2,48,159,207,fall
2011-08-29,3,13,0,1,2,48,170,218,fall
2011-08-29,3,14,0,1,1,55,127,182,fall
2011-08-29,3,15,0,1,1,56,164,220,fall
2011-08-29,3,16,0,1,1,56,226,282,fall
2011-08-29,3,17,0,1,2,67,524,591,fall
2011-08-29,3,18,0,1,1,60,487,547,fall
2011-08-29,3,19,0,1,1,50,317,367,fall
2011-08-29,3,20,0,1,1,50,227,277,fall
2011-08-29,3,21,0,1,1,34,168,202,fall
2011-08-29,3,22,0,1,1,23,119,142,fall
2011-08-29,3,23,0,1,1,19,56,75,fall
2011-08-30,3,0,0,1,1,10,17,27,fall
2011-08-30,3,1,0,1,1,6,7,13,fall
2011-08-30,3,2,0,1,1,2,8,10,fall
2011-08-30,3,3,0,1,1,2,2,4,fall
2011-08-30,3,4,0,1,1,0,6,6,fall
2011-08-30,3,5,0,1,1,1,27,28,fall
2011-08-30,3,6,0,1,1,4,115,119,fall
2011-08-30,3,7,0,1,1,19,338,357,fall
2011-08-30,3,8,0,1,1,34,459,493,fall
2011-08-30,3,9,0,1,1,38,180,218,fall
2011-08-30,3,10,0,1,1,28,109,137,fall
2011-08-30,3,11,0,1,1,60,115,175,fall
2011-08-30,3,12,0,1,1,65,172,237,fall
2011-08-30,3,13,0,1,1,59,170,229,fall
2011-08-30,3,14,0,1,1,58,151,209,fall
2011-08-30,3,15,0,1,1,34,162,196,fall
2011-08-30,3,16,0,1,1,42,295,337,fall
2011-08-30,3,17,0,1,1,62,549,611,fall
2011-08-30,3,18,0,1,1,60,516,576,fall
2011-08-30,3,19,0,1,1,68,397,465,fall
2011-08-30,3,20,0,1,1,39,259,298,fall
2011-08-30,3,21,0,1,1,43,180,223,fall
2011-08-30,3,22,0,1,1,22,121,143,fall
2011-08-30,3,23,0,1,1,19,74,93,fall
2011-08-31,3,0,0,1,1,8,24,32,fall
2011-08-31,3,1,0,1,1,2,13,15,fall
2011-08-31,3,2,0,1,1,1,5,6,fall
2011-08-31,3,3,0,1,1,2,4,6,fall
2011-08-31,3,4,0,1,1,0,5,5,fall
2011-08-31,3,5,0,1,1,2,25,27,fall
2011-08-31,3,6,0,1,1,4,107,111,fall
2011-08-31,3,7,0,1,1,12,316,328,fall
2011-08-31,3,8,0,1,1,27,440,467,fall
2011-08-31,3,9,0,1,1,27,217,244,fall
2011-08-31,3,10,0,1,1,33,105,138,fall
2011-08-31,3,11,0,1,1,28,143,171,fall
2011-08-31,3,12,0,1,1,68,192,260,fall
2011-08-31,3,13,0,1,1,39,182,221,fall
2011-08-31,3,14,0,1,1,48,148,196,fall
2011-08-31,3,15,0,1,1,34,138,172,fall
2011-08-31,3,16,0,1,1,46,263,309,fall
2011-08-31,3,17,0,1,1,83,525,608,fall
2011-08-31,3,18,0,1,1,70,495,565,fall
2011-08-31,3,19,0,1,1,53,393,446,fall
2011-08-31,3,20,0,1,1,30,259,289,fall
2011-08-31,3,21,0,1,1,27,174,201,fall
2011-08-31,3,22,0,1,1,20,137,157,fall
2011-08-31,3,23,0,1,1,24,60,84,fall
2011-09-01,3,0,0,1,1,18,33,51,fall
2011-09-01,3,1,0,1,1,7,14,21,fall
2011-09-01,3,2,0,1,1,14,11,25,fall
2011-09-01,3,3,0,1,1,7,7,14,fall
2011-09-01,3,4,0,1,1,0,7,7,fall
2011-09-01,3,5,0,1,1,1,22,23,fall
2011-09-01,3,6,0,1,1,2,103,105,fall
2011-09-01,3,7,0,1,1,7,335,342,fall
2011-09-01,3,8,0,1,1,31,467,498,fall
2011-09-01,3,9,0,1,1,29,178,207,fall
2011-09-01,3,10,0,1,1,46,92,138,fall
2011-09-01,3,11,0,1,1,51,141,192,fall
2011-09-01,3,12,0,1,2,64,165,229,fall
2011-09-01,3,13,0,1,2,50,169,219,fall
2011-09-01,3,14,0,1,3,54,144,198,fall
2011-09-01,3,15,0,1,1,39,135,174,fall
2011-09-01,3,16,0,1,1,55,253,308,fall
2011-09-01,3,17,0,1,1,61,567,628,fall
2011-09-01,3,18,0,1,1,69,462,531,fall
2011-09-01,3,19,0,1,1,79,364,443,fall
2011-09-01,3,20,0,1,1,33,247,280,fall
2011-09-01,3,21,0,1,2,17,160,177,fall
2011-09-01,3,22,0,1,2,34,145,179,fall
2011-09-01,3,23,0,1,1,15,111,126,fall
2011-09-02,3,0,0,1,1,6,58,64,fall
2011-09-02,3,1,0,1,3,4,28,32,fall
2011-09-02,3,2,0,1,3,9,11,20,fall
2011-09-02,3,3,0,1,2,4,4,8,fall
2011-09-02,3,4,0,1,1,2,2,4,fall
2011-09-02,3,5,0,1,2,0,20,20,fall
2011-09-02,3,6,0,1,1,3,73,76,fall
2011-09-02,3,7,0,1,1,6,253,259,fall
2011-09-02,3,8,0,1,1,22,434,456,fall
2011-09-02,3,9,0,1,2,30,190,220,fall
2011-09-02,3,10,0,1,2,34,106,140,fall
2011-09-02,3,11,0,1,2,51,141,192,fall
2011-09-02,3,12,0,1,2,82,178,260,fall
2011-09-02,3,13,0,1,2,72,207,279,fall
2011-09-02,3,14,0,1,2,75,208,283,fall
2011-09-02,3,15,0,1,2,69,277,346,fall
2011-09-02,3,16,0,1,2,82,299,381,fall
2011-09-02,3,17,0,1,2,78,377,455,fall
2011-09-02,3,18,0,1,2,50,305,355,fall
2011-09-02,3,19,0,1,1,67,220,287,fall
2011-09-02,3,20,0,1,1,38,158,196,fall
2011-09-02,3,21,0,1,2,28,121,149,fall
2011-09-02,3,22,0,1,2,33,114,147,fall
2011-09-02,3,23,0,1,2,30,68,98,fall
2011-09-03,3,0,0,0,2,22,65,87,fall
2011-09-03,3,1,0,0,2,17,57,74,fall
2011-09-03,3,2,0,0,2,15,26,41,fall
2011-09-03,3,3,0,0,1,17,18,35,fall
2011-09-03,3,4,0,0,1,3,4,7,fall
2011-09-03,3,5,0,0,1,3,9,12,fall
2011-09-03,3,6,0,0,1,4,19,23,fall
2011-09-03,3,7,0,0,1,5,33,38,fall
2011-09-03,3,8,0,0,1,24,65,89,fall
2011-09-03,3,9,0,0,2,83,118,201,fall
2011-09-03,3,10,0,0,3,90,168,258,fall
2011-09-03,3,11,0,0,3,66,128,194,fall
2011-09-03,3,12,0,0,1,97,160,257,fall
2011-09-03,3,13,0,0,1,153,200,353,fall
2011-09-03,3,14,0,0,2,204,176,380,fall
2011-09-03,3,15,0,0,1,187,201,388,fall
2011-09-03,3,16,0,0,1,186,188,374,fall
2011-09-03,3,17,0,0,1,170,201,371,fall
2011-09-03,3,18,0,0,1,160,179,339,fall
2011-09-03,3,19,0,0,1,147,148,295,fall
2011-09-03,3,20,0,0,1,99,120,219,fall
2011-09-03,3,21,0,0,1,71,93,164,fall
2011-09-03,3,22,0,0,1,66,96,162,fall
2011-09-03,3,23,0,0,1,46,77,123,fall
2011-09-04,3,0,0,0,1,33,76,109,fall
2011-09-04,3,1,0,0,1,37,38,75,fall
2011-09-04,3,2,0,0,1,17,43,60,fall
2011-09-04,3,3,0,0,1,20,23,43,fall
2011-09-04,3,4,0,0,1,0,4,4,fall
2011-09-04,3,5,0,0,1,1,5,6,fall
2011-09-04,3,6,0,0,1,0,3,3,fall
2011-09-04,3,7,0,0,1,10,20,30,fall
2011-09-04,3,8,0,0,1,21,49,70,fall
2011-09-04,3,9,0,0,1,87,102,189,fall
2011-09-04,3,10,0,0,1,150,147,297,fall
2011-09-04,3,11,0,0,1,174,163,337,fall
2011-09-04,3,12,0,0,1,214,221,435,fall
2011-09-04,3,13,0,0,2,245,174,419,fall
2011-09-04,3,14,0,0,1,205,156,361,fall
2011-09-04,3,15,0,0,1,218,192,410,fall
2011-09-04,3,16,0,0,1,196,141,337,fall
2011-09-04,3,17,0,0,1,204,172,376,fall
2011-09-04,3,18,0,0,1,187,169,356,fall
2011-09-04,3,19,0,0,1,178,150,328,fall
2011-09-04,3,20,0,0,1,104,125,229,fall
2011-09-04,3,21,0,0,1,104,103,207,fall
2011-09-04,3,22,0,0,2,70,85,155,fall
2011-09-04,3,23,0,0,2,46,58,104,fall
2011-09-05,3,0,1,0,2,31,66,97,fall
2011-09-05,3,1,1,0,2,19,35,54,fall
2011-09-05,3,2,1,0,2,17,22,39,fall
2011-09-05,3,3,1,0,2,4,12,16,fall
2011-09-05,3,4,1,0,2,3,5,8,fall
2011-09-05,3,5,1,0,2,2,4,6,fall
2011-09-05,3,6,1,0,2,6,5,11,fall
2011-09-05,3,7,1,0,1,11,30,41,fall
2011-09-05,3,8,1,0,2,45,56,101,fall
2011-09-05,3,9,1,0,3,63,89,152,fall
2011-09-05,3,10,1,0,2,107,137,244,fall
2011-09-05,3,11,1,0,2,101,207,308,fall
2011-09-05,3,12,1,0,2,141,212,353,fall
2011-09-05,3,13,1,0,2,154,235,389,fall
2011-09-05,3,14,1,0,1,145,212,357,fall
2011-09-05,3,15,1,0,2,111,142,253,fall
2011-09-05,3,16,1,0,2,92,192,284,fall
2011-09-05,3,17,1,0,2,37,77,114,fall
2011-09-05,3,18,1,0,1,31,92,123,fall
2011-09-05,3,19,1,0,3,52,123,175,fall
2011-09-05,3,20,1,0,3,26,56,82,fall
2011-09-05,3,21,1,0,2,20,40,60,fall
2011-09-05,3,22,1,0,2,15,49,64,fall
2011-09-05,3,23,1,0,3,3,17,20,fall
2011-09-06,3,0,0,1,3,1,7,8,fall
2011-09-06,3,2,0,1,3,0,2,2,fall
2011-09-06,3,3,0,1,3,1,0,1,fall
2011-09-06,3,4,0,1,2,1,3,4,fall
2011-09-06,3,5,0,1,3,1,20,21,fall
2011-09-06,3,6,0,1,2,0,72,72,fall
2011-09-06,3,7,0,1,2,6,166,172,fall
2011-09-06,3,8,0,1,3,15,349,364,fall
2011-09-06,3,9,0,1,2,18,167,185,fall
2011-09-06,3,10,0,1,3,16,90,106,fall
2011-09-06,3,11,0,1,3,11,78,89,fall
2011-09-06,3,12,0,1,3,16,51,67,fall
2011-09-06,3,13,0,1,3,5,24,29,fall
2011-09-06,3,14,0,1,3,3,21,24,fall
2011-09-06,3,15,0,1,3,18,71,89,fall
2011-09-06,3,16,0,1,3,11,95,106,fall
2011-09-06,3,17,0,1,2,15,276,291,fall
2011-09-06,3,18,0,1,2,22,351,373,fall
2011-09-06,3,19,0,1,2,12,269,281,fall
2011-09-06,3,20,0,1,3,13,150,163,fall
2011-09-06,3,21,0,1,3,12,109,121,fall
2011-09-06,3,22,0,1,2,5,79,84,fall
2011-09-06,3,23,0,1,3,2,56,58,fall
2011-09-07,3,0,0,1,2,1,12,13,fall
2011-09-07,3,1,0,1,3,2,3,5,fall
2011-09-07,3,2,0,1,2,2,4,6,fall
2011-09-07,3,3,0,1,3,1,1,2,fall
2011-09-07,3,4,0,1,3,0,4,4,fall
2011-09-07,3,5,0,1,2,1,15,16,fall
2011-09-07,3,6,0,1,3,1,74,75,fall
2011-09-07,3,7,0,1,3,3,83,86,fall
2011-09-07,3,8,0,1,3,9,319,328,fall
2011-09-07,3,9,0,1,3,14,176,190,fall
2011-09-07,3,10,0,1,3,3,63,66,fall
2011-09-07,3,11,0,1,3,1,9,10,fall
2011-09-07,3,12,0,1,3,1,21,22,fall
2011-09-07,3,13,0,1,3,2,9,11,fall
2011-09-07,3,14,0,1,3,1,24,25,fall
2011-09-07,3,15,0,1,3,3,55,58,fall
2011-09-07,3,16,0,1,1,7,137,144,fall
2011-09-07,3,17,0,1,3,21,264,285,fall
2011-09-07,3,18,0,1,3,18,219,237,fall
2011-09-07,3,19,0,1,2,14,212,226,fall
2011-09-07,3,20,0,1,3,3,93,96,fall
2011-09-07,3,21,0,1,3,4,34,38,fall
2011-09-07,3,22,0,1,3,3,26,29,fall
2011-09-07,3,23,0,1,3,3,21,24,fall
2011-09-08,3,0,0,1,3,3,11,14,fall
2011-09-08,3,1,0,1,3,0,4,4,fall
2011-09-08,3,3,0,1,3,0,2,2,fall
2011-09-08,3,4,0,1,2,0,3,3,fall
2011-09-08,3,5,0,1,3,1,13,14,fall
2011-09-08,3,6,0,1,3,1,55,56,fall
2011-09-08,3,7,0,1,3,7,172,179,fall
2011-09-08,3,8,0,1,3,7,188,195,fall
2011-09-08,3,9,0,1,2,4,65,69,fall
2011-09-08,3,10,0,1,2,8,57,65,fall
2011-09-08,3,11,0,1,2,16,82,98,fall
2011-09-08,3,12,0,1,2,17,85,102,fall
2011-09-08,3,13,0,1,2,14,112,126,fall
2011-09-08,3,14,0,1,2,15,105,120,fall
2011-09-08,3,15,0,1,3,24,115,139,fall
2011-09-08,3,16,0,1,3,5,151,156,fall
2011-09-08,3,17,0,1,3,11,102,113,fall
2011-09-08,3,18,0,1,3,2,66,68,fall
2011-09-08,3,19,0,1,3,1,51,52,fall
2011-09-08,3,20,0,1,2,6,83,89,fall
2011-09-08,3,21,0,1,3,6,76,82,fall
2011-09-08,3,22,0,1,3,5,65,70,fall
2011-09-08,3,23,0,1,3,0,26,26,fall
2011-09-09,3,0,0,1,3,1,15,16,fall
2011-09-09,3,1,0,1,2,0,8,8,fall
2011-09-09,3,2,0,1,2,1,7,8,fall
2011-09-09,3,3,0,1,2,1,1,2,fall
2011-09-09,3,4,0,1,3,0,3,3,fall
2011-09-09,3,5,0,1,2,0,14,14,fall
2011-09-09,3,6,0,1,2,3,54,57,fall
2011-09-09,3,7,0,1,3,4,104,108,fall
2011-09-09,3,8,0,1,3,12,276,288,fall
2011-09-09,3,9,0,1,3,5,131,136,fall
2011-09-09,3,10,0,1,2,2,27,29,fall
2011-09-09,3,11,0,1,2,6,66,72,fall
2011-09-09,3,12,0,1,1,4,71,75,fall
2011-09-09,3,13,0,1,1,14,108,122,fall
2011-09-09,3,14,0,1,1,29,119,148,fall
2011-09-09,3,15,0,1,1,27,161,188,fall
2011-09-09,3,16,0,1,1,41,244,285,fall
2011-09-09,3,17,0,1,1,54,451,505,fall
2011-09-09,3,18,0,1,1,33,377,410,fall
2011-09-09,3,19,0,1,1,33,316,349,fall
2011-09-09,3,20,0,1,1,30,180,210,fall
2011-09-09,3,21,0,1,1,49,154,203,fall
2011-09-09,3,22,0,1,1,33,127,160,fall
2011-09-09,3,23,0,1,1,35,113,148,fall
2011-09-10,3,0,0,0,1,32,84,116,fall
2011-09-10,3,1,0,0,2,16,67,83,fall
2011-09-10,3,2,0,0,2,18,46,64,fall
2011-09-10,3,3,0,0,1,8,29,37,fall
2011-09-10,3,4,0,0,1,3,4,7,fall
2011-09-10,3,5,0,0,1,2,6,8,fall
2011-09-10,3,6,0,0,1,0,6,6,fall
2011-09-10,3,7,0,0,1,9,43,52,fall
2011-09-10,3,8,0,0,1,16,103,119,fall
2011-09-10,3,9,0,0,1,39,168,207,fall
2011-09-10,3,10,0,0,1,85,233,318,fall
2011-09-10,3,11,0,0,1,108,252,360,fall
2011-09-10,3,12,0,0,1,144,260,404,fall
2011-09-10,3,13,0,0,1,131,239,370,fall
2011-09-10,3,14,0,0,1,129,230,359,fall
2011-09-10,3,15,0,0,1,217,263,480,fall
2011-09-10,3,16,0,0,1,170,261,431,fall
2011-09-10,3,17,0,0,1,185,275,460,fall
2011-09-10,3,18,0,0,1,119,241,360,fall
2011-09-10,3,19,0,0,1,101,214,315,fall
2011-09-10,3,20,0,0,1,78,167,245,fall
2011-09-10,3,21,0,0,1,59,171,230,fall
2011-09-10,3,22,0,0,1,49,126,175,fall
2011-09-10,3,23,0,0,2,32,107,139,fall
2011-09-11,3,0,0,0,1,29,79,108,fall
2011-09-11,3,1,0,0,2,22,66,88,fall
2011-09-11,3,2,0,0,2,16,60,76,fall
2011-09-11,3,3,0,0,2,15,30,45,fall
2011-09-11,3,4,0,0,1,3,6,9,fall
2011-09-11,3,5,0,0,1,15,24,39,fall
2011-09-11,3,6,0,0,1,4,16,20,fall
2011-09-11,3,7,0,0,1,9,28,37,fall
2011-09-11,3,8,0,0,1,25,69,94,fall
2011-09-11,3,9,0,0,1,59,168,227,fall
2011-09-11,3,10,0,0,1,120,214,334,fall
2011-09-11,3,11,0,0,1,144,258,402,fall
2011-09-11,3,12,0,0,1,113,298,411,fall
2011-09-11,3,13,0,0,1,119,231,350,fall
2011-09-11,3,14,0,0,1,120,222,342,fall
2011-09-11,3,15,0,0,1,134,270,404,fall
2011-09-11,3,16,0,0,1,180,303,483,fall
2011-09-11,3,17,0,0,1,152,228,380,fall
2011-09-11,3,18,0,0,1,110,229,339,fall
2011-09-11,3,19,0,0,1,101,232,333,fall
2011-09-11,3,20,0,0,1,65,161,226,fall
2011-09-11,3,21,0,0,1,45,114,159,fall
2011-09-11,3,22,0,0,1,21,74,95,fall
2011-09-11,3,23,0,0,3,12,33,45,fall
2011-09-12,3,0,0,1,1,5,11,16,fall
2011-09-12,3,1,0,1,1,1,11,12,fall
2011-09-12,3,2,0,1,1,2,0,2,fall
2011-09-12,3,4,0,1,1,0,4,4,fall
2011-09-12,3,5,0,1,1,1,23,24,fall
2011-09-12,3,6,0,1,1,1,108,109,fall
2011-09-12,3,7,0,1,1,12,300,312,fall
2011-09-12,3,8,0,1,1,26,382,408,fall
2011-09-12,3,9,0,1,1,21,155,176,fall
2011-09-12,3,10,0,1,1,40,89,129,fall
2011-09-12,3,11,0,1,1,34,131,165,fall
2011-09-12,3,12,0,1,1,37,147,184,fall
2011-09-12,3,13,0,1,1,43,120,163,fall
2011-09-12,3,14,0,1,1,60,129,189,fall
2011-09-12,3,15,0,1,1,60,152,212,fall
2011-09-12,3,16,0,1,1,60,238,298,fall
2011-09-12,3,17,0,1,1,75,515,590,fall
2011-09-12,3,18,0,1,1,56,515,571,fall
2011-09-12,3,19,0,1,1,63,373,436,fall
2011-09-12,3,20,0,1,1,41,258,299,fall
2011-09-12,3,21,0,1,1,29,166,195,fall
2011-09-12,3,22,0,1,1,16,134,150,fall
2011-09-12,3,23,0,1,1,7,62,69,fall
2011-09-13,3,0,0,1,1,7,19,26,fall
2011-09-13,3,1,0,1,1,4,6,10,fall
2011-09-13,3,2,0,1,1,2,0,2,fall
2011-09-13,3,3,0,1,1,2,2,4,fall
2011-09-13,3,4,0,1,1,2,6,8,fall
2011-09-13,3,5,0,1,1,1,19,20,fall
2011-09-13,3,6,0,1,1,6,116,122,fall
2011-09-13,3,7,0,1,1,14,348,362,fall
2011-09-13,3,8,0,1,1,26,399,425,fall
2011-09-13,3,9,0,1,1,35,179,214,fall
2011-09-13,3,10,0,1,1,42,93,135,fall
2011-09-13,3,11,0,1,1,33,120,153,fall
2011-09-13,3,12,0,1,1,43,144,187,fall
2011-09-13,3,13,0,1,1,48,136,184,fall
2011-09-13,3,14,0,1,1,51,139,190,fall
2011-09-13,3,15,0,1,1,35,145,180,fall
2011-09-13,3,16,0,1,1,41,251,292,fall
2011-09-13,3,17,0,1,1,72,507,579,fall
2011-09-13,3,18,0,1,1,67,472,539,fall
2011-09-13,3,19,0,1,1,55,341,396,fall
2011-09-13,3,20,0,1,1,31,241,272,fall
2011-09-13,3,21,0,1,1,45,200,245,fall
2011-09-13,3,22,0,1,1,24,120,144,fall
2011-09-13,3,23,0,1,1,15,59,74,fall
2011-09-14,3,0,0,1,1,5,28,33,fall
2011-09-14,3,1,0,1,1,1,7,8,fall
2011-09-14,3,2,0,1,1,1,4,5,fall
2011-09-14,3,3,0,1,1,1,7,8,fall
2011-09-14,3,4,0,1,1,1,8,9,fall
2011-09-14,3,5,0,1,1,1,30,31,fall
2011-09-14,3,6,0,1,1,7,138,145,fall
2011-09-14,3,7,0,1,1,20,350,370,fall
2011-09-14,3,8,0,1,1,33,396,429,fall
2011-09-14,3,9,0,1,1,19,183,202,fall
2011-09-14,3,10,0,1,1,27,115,142,fall
2011-09-14,3,11,0,1,1,43,121,164,fall
2011-09-14,3,12,0,1,1,56,156,212,fall
2011-09-14,3,13,0,1,1,39,139,178,fall
2011-09-14,3,14,0,1,1,19,105,124,fall
2011-09-14,3,15,0,1,1,30,146,176,fall
2011-09-14,3,16,0,1,1,36,241,277,fall
2011-09-14,3,17,0,1,1,87,512,599,fall
2011-09-14,3,18,0,1,1,83,503,586,fall
2011-09-14,3,19,0,1,2,44,337,381,fall
2011-09-14,3,20,0,1,2,40,221,261,fall
2011-09-14,3,21,0,1,2,24,189,213,fall
2011-09-14,3,22,0,1,2,20,140,160,fall
2011-09-14,3,23,0,1,2,10,62,72,fall
2011-09-15,3,0,0,1,1,3,34,37,fall
2011-09-15,3,1,0,1,1,0,20,20,fall
2011-09-15,3,2,0,1,1,0,5,5,fall
2011-09-15,3,3,0,1,1,3,5,8,fall
2011-09-15,3,4,0,1,1,2,5,7,fall
2011-09-15,3,5,0,1,1,1,30,31,fall
2011-09-15,3,6,0,1,2,5,119,124,fall
2011-09-15,3,7,0,1,2,17,321,338,fall
2011-09-15,3,8,0,1,1,27,364,391,fall
2011-09-15,3,9,0,1,2,23,186,209,fall
2011-09-15,3,10,0,1,2,25,96,121,fall
2011-09-15,3,11,0,1,2,39,120,159,fall
2011-09-15,3,12,0,1,2,31,148,179,fall
2011-09-15,3,13,0,1,2,38,151,189,fall
2011-09-15,3,14,0,1,2,36,134,170,fall
2011-09-15,3,15,0,1,2,25,110,135,fall
2011-09-15,3,16,0,1,2,29,193,222,fall
2011-09-15,3,17,0,1,3,31,230,261,fall
2011-09-15,3,18,0,1,3,22,222,244,fall
2011-09-15,3,19,0,1,1,20,212,232,fall
2011-09-15,3,20,0,1,1,25,223,248,fall
2011-09-15,3,21,0,1,1,11,134,145,fall
2011-09-15,3,22,0,1,1,7,108,115,fall
2011-09-15,3,23,0,1,1,8,61,69,fall
2011-09-16,3,0,0,1,1,5,43,48,fall
2011-09-16,3,1,0,1,1,7,19,26,fall
2011-09-16,3,2,0,1,1,3,7,10,fall
2011-09-16,3,3,0,1,1,2,4,6,fall
2011-09-16,3,4,0,1,1,1,3,4,fall
2011-09-16,3,5,0,1,1,2,30,32,fall
2011-09-16,3,6,0,1,1,6,87,93,fall
2011-09-16,3,7,0,1,1,16,283,299,fall
2011-09-16,3,8,0,1,1,23,386,409,fall
2011-09-16,3,9,0,1,1,21,189,210,fall
2011-09-16,3,10,0,1,2,36,104,140,fall
2011-09-16,3,11,0,1,2,40,139,179,fall
2011-09-16,3,12,0,1,2,39,212,251,fall
2011-09-16,3,13,0,1,2,55,168,223,fall
2011-09-16,3,14,0,1,2,49,176,225,fall
2011-09-16,3,15,0,1,2,38,165,203,fall
2011-09-16,3,16,0,1,2,67,291,358,fall
2011-09-16,3,17,0,1,2,86,480,566,fall
2011-09-16,3,18,0,1,2,55,427,482,fall
2011-09-16,3,19,0,1,2,59,256,315,fall
2011-09-16,3,20,0,1,2,41,184,225,fall
2011-09-16,3,21,0,1,2,39,124,163,fall
2011-09-16,3,22,0,1,1,32,135,167,fall
2011-09-16,3,23,0,1,1,20,106,126,fall
2011-09-17,3,0,0,0,1,28,80,108,fall
2011-09-17,3,1,0,0,1,28,52,80,fall
2011-09-17,3,2,0,0,1,18,61,79,fall
2011-09-17,3,3,0,0,1,7,21,28,fall
2011-09-17,3,4,0,0,1,1,4,5,fall
2011-09-17,3,5,0,0,1,2,3,5,fall
2011-09-17,3,6,0,0,2,5,17,22,fall
2011-09-17,3,7,0,0,2,4,33,37,fall
2011-09-17,3,8,0,0,2,27,81,108,fall
2011-09-17,3,9,0,0,2,32,145,177,fall
2011-09-17,3,10,0,0,2,72,177,249,fall
2011-09-17,3,11,0,0,2,119,248,367,fall
2011-09-17,3,12,0,0,2,115,257,372,fall
2011-09-17,3,13,0,0,2,124,225,349,fall
2011-09-17,3,14,0,0,2,123,174,297,fall
2011-09-17,3,15,0,0,2,148,206,354,fall
2011-09-17,3,16,0,0,1,116,189,305,fall
2011-09-17,3,17,0,0,1,141,218,359,fall
2011-09-17,3,18,0,0,2,95,234,329,fall
2011-09-17,3,19,0,0,1,70,186,256,fall
2011-09-17,3,20,0,0,1,43,133,176,fall
2011-09-17,3,21,0,0,2,49,121,170,fall
2011-09-17,3,22,0,0,1,31,112,143,fall
2011-09-17,3,23,0,0,1,36,100,136,fall
2011-09-18,3,0,0,0,1,24,88,112,fall
2011-09-18,3,1,0,0,1,13,66,79,fall
2011-09-18,3,2,0,0,1,21,68,89,fall
2011-09-18,3,3,0,0,1,11,25,36,fall
2011-09-18,3,4,0,0,1,1,0,1,fall
2011-09-18,3,5,0,0,1,1,5,6,fall
2011-09-18,3,6,0,0,1,2,10,12,fall
2011-09-18,3,7,0,0,1,15,29,44,fall
2011-09-18,3,8,0,0,1,16,53,69,fall
2011-09-18,3,9,0,0,1,46,94,140,fall
2011-09-18,3,10,0,0,1,82,178,260,fall
2011-09-18,3,11,0,0,1,116,201,317,fall
2011-09-18,3,12,0,0,1,135,229,364,fall
2011-09-18,3,13,0,0,1,162,214,376,fall
2011-09-18,3,14,0,0,2,127,184,311,fall
2011-09-18,3,15,0,0,2,132,233,365,fall
2011-09-18,3,16,0,0,2,134,235,369,fall
2011-09-18,3,17,0,0,2,95,230,325,fall
2011-09-18,3,18,0,0,2,66,223,289,fall
2011-09-18,3,19,0,0,2,54,191,245,fall
2011-09-18,3,20,0,0,2,44,136,180,fall
2011-09-18,3,21,0,0,2,37,110,147,fall
2011-09-18,3,22,0,0,2,9,75,84,fall
2011-09-18,3,23,0,0,1,10,44,54,fall
2011-09-19,3,0,0,1,2,14,23,37,fall
2011-09-19,3,1,0,1,2,3,7,10,fall
2011-09-19,3,2,0,1,2,6,7,13,fall
2011-09-19,3,3,0,1,2,1,4,5,fall
2011-09-19,3,4,0,1,2,2,6,8,fall
2011-09-19,3,5,0,1,2,2,26,28,fall
2011-09-19,3,6,0,1,1,6,107,113,fall
2011-09-19,3,7,0,1,2,20,312,332,fall
2011-09-19,3,8,0,1,2,29,391,420,fall
2011-09-19,3,9,0,1,2,32,183,215,fall
2011-09-19,3,10,0,1,2,21,84,105,fall
2011-09-19,3,11,0,1,2,41,98,139,fall
2011-09-19,3,12,0,1,2,51,138,189,fall
2011-09-19,3,13,0,1,2,53,124,177,fall
2011-09-19,3,14,0,1,2,45,143,188,fall
2011-09-19,3,15,0,1,2,44,143,187,fall
2011-09-19,3,16,0,1,2,55,208,263,fall
2011-09-19,3,17,0,1,2,85,483,568,fall
2011-09-19,3,18,0,1,2,56,484,540,fall
2011-09-19,3,19,0,1,2,41,333,374,fall
2011-09-19,3,20,0,1,2,27,204,231,fall
2011-09-19,3,21,0,1,2,19,181,200,fall
2011-09-19,3,22,0,1,2,25,104,129,fall
2011-09-19,3,23,0,1,2,13,55,68,fall
2011-09-20,3,0,0,1,2,4,21,25,fall
2011-09-20,3,1,0,1,2,3,11,14,fall
2011-09-20,3,2,0,1,2,1,4,5,fall
2011-09-20,3,3,0,1,2,0,3,3,fall
2011-09-20,3,4,0,1,1,2,4,6,fall
2011-09-20,3,5,0,1,2,1,21,22,fall
2011-09-20,3,6,0,1,2,3,111,114,fall
2011-09-20,3,7,0,1,2,23,306,329,fall
2011-09-20,3,8,0,1,3,13,196,209,fall
2011-09-20,3,9,0,1,3,5,64,69,fall
2011-09-20,3,10,0,1,3,4,26,30,fall
2011-09-20,3,11,0,1,3,8,48,56,fall
2011-09-20,3,12,0,1,2,13,47,60,fall
2011-09-20,3,13,0,1,2,22,81,103,fall
2011-09-20,3,14,0,1,2,27,85,112,fall
2011-09-20,3,15,0,1,2,34,158,192,fall
2011-09-20,3,16,0,1,2,23,241,264,fall
2011-09-20,3,17,0,1,1,66,445,511,fall
2011-09-20,3,18,0,1,1,39,453,492,fall
2011-09-20,3,19,0,1,1,43,294,337,fall
2011-09-20,3,20,0,1,1,41,212,253,fall
2011-09-20,3,21,0,1,1,29,177,206,fall
2011-09-20,3,22,0,1,1,23,125,148,fall
2011-09-20,3,23,0,1,1,11,70,81,fall
2011-09-21,3,0,0,1,1,7,20,27,fall
2011-09-21,3,1,0,1,1,0,17,17,fall
2011-09-21,3,2,0,1,1,1,5,6,fall
2011-09-21,3,3,0,1,2,0,6,6,fall
2011-09-21,3,4,0,1,2,2,5,7,fall
2011-09-21,3,5,0,1,2,1,30,31,fall
2011-09-21,3,6,0,1,2,5,112,117,fall
2011-09-21,3,7,0,1,2,18,312,330,fall
2011-09-21,3,8,0,1,2,18,444,462,fall
2011-09-21,3,9,0,1,2,21,187,208,fall
2011-09-21,3,10,0,1,2,30,103,133,fall
2011-09-21,3,11,0,1,2,42,138,180,fall
2011-09-21,3,12,0,1,2,42,151,193,fall
2011-09-21,3,13,0,1,2,37,144,181,fall
2011-09-21,3,14,0,1,2,40,139,179,fall
2011-09-21,3,15,0,1,2,43,142,185,fall
2011-09-21,3,16,0,1,2,51,230,281,fall
2011-09-21,3,17,0,1,3,61,475,536,fall
2011-09-21,3,18,0,1,3,24,384,408,fall
2011-09-21,3,19,0,1,3,30,253,283,fall
2011-09-21,3,20,0,1,3,11,149,160,fall
2011-09-21,3,21,0,1,2,25,175,200,fall
2011-09-21,3,22,0,1,2,15,112,127,fall
2011-09-21,3,23,0,1,1,15,80,95,fall
2011-09-22,3,0,0,1,1,11,30,41,fall
2011-09-22,3,1,0,1,2,5,6,11,fall
2011-09-22,3,2,0,1,2,2,8,10,fall
2011-09-22,3,3,0,1,2,5,7,12,fall
2011-09-22,3,4,0,1,2,0,2,2,fall
2011-09-22,3,5,0,1,2,2,28,30,fall
2011-09-22,3,6,0,1,2,7,94,101,fall
2011-09-22,3,7,0,1,2,16,295,311,fall
2011-09-22,3,8,0,1,2,26,389,415,fall
2011-09-22,3,9,0,1,2,35,168,203,fall
2011-09-22,3,10,0,1,2,19,101,120,fall
2011-09-22,3,11,0,1,2,23,142,165,fall
2011-09-22,3,12,0,1,2,25,151,176,fall
2011-09-22,3,13,0,1,2,38,155,193,fall
2011-09-22,3,14,0,1,2,41,142,183,fall
2011-09-22,3,15,0,1,2,32,149,181,fall
2011-09-22,3,16,0,1,2,39,262,301,fall
2011-09-22,3,17,0,1,2,50,513,563,fall
2011-09-22,3,18,0,1,2,50,501,551,fall
2011-09-22,3,19,0,1,2,32,388,420,fall
2011-09-22,3,20,0,1,2,35,250,285,fall
2011-09-22,3,21,0,1,2,27,194,221,fall
2011-09-22,3,22,0,1,2,21,166,187,fall
2011-09-22,3,23,0,1,2,14,99,113,fall
2011-09-23,4,0,0,1,2,11,41,52,winter
2011-09-23,4,1,0,1,2,2,29,31,winter
2011-09-23,4,2,0,1,2,6,14,20,winter
2011-09-23,4,3,0,1,2,3,5,8,winter
2011-09-23,4,4,0,1,3,6,7,13,winter
2011-09-23,4,5,0,1,2,2,20,22,winter
2011-09-23,4,6,0,1,2,5,99,104,winter
2011-09-23,4,7,0,1,3,14,240,254,winter
2011-09-23,4,8,0,1,3,20,297,317,winter
2011-09-23,4,9,0,1,3,3,108,111,winter
2011-09-23,4,10,0,1,3,7,28,35,winter
2011-09-23,4,11,0,1,3,1,20,21,winter
2011-09-23,4,12,0,1,3,1,28,29,winter
2011-09-23,4,13,0,1,3,7,27,34,winter
2011-09-23,4,14,0,1,3,3,21,24,winter
2011-09-23,4,15,0,1,3,9,52,61,winter
2011-09-23,4,16,0,1,3,5,51,56,winter
2011-09-23,4,17,0,1,2,13,86,99,winter
2011-09-23,4,18,0,1,1,14,220,234,winter
2011-09-23,4,19,0,1,1,16,232,248,winter
2011-09-23,4,20,0,1,1,21,158,179,winter
2011-09-23,4,21,0,1,1,17,121,138,winter
2011-09-23,4,22,0,1,1,31,126,157,winter
2011-09-23,4,23,0,1,2,41,107,148,winter
2011-09-24,4,0,0,0,1,7,86,93,winter
2011-09-24,4,1,0,0,2,18,61,79,winter
2011-09-24,4,2,0,0,2,14,54,68,winter
2011-09-24,4,3,0,0,1,4,27,31,winter
2011-09-24,4,4,0,0,1,1,7,8,winter
2011-09-24,4,5,0,0,2,2,3,5,winter
2011-09-24,4,6,0,0,2,6,12,18,winter
2011-09-24,4,7,0,0,2,12,34,46,winter
2011-09-24,4,8,0,0,2,19,102,121,winter
2011-09-24,4,9,0,0,2,41,134,175,winter
2011-09-24,4,10,0,0,2,90,203,293,winter
2011-09-24,4,11,0,0,2,118,268,386,winter
2011-09-24,4,12,0,0,2,141,266,407,winter
2011-09-24,4,13,0,0,1,170,290,460,winter
2011-09-24,4,14,0,0,2,164,226,390,winter
2011-09-24,4,15,0,0,2,168,284,452,winter
2011-09-24,4,16,0,0,2,167,282,449,winter
2011-09-24,4,17,0,0,1,180,246,426,winter
2011-09-24,4,18,0,0,1,157,243,400,winter
2011-09-24,4,19,0,0,1,77,231,308,winter
2011-09-24,4,20,0,0,1,77,166,243,winter
2011-09-24,4,21,0,0,1,66,156,222,winter
2011-09-24,4,22,0,0,2,50,143,193,winter
2011-09-24,4,23,0,0,2,27,123,150,winter
2011-09-25,4,0,0,0,2,37,136,173,winter
2011-09-25,4,1,0,0,2,31,93,124,winter
2011-09-25,4,2,0,0,3,27,79,106,winter
2011-09-25,4,3,0,0,3,20,39,59,winter
2011-09-25,4,4,0,0,3,3,5,8,winter
2011-09-25,4,5,0,0,1,1,2,3,winter
2011-09-25,4,6,0,0,2,4,13,17,winter
2011-09-25,4,7,0,0,2,15,23,38,winter
2011-09-25,4,8,0,0,2,27,59,86,winter
2011-09-25,4,9,0,0,2,55,100,155,winter
2011-09-25,4,10,0,0,2,85,190,275,winter
2011-09-25,4,11,0,0,2,131,230,361,winter
2011-09-25,4,12,0,0,2,143,270,413,winter
2011-09-25,4,13,0,0,2,122,247,369,winter
2011-09-25,4,14,0,0,2,116,231,347,winter
2011-09-25,4,15,0,0,2,119,234,353,winter
2011-09-25,4,16,0,0,1,144,320,464,winter
2011-09-25,4,17,0,0,1,145,275,420,winter
2011-09-25,4,18,0,0,1,125,279,404,winter
2011-09-25,4,19,0,0,1,87,242,329,winter
2011-09-25,4,20,0,0,1,51,135,186,winter
2011-09-25,4,21,0,0,1,24,113,137,winter
2011-09-25,4,22,0,0,1,20,84,104,winter
2011-09-25,4,23,0,0,2,12,67,79,winter
2011-09-26,4,0,0,1,2,6,23,29,winter
2011-09-26,4,1,0,1,2,3,14,17,winter
2011-09-26,4,2,0,1,2,4,4,8,winter
2011-09-26,4,3,0,1,2,0,5,5,winter
2011-09-26,4,4,0,1,2,2,4,6,winter
2011-09-26,4,5,0,1,2,0,25,25,winter
2011-09-26,4,6,0,1,2,6,107,113,winter
2011-09-26,4,7,0,1,2,17,315,332,winter
2011-09-26,4,8,0,1,2,29,326,355,winter
2011-09-26,4,9,0,1,2,44,161,205,winter
2011-09-26,4,10,0,1,2,37,117,154,winter
2011-09-26,4,11,0,1,1,43,116,159,winter
2011-09-26,4,12,0,1,2,48,161,209,winter
2011-09-26,4,13,0,1,2,48,139,187,winter
2011-09-26,4,14,0,1,1,44,110,154,winter
2011-09-26,4,15,0,1,1,52,157,209,winter
2011-09-26,4,16,0,1,1,74,239,313,winter
2011-09-26,4,17,0,1,1,61,509,570,winter
2011-09-26,4,18,0,1,1,63,490,553,winter
2011-09-26,4,19,0,1,1,36,347,383,winter
2011-09-26,4,20,0,1,1,24,227,251,winter
2011-09-26,4,21,0,1,1,18,164,182,winter
2011-09-26,4,22,0,1,1,14,122,136,winter
2011-09-26,4,23,0,1,1,11,64,75,winter
2011-09-27,4,0,0,1,1,9,28,37,winter
2011-09-27,4,1,0,1,1,4,6,10,winter
2011-09-27,4,2,0,1,1,7,4,11,winter
2011-09-27,4,3,0,1,2,5,5,10,winter
2011-09-27,4,4,0,1,3,5,3,8,winter
2011-09-27,4,5,0,1,3,0,24,24,winter
2011-09-27,4,6,0,1,2,8,116,124,winter
2011-09-27,4,7,0,1,2,15,234,249,winter
2011-09-27,4,8,0,1,2,27,400,427,winter
2011-09-27,4,9,0,1,3,20,173,193,winter
2011-09-27,4,10,0,1,3,21,101,122,winter
2011-09-27,4,11,0,1,2,26,97,123,winter
2011-09-27,4,12,0,1,2,33,129,162,winter
2011-09-27,4,13,0,1,2,29,122,151,winter
2011-09-27,4,14,0,1,2,29,123,152,winter
2011-09-27,4,15,0,1,2,35,170,205,winter
2011-09-27,4,16,0,1,2,33,225,258,winter
2011-09-27,4,17,0,1,2,50,480,530,winter
2011-09-27,4,18,0,1,2,31,325,356,winter
2011-09-27,4,19,0,1,2,26,294,320,winter
2011-09-27,4,20,0,1,1,17,221,238,winter
2011-09-27,4,21,0,1,1,17,179,196,winter
2011-09-27,4,22,0,1,1,19,102,121,winter
2011-09-27,4,23,0,1,1,11,82,93,winter
2011-09-28,4,0,0,1,1,7,29,36,winter
2011-09-28,4,1,0,1,1,1,13,14,winter
2011-09-28,4,2,0,1,1,0,9,9,winter
2011-09-28,4,3,0,1,2,0,3,3,winter
2011-09-28,4,4,0,1,1,1,3,4,winter
2011-09-28,4,5,0,1,2,2,20,22,winter
2011-09-28,4,6,0,1,3,3,111,114,winter
2011-09-28,4,7,0,1,3,8,177,185,winter
2011-09-28,4,8,0,1,3,17,270,287,winter
2011-09-28,4,9,0,1,3,14,141,155,winter
2011-09-28,4,10,0,1,2,20,109,129,winter
2011-09-28,4,11,0,1,2,24,127,151,winter
2011-09-28,4,12,0,1,2,25,159,184,winter
2011-09-28,4,13,0,1,1,24,138,162,winter
2011-09-28,4,14,0,1,1,25,145,170,winter
2011-09-28,4,15,0,1,1,35,146,181,winter
2011-09-28,4,16,0,1,1,39,241,280,winter
2011-09-28,4,17,0,1,1,64,527,591,winter
2011-09-28,4,18,0,1,3,65,459,524,winter
2011-09-28,4,19,0,1,3,57,315,372,winter
2011-09-28,4,20,0,1,3,11,91,102,winter
2011-09-28,4,21,0,1,3,7,67,74,winter
2011-09-28,4,22,0,1,1,19,68,87,winter
2011-09-28,4,23,0,1,1,12,59,71,winter
2011-09-29,4,0,0,1,1,7,33,40,winter
2011-09-29,4,1,0,1,2,3,20,23,winter
2011-09-29,4,2,0,1,2,0,2,2,winter
2011-09-29,4,3,0,1,2,0,8,8,winter
2011-09-29,4,4,0,1,2,2,5,7,winter
2011-09-29,4,5,0,1,2,0,22,22,winter
2011-09-29,4,6,0,1,2,5,106,111,winter
2011-09-29,4,7,0,1,1,14,269,283,winter
2011-09-29,4,8,0,1,1,29,402,431,winter
2011-09-29,4,9,0,1,1,27,198,225,winter
2011-09-29,4,10,0,1,1,24,103,127,winter
2011-09-29,4,11,0,1,1,36,122,158,winter
2011-09-29,4,12,0,1,1,38,157,195,winter
2011-09-29,4,13,0,1,1,36,175,211,winter
2011-09-29,4,14,0,1,1,33,134,167,winter
2011-09-29,4,15,0,1,1,42,185,227,winter
2011-09-29,4,16,0,1,1,64,227,291,winter
2011-09-29,4,17,0,1,1,62,527,589,winter
2011-09-29,4,18,0,1,1,84,500,584,winter
2011-09-29,4,19,0,1,1,36,348,384,winter
2011-09-29,4,20,0,1,1,39,234,273,winter
2011-09-29,4,21,0,1,1,30,195,225,winter
2011-09-29,4,22,0,1,1,25,150,175,winter
2011-09-29,4,23,0,1,1,17,64,81,winter
2011-09-30,4,0,0,1,1,7,53,60,winter
2011-09-30,4,1,0,1,1,5,18,23,winter
2011-09-30,4,2,0,1,1,6,9,15,winter
2011-09-30,4,3,0,1,1,0,3,3,winter
2011-09-30,4,4,0,1,1,2,6,8,winter
2011-09-30,4,5,0,1,1,3,23,26,winter
2011-09-30,4,6,0,1,1,0,98,98,winter
2011-09-30,4,7,0,1,1,14,283,297,winter
2011-09-30,4,8,0,1,1,31,425,456,winter
2011-09-30,4,9,0,1,1,23,214,237,winter
2011-09-30,4,10,0,1,1,46,122,168,winter
2011-09-30,4,11,0,1,1,49,168,217,winter
2011-09-30,4,12,0,1,2,59,195,254,winter
2011-09-30,4,13,0,1,2,72,194,266,winter
2011-09-30,4,14,0,1,2,93,173,266,winter
2011-09-30,4,15,0,1,1,52,193,245,winter
2011-09-30,4,16,0,1,1,62,298,360,winter
2011-09-30,4,17,0,1,1,94,497,591,winter
2011-09-30,4,18,0,1,1,62,449,511,winter
2011-09-30,4,19,0,1,1,42,332,374,winter
2011-09-30,4,20,0,1,1,28,202,230,winter
2011-09-30,4,21,0,1,1,27,179,206,winter
2011-09-30,4,22,0,1,1,30,129,159,winter
2011-09-30,4,23,0,1,1,23,109,132,winter
2011-10-01,4,0,0,0,1,24,106,130,winter
2011-10-01,4,1,0,0,1,11,47,58,winter
2011-10-01,4,2,0,0,1,21,46,67,winter
2011-10-01,4,3,0,0,1,8,17,25,winter
2011-10-01,4,4,0,0,1,2,6,8,winter
2011-10-01,4,5,0,0,2,1,4,5,winter
2011-10-01,4,6,0,0,1,4,15,19,winter
2011-10-01,4,7,0,0,3,6,30,36,winter
2011-10-01,4,8,0,0,2,9,58,67,winter
2011-10-01,4,9,0,0,3,17,112,129,winter
2011-10-01,4,10,0,0,3,21,100,121,winter
2011-10-01,4,11,0,0,3,30,102,132,winter
2011-10-01,4,12,0,0,2,28,130,158,winter
2011-10-01,4,13,0,0,2,27,98,125,winter
2011-10-01,4,14,0,0,2,33,147,180,winter
2011-10-01,4,15,0,0,2,41,154,195,winter
2011-10-01,4,16,0,0,2,58,165,223,winter
2011-10-01,4,17,0,0,3,58,170,228,winter
2011-10-01,4,18,0,0,3,23,117,140,winter
2011-10-01,4,19,0,0,2,27,99,126,winter
2011-10-01,4,20,0,0,3,8,58,66,winter
2011-10-01,4,21,0,0,3,3,53,56,winter
2011-10-01,4,22,0,0,2,12,58,70,winter
2011-10-01,4,23,0,0,3,8,57,65,winter
2011-10-02,4,0,0,0,3,4,43,47,winter
2011-10-02,4,1,0,0,3,1,23,24,winter
2011-10-02,4,2,0,0,3,3,27,30,winter
2011-10-02,4,3,0,0,3,4,5,9,winter
2011-10-02,4,4,0,0,2,4,3,7,winter
2011-10-02,4,5,0,0,1,0,7,7,winter
2011-10-02,4,6,0,0,1,2,13,15,winter
2011-10-02,4,7,0,0,1,5,24,29,winter
2011-10-02,4,8,0,0,2,14,50,64,winter
2011-10-02,4,9,0,0,1,19,96,115,winter
2011-10-02,4,10,0,0,2,60,188,248,winter
2011-10-02,4,11,0,0,2,74,218,292,winter
2011-10-02,4,12,0,0,2,78,243,321,winter
2011-10-02,4,13,0,0,3,84,224,308,winter
2011-10-02,4,14,0,0,3,61,195,256,winter
2011-10-02,4,15,0,0,3,29,144,173,winter
2011-10-02,4,16,0,0,3,44,162,206,winter
2011-10-02,4,17,0,0,3,32,135,167,winter
2011-10-02,4,18,0,0,2,16,158,174,winter
2011-10-02,4,19,0,0,2,34,128,162,winter
2011-10-02,4,20,0,0,2,16,71,87,winter
2011-10-02,4,21,0,0,1,17,71,88,winter
2011-10-02,4,22,0,0,3,9,55,64,winter
2011-10-02,4,23,0,0,1,6,19,25,winter
2011-10-03,4,0,0,1,1,3,13,16,winter
2011-10-03,4,1,0,1,1,1,5,6,winter
2011-10-03,4,2,0,1,1,0,4,4,winter
2011-10-03,4,3,0,1,1,1,6,7,winter
2011-10-03,4,4,0,1,1,2,6,8,winter
2011-10-03,4,5,0,1,2,4,17,21,winter
2011-10-03,4,6,0,1,2,3,91,94,winter
2011-10-03,4,7,0,1,2,8,241,249,winter
2011-10-03,4,8,0,1,2,13,359,372,winter
2011-10-03,4,9,0,1,2,12,141,153,winter
2011-10-03,4,10,0,1,2,19,82,101,winter
2011-10-03,4,11,0,1,2,26,100,126,winter
2011-10-03,4,12,0,1,2,29,118,147,winter
2011-10-03,4,13,0,1,3,16,102,118,winter
2011-10-03,4,14,0,1,3,26,94,120,winter
2011-10-03,4,15,0,1,3,22,79,101,winter
2011-10-03,4,16,0,1,2,16,202,218,winter
2011-10-03,4,17,0,1,2,40,455,495,winter
2011-10-03,4,18,0,1,2,28,384,412,winter
2011-10-03,4,19,0,1,1,15,300,315,winter
2011-10-03,4,20,0,1,3,13,191,204,winter
2011-10-03,4,21,0,1,2,10,128,138,winter
2011-10-03,4,22,0,1,2,12,79,91,winter
2011-10-03,4,23,0,1,2,11,43,54,winter
2011-10-04,4,0,0,1,2,5,22,27,winter
2011-10-04,4,1,0,1,2,1,8,9,winter
2011-10-04,4,2,0,1,2,1,2,3,winter
2011-10-04,4,3,0,1,1,3,3,6,winter
2011-10-04,4,4,0,1,1,3,4,7,winter
2011-10-04,4,5,0,1,1,2,25,27,winter
2011-10-04,4,6,0,1,1,3,109,112,winter
2011-10-04,4,7,0,1,1,11,298,309,winter
2011-10-04,4,8,0,1,1,28,372,400,winter
2011-10-04,4,9,0,1,1,19,168,187,winter
2011-10-04,4,10,0,1,1,19,107,126,winter
2011-10-04,4,11,0,1,1,22,102,124,winter
2011-10-04,4,12,0,1,1,39,160,199,winter
2011-10-04,4,13,0,1,1,20,153,173,winter
2011-10-04,4,14,0,1,1,27,156,183,winter
2011-10-04,4,15,0,1,1,28,166,194,winter
2011-10-04,4,16,0,1,1,36,273,309,winter
2011-10-04,4,17,0,1,1,55,530,585,winter
2011-10-04,4,18,0,1,1,68,456,524,winter
2011-10-04,4,19,0,1,1,35,310,345,winter
2011-10-04,4,20,0,1,1,25,236,261,winter
2011-10-04,4,21,0,1,1,22,144,166,winter
2011-10-04,4,22,0,1,1,8,106,114,winter
2011-10-04,4,23,0,1,1,6,60,66,winter
2011-10-05,4,0,0,1,1,7,36,43,winter
2011-10-05,4,1,0,1,1,4,7,11,winter
2011-10-05,4,2,0,1,1,1,2,3,winter
2011-10-05,4,3,0,1,1,1,5,6,winter
2011-10-05,4,4,0,1,1,1,4,5,winter
2011-10-05,4,5,0,1,1,3,29,32,winter
2011-10-05,4,6,0,1,1,5,112,117,winter
2011-10-05,4,7,0,1,1,9,292,301,winter
2011-10-05,4,8,0,1,1,26,441,467,winter
2011-10-05,4,9,0,1,1,32,187,219,winter
2011-10-05,4,10,0,1,1,30,103,133,winter
2011-10-05,4,11,0,1,1,32,138,170,winter
2011-10-05,4,12,0,1,1,34,180,214,winter
2011-10-05,4,13,0,1,1,30,189,219,winter
2011-10-05,4,14,0,1,1,34,156,190,winter
2011-10-05,4,15,0,1,1,35,147,182,winter
2011-10-05,4,16,0,1,1,37,245,282,winter
2011-10-05,4,17,0,1,1,66,525,591,winter
2011-10-05,4,18,0,1,1,57,536,593,winter
2011-10-05,4,19,0,1,1,40,334,374,winter
2011-10-05,4,20,0,1,1,18,228,246,winter
2011-10-05,4,21,0,1,1,28,173,201,winter
2011-10-05,4,22,0,1,1,20,134,154,winter
2011-10-05,4,23,0,1,1,9,64,73,winter
2011-10-06,4,0,0,1,1,6,34,40,winter
2011-10-06,4,1,0,1,1,5,17,22,winter
2011-10-06,4,2,0,1,1,2,8,10,winter
2011-10-06,4,3,0,1,1,1,4,5,winter
2011-10-06,4,4,0,1,1,0,5,5,winter
2011-10-06,4,5,0,1,1,0,24,24,winter
2011-10-06,4,6,0,1,1,4,110,114,winter
2011-10-06,4,7,0,1,1,15,287,302,winter
2011-10-06,4,8,0,1,1,20,437,457,winter
2011-10-06,4,9,0,1,1,20,188,208,winter
2011-10-06,4,10,0,1,1,24,105,129,winter
2011-10-06,4,11,0,1,1,29,115,144,winter
2011-10-06,4,12,0,1,1,46,180,226,winter
2011-10-06,4,13,0,1,1,33,158,191,winter
2011-10-06,4,14,0,1,1,56,139,195,winter
2011-10-06,4,15,0,1,1,62,157,219,winter
2011-10-06,4,16,0,1,1,51,272,323,winter
2011-10-06,4,17,0,1,1,63,505,568,winter
2011-10-06,4,18,0,1,1,59,479,538,winter
2011-10-06,4,19,0,1,1,38,305,343,winter
2011-10-06,4,20,0,1,1,29,231,260,winter
2011-10-06,4,21,0,1,1,34,161,195,winter
2011-10-06,4,22,0,1,1,24,124,148,winter
2011-10-06,4,23,0,1,1,18,81,99,winter
2011-10-07,4,0,0,1,1,19,48,67,winter
2011-10-07,4,1,0,1,1,3,25,28,winter
2011-10-07,4,2,0,1,1,0,5,5,winter
2011-10-07,4,3,0,1,1,1,9,10,winter
2011-10-07,4,4,0,1,1,0,5,5,winter
2011-10-07,4,5,0,1,1,3,24,27,winter
2011-10-07,4,6,0,1,1,3,84,87,winter
2011-10-07,4,7,0,1,1,5,237,242,winter
2011-10-07,4,8,0,1,1,31,386,417,winter
2011-10-07,4,9,0,1,1,34,207,241,winter
2011-10-07,4,10,0,1,1,48,126,174,winter
2011-10-07,4,11,0,1,1,80,150,230,winter
2011-10-07,4,12,0,1,1,61,174,235,winter
2011-10-07,4,13,0,1,1,95,210,305,winter
2011-10-07,4,14,0,1,1,77,179,256,winter
2011-10-07,4,15,0,1,1,68,202,270,winter
2011-10-07,4,16,0,1,1,73,346,419,winter
2011-10-07,4,17,0,1,1,101,462,563,winter
2011-10-07,4,18,0,1,1,94,371,465,winter
2011-10-07,4,19,0,1,1,51,243,294,winter
2011-10-07,4,20,0,1,1,30,167,197,winter
2011-10-07,4,21,0,1,1,22,144,166,winter
2011-10-07,4,22,0,1,1,27,119,146,winter
2011-10-07,4,23,0,1,1,23,113,136,winter
2011-10-08,4,0,0,0,1,17,72,89,winter
2011-10-08,4,1,0,0,1,14,51,65,winter
2011-10-08,4,2,0,0,1,4,41,45,winter
2011-10-08,4,3,0,0,1,4,16,20,winter
2011-10-08,4,4,0,0,1,3,7,10,winter
2011-10-08,4,5,0,0,1,1,7,8,winter
2011-10-08,4,6,0,0,1,6,16,22,winter
2011-10-08,4,7,0,0,1,27,46,73,winter
2011-10-08,4,8,0,0,1,14,89,103,winter
2011-10-08,4,9,0,0,1,54,163,217,winter
2011-10-08,4,10,0,0,1,120,217,337,winter
2011-10-08,4,11,0,0,1,176,221,397,winter
2011-10-08,4,12,0,0,1,191,255,446,winter
2011-10-08,4,13,0,0,1,256,229,485,winter
2011-10-08,4,14,0,0,1,251,214,465,winter
2011-10-08,4,15,0,0,1,262,234,496,winter
2011-10-08,4,16,0,0,1,221,230,451,winter
2011-10-08,4,17,0,0,1,174,219,393,winter
2011-10-08,4,18,0,0,1,135,224,359,winter
2011-10-08,4,19,0,0,1,76,172,248,winter
2011-10-08,4,20,0,0,1,78,124,202,winter
2011-10-08,4,21,0,0,1,54,133,187,winter
2011-10-08,4,22,0,0,1,45,104,149,winter
2011-10-08,4,23,0,0,1,52,90,142,winter
2011-10-09,4,0,0,0,1,46,83,129,winter
2011-10-09,4,1,0,0,1,15,63,78,winter
2011-10-09,4,2,0,0,1,20,35,55,winter
2011-10-09,4,3,0,0,1,10,20,30,winter
2011-10-09,4,4,0,0,1,7,7,14,winter
2011-10-09,4,5,0,0,1,1,14,15,winter
2011-10-09,4,6,0,0,1,7,14,21,winter
2011-10-09,4,7,0,0,1,18,26,44,winter
2011-10-09,4,8,0,0,1,25,82,107,winter
2011-10-09,4,9,0,0,1,66,119,185,winter
2011-10-09,4,10,0,0,1,155,210,365,winter
2011-10-09,4,11,0,0,1,189,234,423,winter
2011-10-09,4,12,0,0,1,212,243,455,winter
2011-10-09,4,13,0,0,1,225,193,418,winter
2011-10-09,4,14,0,0,1,272,228,500,winter
2011-10-09,4,15,0,0,1,198,209,407,winter
2011-10-09,4,16,0,0,1,223,247,470,winter
2011-10-09,4,17,0,0,1,208,230,438,winter
2011-10-09,4,18,0,0,1,186,228,414,winter
2011-10-09,4,19,0,0,1,116,186,302,winter
2011-10-09,4,20,0,0,1,59,134,193,winter
2011-10-09,4,21,0,0,1,53,120,173,winter
2011-10-09,4,22,0,0,2,48,104,152,winter
2011-10-09,4,23,0,0,1,38,85,123,winter
2011-10-10,4,0,1,0,1,11,42,53,winter
2011-10-10,4,1,1,0,1,4,30,34,winter
2011-10-10,4,2,1,0,1,4,15,19,winter
2011-10-10,4,3,1,0,1,2,9,11,winter
2011-10-10,4,4,1,0,1,2,4,6,winter
2011-10-10,4,5,1,0,1,2,19,21,winter
2011-10-10,4,6,1,0,1,5,39,44,winter
2011-10-10,4,7,1,0,1,12,102,114,winter
2011-10-10,4,8,1,0,1,27,227,254,winter
2011-10-10,4,9,1,0,1,58,161,219,winter
2011-10-10,4,10,1,0,1,107,158,265,winter
2011-10-10,4,11,1,0,1,139,183,322,winter
2011-10-10,4,12,1,0,2,164,201,365,winter
2011-10-10,4,13,1,0,1,146,219,365,winter
2011-10-10,4,14,1,0,1,147,223,370,winter
2011-10-10,4,15,1,0,2,130,254,384,winter
2011-10-10,4,16,1,0,2,154,248,402,winter
2011-10-10,4,17,1,0,2,125,334,459,winter
2011-10-10,4,18,1,0,2,108,365,473,winter
2011-10-10,4,19,1,0,2,69,267,336,winter
2011-10-10,4,20,1,0,1,37,188,225,winter
2011-10-10,4,21,1,0,1,27,148,175,winter
2011-10-10,4,22,1,0,1,22,104,126,winter
2011-10-10,4,23,1,0,2,12,63,75,winter
2011-10-11,4,0,0,1,2,14,16,30,winter
2011-10-11,4,1,0,1,2,2,9,11,winter
2011-10-11,4,2,0,1,2,1,4,5,winter
2011-10-11,4,3,0,1,2,2,1,3,winter
2011-10-11,4,4,0,1,2,0,5,5,winter
2011-10-11,4,5,0,1,2,0,20,20,winter
2011-10-11,4,6,0,1,1,9,114,123,winter
2011-10-11,4,7,0,1,2,19,333,352,winter
2011-10-11,4,8,0,1,2,31,375,406,winter
2011-10-11,4,9,0,1,2,40,195,235,winter
2011-10-11,4,10,0,1,2,38,111,149,winter
2011-10-11,4,11,0,1,2,31,92,123,winter
2011-10-11,4,12,0,1,2,51,130,181,winter
2011-10-11,4,13,0,1,2,42,138,180,winter
2011-10-11,4,14,0,1,3,54,117,171,winter
2011-10-11,4,15,0,1,2,36,139,175,winter
2011-10-11,4,16,0,1,2,63,257,320,winter
2011-10-11,4,17,0,1,2,70,534,604,winter
2011-10-11,4,18,0,1,2,46,493,539,winter
2011-10-11,4,19,0,1,2,33,285,318,winter
2011-10-11,4,20,0,1,2,31,203,234,winter
2011-10-11,4,21,0,1,2,17,158,175,winter
2011-10-11,4,22,0,1,2,27,120,147,winter
2011-10-11,4,23,0,1,2,10,47,57,winter
2011-10-12,4,0,0,1,2,2,23,25,winter
2011-10-12,4,1,0,1,3,2,8,10,winter
2011-10-12,4,2,0,1,2,0,2,2,winter
2011-10-12,4,3,0,1,3,0,2,2,winter
2011-10-12,4,4,0,1,3,1,6,7,winter
2011-10-12,4,5,0,1,2,0,22,22,winter
2011-10-12,4,6,0,1,2,5,107,112,winter
2011-10-12,4,7,0,1,2,15,244,259,winter
2011-10-12,4,8,0,1,2,27,377,404,winter
2011-10-12,4,9,0,1,2,14,183,197,winter
2011-10-12,4,10,0,1,2,15,98,113,winter
2011-10-12,4,11,0,1,3,18,102,120,winter
2011-10-12,4,12,0,1,3,9,53,62,winter
2011-10-12,4,13,0,1,3,25,76,101,winter
2011-10-12,4,14,0,1,3,8,70,78,winter
2011-10-12,4,15,0,1,3,3,42,45,winter
2011-10-12,4,16,0,1,2,5,50,55,winter
2011-10-12,4,17,0,1,3,16,235,251,winter
2011-10-12,4,18,0,1,3,11,161,172,winter
2011-10-12,4,19,0,1,3,7,102,109,winter
2011-10-12,4,20,0,1,3,9,81,90,winter
2011-10-12,4,21,0,1,3,9,74,83,winter
2011-10-12,4,22,0,1,3,3,40,43,winter
2011-10-12,4,23,0,1,3,13,41,54,winter
2011-10-13,4,0,0,1,2,1,14,15,winter
2011-10-13,4,1,0,1,2,3,9,12,winter
2011-10-13,4,2,0,1,2,0,4,4,winter
2011-10-13,4,3,0,1,2,2,4,6,winter
2011-10-13,4,4,0,1,2,2,5,7,winter
2011-10-13,4,5,0,1,2,1,16,17,winter
2011-10-13,4,6,0,1,3,1,51,52,winter
2011-10-13,4,7,0,1,3,5,76,81,winter
2011-10-13,4,8,0,1,3,10,199,209,winter
2011-10-13,4,9,0,1,3,3,106,109,winter
2011-10-13,4,10,0,1,3,16,53,69,winter
2011-10-13,4,11,0,1,2,8,76,84,winter
2011-10-13,4,12,0,1,2,10,95,105,winter
2011-10-13,4,13,0,1,2,20,142,162,winter
2011-10-13,4,14,0,1,1,22,111,133,winter
2011-10-13,4,15,0,1,1,27,128,155,winter
2011-10-13,4,16,0,1,1,36,240,276,winter
2011-10-13,4,17,0,1,3,47,432,479,winter
2011-10-13,4,18,0,1,3,20,248,268,winter
2011-10-13,4,19,0,1,2,18,187,205,winter
2011-10-13,4,20,0,1,1,15,166,181,winter
2011-10-13,4,21,0,1,1,8,115,123,winter
2011-10-13,4,22,0,1,1,13,101,114,winter
2011-10-13,4,23,0,1,2,2,45,47,winter
2011-10-14,4,0,0,1,1,10,29,39,winter
2011-10-14,4,1,0,1,1,8,16,24,winter
2011-10-14,4,2,0,1,1,0,6,6,winter
2011-10-14,4,3,0,1,1,1,6,7,winter
2011-10-14,4,4,0,1,1,0,8,8,winter
2011-10-14,4,5,0,1,2,0,17,17,winter
2011-10-14,4,6,0,1,3,4,90,94,winter
2011-10-14,4,7,0,1,3,10,137,147,winter
2011-10-14,4,8,0,1,2,23,186,209,winter
2011-10-14,4,9,0,1,2,16,164,180,winter
2011-10-14,4,10,0,1,3,17,108,125,winter
2011-10-14,4,11,0,1,3,11,76,87,winter
2011-10-14,4,12,0,1,3,13,62,75,winter
2011-10-14,4,13,0,1,1,18,114,132,winter
2011-10-14,4,14,0,1,1,37,119,156,winter
2011-10-14,4,15,0,1,1,61,169,230,winter
2011-10-14,4,16,0,1,1,80,264,344,winter
2011-10-14,4,17,0,1,1,55,426,481,winter
2011-10-14,4,18,0,1,1,62,361,423,winter
2011-10-14,4,19,0,1,1,27,221,248,winter
2011-10-14,4,20,0,1,1,19,177,196,winter
2011-10-14,4,21,0,1,1,22,156,178,winter
2011-10-14,4,22,0,1,1,20,123,143,winter
2011-10-14,4,23,0,1,1,15,80,95,winter
2011-10-15,4,0,0,0,1,18,88,106,winter
2011-10-15,4,1,0,0,1,9,64,73,winter
2011-10-15,4,2,0,0,1,17,39,56,winter
2011-10-15,4,3,0,0,1,5,18,23,winter
2011-10-15,4,4,0,0,1,0,6,6,winter
2011-10-15,4,5,0,0,1,1,6,7,winter
2011-10-15,4,6,0,0,1,5,15,20,winter
2011-10-15,4,7,0,0,1,17,40,57,winter
2011-10-15,4,8,0,0,1,24,101,125,winter
2011-10-15,4,9,0,0,1,50,157,207,winter
2011-10-15,4,10,0,0,1,115,207,322,winter
2011-10-15,4,11,0,0,1,153,221,374,winter
2011-10-15,4,12,0,0,1,195,261,456,winter
2011-10-15,4,13,0,0,1,171,223,394,winter
2011-10-15,4,14,0,0,1,242,230,472,winter
2011-10-15,4,15,0,0,1,166,211,377,winter
2011-10-15,4,16,0,0,1,179,264,443,winter
2011-10-15,4,17,0,0,1,177,264,441,winter
2011-10-15,4,18,0,0,1,121,251,372,winter
2011-10-15,4,19,0,0,1,61,177,238,winter
2011-10-15,4,20,0,0,1,42,137,179,winter
2011-10-15,4,21,0,0,1,53,115,168,winter
2011-10-15,4,22,0,0,1,45,121,166,winter
2011-10-15,4,23,0,0,1,33,102,135,winter
2011-10-16,4,0,0,0,1,22,85,107,winter
2011-10-16,4,1,0,0,1,13,64,77,winter
2011-10-16,4,2,0,0,1,13,52,65,winter
2011-10-16,4,3,0,0,1,11,31,42,winter
2011-10-16,4,4,0,0,1,5,7,12,winter
2011-10-16,4,5,0,0,1,1,6,7,winter
2011-10-16,4,6,0,0,1,3,7,10,winter
2011-10-16,4,7,0,0,1,9,39,48,winter
2011-10-16,4,8,0,0,1,28,71,99,winter
2011-10-16,4,9,0,0,1,39,151,190,winter
2011-10-16,4,10,0,0,1,121,226,347,winter
2011-10-16,4,11,0,0,1,159,218,377,winter
2011-10-16,4,12,0,0,1,167,277,444,winter
2011-10-16,4,13,0,0,1,169,269,438,winter
2011-10-16,4,14,0,0,1,204,258,462,winter
2011-10-16,4,15,0,0,1,182,230,412,winter
2011-10-16,4,16,0,0,1,177,289,466,winter
2011-10-16,4,17,0,0,1,152,253,405,winter
2011-10-16,4,18,0,0,1,102,226,328,winter
2011-10-16,4,19,0,0,1,52,181,233,winter
2011-10-16,4,20,0,0,1,49,129,178,winter
2011-10-16,4,21,0,0,1,14,88,102,winter
2011-10-16,4,22,0,0,1,42,88,130,winter
2011-10-16,4,23,0,0,1,14,48,62,winter
2011-10-17,4,0,0,1,1,12,25,37,winter
2011-10-17,4,1,0,1,1,2,15,17,winter
2011-10-17,4,2,0,1,1,4,3,7,winter
2011-10-17,4,3,0,1,1,0,2,2,winter
2011-10-17,4,4,0,1,1,2,3,5,winter
2011-10-17,4,5,0,1,1,1,28,29,winter
2011-10-17,4,6,0,1,1,7,107,114,winter
2011-10-17,4,7,0,1,2,10,299,309,winter
2011-10-17,4,8,0,1,2,33,381,414,winter
2011-10-17,4,9,0,1,2,26,180,206,winter
2011-10-17,4,10,0,1,1,43,92,135,winter
2011-10-17,4,11,0,1,1,35,131,166,winter
2011-10-17,4,12,0,1,1,39,166,205,winter
2011-10-17,4,13,0,1,1,49,156,205,winter
2011-10-17,4,14,0,1,1,44,122,166,winter
2011-10-17,4,15,0,1,1,66,142,208,winter
2011-10-17,4,16,0,1,1,64,238,302,winter
2011-10-17,4,17,0,1,1,80,540,620,winter
2011-10-17,4,18,0,1,1,49,469,518,winter
2011-10-17,4,19,0,1,1,45,288,333,winter
2011-10-17,4,20,0,1,1,40,189,229,winter
2011-10-17,4,21,0,1,1,36,141,177,winter
2011-10-17,4,22,0,1,1,16,88,104,winter
2011-10-17,4,23,0,1,2,10,52,62,winter
2011-10-18,4,0,0,1,1,8,23,31,winter
2011-10-18,4,1,0,1,2,4,7,11,winter
2011-10-18,4,2,0,1,1,1,4,5,winter
2011-10-18,4,3,0,1,1,0,1,1,winter
2011-10-18,4,4,0,1,2,0,4,4,winter
2011-10-18,4,5,0,1,2,2,19,21,winter
2011-10-18,4,6,0,1,1,4,105,109,winter
2011-10-18,4,7,0,1,1,15,326,341,winter
2011-10-18,4,8,0,1,1,25,474,499,winter
2011-10-18,4,9,0,1,2,29,198,227,winter
2011-10-18,4,10,0,1,2,27,75,102,winter
2011-10-18,4,11,0,1,2,35,112,147,winter
2011-10-18,4,12,0,1,2,42,159,201,winter
2011-10-18,4,13,0,1,2,48,171,219,winter
2011-10-18,4,14,0,1,2,32,137,169,winter
2011-10-18,4,15,0,1,1,66,139,205,winter
2011-10-18,4,16,0,1,1,58,246,304,winter
2011-10-18,4,17,0,1,1,72,553,625,winter
2011-10-18,4,18,0,1,1,58,512,570,winter
2011-10-18,4,19,0,1,1,31,286,317,winter
2011-10-18,4,20,0,1,1,23,204,227,winter
2011-10-18,4,21,0,1,2,28,178,206,winter
2011-10-18,4,22,0,1,2,22,115,137,winter
2011-10-18,4,23,0,1,2,7,63,70,winter
2011-10-19,4,0,0,1,2,11,23,34,winter
2011-10-19,4,1,0,1,2,7,9,16,winter
2011-10-19,4,2,0,1,2,1,6,7,winter
2011-10-19,4,4,0,1,3,0,3,3,winter
2011-10-19,4,5,0,1,3,0,3,3,winter
2011-10-19,4,6,0,1,3,3,28,31,winter
2011-10-19,4,7,0,1,3,1,67,68,winter
2011-10-19,4,8,0,1,3,10,200,210,winter
2011-10-19,4,9,0,1,3,17,185,202,winter
2011-10-19,4,10,0,1,3,14,109,123,winter
2011-10-19,4,11,0,1,3,33,116,149,winter
2011-10-19,4,12,0,1,3,13,117,130,winter
2011-10-19,4,13,0,1,2,20,86,106,winter
2011-10-19,4,14,0,1,3,17,80,97,winter
2011-10-19,4,15,0,1,3,21,99,120,winter
2011-10-19,4,16,0,1,3,21,180,201,winter
2011-10-19,4,17,0,1,3,11,170,181,winter
2011-10-19,4,18,0,1,3,8,132,140,winter
2011-10-19,4,19,0,1,2,8,189,197,winter
2011-10-19,4,20,0,1,3,5,140,145,winter
2011-10-19,4,21,0,1,2,6,79,85,winter
2011-10-19,4,22,0,1,2,13,94,107,winter
2011-10-19,4,23,0,1,2,14,55,69,winter
2011-10-20,4,0,0,1,1,4,22,26,winter
2011-10-20,4,1,0,1,1,4,11,15,winter
2011-10-20,4,2,0,1,1,0,4,4,winter
2011-10-20,4,3,0,1,1,0,1,1,winter
2011-10-20,4,4,0,1,1,2,6,8,winter
2011-10-20,4,5,0,1,1,2,24,26,winter
2011-10-20,4,6,0,1,1,5,87,92,winter
2011-10-20,4,7,0,1,1,15,303,318,winter
2011-10-20,4,8,0,1,1,17,409,426,winter
2011-10-20,4,9,0,1,1,26,197,223,winter
2011-10-20,4,10,0,1,1,25,105,130,winter
2011-10-20,4,11,0,1,1,30,99,129,winter
2011-10-20,4,12,0,1,1,28,171,199,winter
2011-10-20,4,13,0,1,1,28,136,164,winter
2011-10-20,4,14,0,1,2,38,117,155,winter
2011-10-20,4,15,0,1,2,22,138,160,winter
2011-10-20,4,16,0,1,2,31,203,234,winter
2011-10-20,4,17,0,1,2,56,438,494,winter
2011-10-20,4,18,0,1,2,39,430,469,winter
2011-10-20,4,19,0,1,1,20,278,298,winter
2011-10-20,4,20,0,1,2,34,207,241,winter
2011-10-20,4,21,0,1,1,16,149,165,winter
2011-10-20,4,22,0,1,1,22,106,128,winter
2011-10-20,4,23,0,1,1,7,83,90,winter
2011-10-21,4,0,0,1,1,8,42,50,winter
2011-10-21,4,1,0,1,1,7,19,26,winter
2011-10-21,4,2,0,1,1,6,12,18,winter
2011-10-21,4,3,0,1,1,0,7,7,winter
2011-10-21,4,4,0,1,1,0,6,6,winter
2011-10-21,4,5,0,1,1,0,31,31,winter
2011-10-21,4,6,0,1,1,7,78,85,winter
2011-10-21,4,7,0,1,1,5,228,233,winter
2011-10-21,4,8,0,1,1,16,386,402,winter
2011-10-21,4,9,0,1,2,33,189,222,winter
2011-10-21,4,10,0,1,1,32,106,138,winter
2011-10-21,4,11,0,1,1,39,135,174,winter
2011-10-21,4,12,0,1,1,47,193,240,winter
2011-10-21,4,13,0,1,1,43,163,206,winter
2011-10-21,4,14,0,1,1,67,131,198,winter
2011-10-21,4,15,0,1,1,57,178,235,winter
2011-10-21,4,16,0,1,1,60,242,302,winter
2011-10-21,4,17,0,1,2,79,445,524,winter
2011-10-21,4,18,0,1,2,43,354,397,winter
2011-10-21,4,19,0,1,2,25,228,253,winter
2011-10-21,4,20,0,1,2,29,155,184,winter
2011-10-21,4,21,0,1,1,31,112,143,winter
2011-10-21,4,22,0,1,1,24,89,113,winter
2011-10-21,4,23,0,1,1,18,99,117,winter
2011-10-22,4,0,0,0,1,16,80,96,winter
2011-10-22,4,1,0,0,1,20,50,70,winter
2011-10-22,4,2,0,0,1,6,25,31,winter
2011-10-22,4,3,0,0,1,1,19,20,winter
2011-10-22,4,4,0,0,1,4,4,8,winter
2011-10-22,4,5,0,0,1,1,7,8,winter
2011-10-22,4,6,0,0,1,1,17,18,winter
2011-10-22,4,7,0,0,1,8,49,57,winter
2011-10-22,4,8,0,0,1,26,88,114,winter
2011-10-22,4,9,0,0,1,47,122,169,winter
2011-10-22,4,10,0,0,2,87,149,236,winter
2011-10-22,4,11,0,0,2,110,172,282,winter
2011-10-22,4,12,0,0,1,132,211,343,winter
2011-10-22,4,13,0,0,1,136,186,322,winter
2011-10-22,4,14,0,0,2,133,177,310,winter
2011-10-22,4,15,0,0,1,159,223,382,winter
2011-10-22,4,16,0,0,1,169,190,359,winter
2011-10-22,4,17,0,0,1,143,217,360,winter
2011-10-22,4,18,0,0,1,111,224,335,winter
2011-10-22,4,19,0,0,1,47,173,220,winter
2011-10-22,4,20,0,0,1,48,111,159,winter
2011-10-22,4,21,0,0,1,37,120,157,winter
2011-10-22,4,22,0,0,1,30,114,144,winter
2011-10-22,4,23,0,0,1,27,81,108,winter
2011-10-23,4,0,0,0,1,24,64,88,winter
2011-10-23,4,1,0,0,1,11,60,71,winter
2011-10-23,4,2,0,0,1,10,40,50,winter
2011-10-23,4,3,0,0,1,15,31,46,winter
2011-10-23,4,4,0,0,1,5,1,6,winter
2011-10-23,4,5,0,0,1,1,2,3,winter
2011-10-23,4,6,0,0,1,0,12,12,winter
2011-10-23,4,7,0,0,1,3,18,21,winter
2011-10-23,4,8,0,0,1,32,56,88,winter
2011-10-23,4,9,0,0,1,48,95,143,winter
2011-10-23,4,10,0,0,1,104,185,289,winter
2011-10-23,4,11,0,0,1,131,202,333,winter
2011-10-23,4,12,0,0,1,164,249,413,winter
2011-10-23,4,13,0,0,1,160,255,415,winter
2011-10-23,4,14,0,0,1,192,216,408,winter
2011-10-23,4,15,0,0,1,171,216,387,winter
2011-10-23,4,16,0,0,1,188,217,405,winter
2011-10-23,4,17,0,0,1,120,220,340,winter
2011-10-23,4,18,0,0,1,88,196,284,winter
2011-10-23,4,19,0,0,1,53,140,193,winter
2011-10-23,4,20,0,0,1,32,112,144,winter
2011-10-23,4,21,0,0,1,24,75,99,winter
2011-10-23,4,22,0,0,1,25,69,94,winter
2011-10-23,4,23,0,0,1,18,31,49,winter
2011-10-24,4,0,0,1,1,6,26,32,winter
2011-10-24,4,1,0,1,1,7,8,15,winter
2011-10-24,4,2,0,1,1,1,6,7,winter
2011-10-24,4,3,0,1,1,1,3,4,winter
2011-10-24,4,4,0,1,1,1,5,6,winter
2011-10-24,4,5,0,1,1,2,19,21,winter
2011-10-24,4,6,0,1,1,3,83,86,winter
2011-10-24,4,7,0,1,2,11,274,285,winter
2011-10-24,4,8,0,1,2,20,378,398,winter
2011-10-24,4,9,0,1,2,29,166,195,winter
2011-10-24,4,10,0,1,2,47,82,129,winter
2011-10-24,4,11,0,1,2,59,109,168,winter
2011-10-24,4,12,0,1,2,64,156,220,winter
2011-10-24,4,13,0,1,2,60,138,198,winter
2011-10-24,4,14,0,1,2,63,143,206,winter
2011-10-24,4,15,0,1,1,52,125,177,winter
2011-10-24,4,16,0,1,1,68,242,310,winter
2011-10-24,4,17,0,1,1,87,527,614,winter
2011-10-24,4,18,0,1,1,58,428,486,winter
2011-10-24,4,19,0,1,3,25,212,237,winter
2011-10-24,4,20,0,1,1,11,118,129,winter
2011-10-24,4,21,0,1,1,12,114,126,winter
2011-10-24,4,22,0,1,1,3,76,79,winter
2011-10-24,4,23,0,1,1,9,50,59,winter
2011-10-25,4,0,0,1,1,4,26,30,winter
2011-10-25,4,1,0,1,1,5,6,11,winter
2011-10-25,4,2,0,1,1,2,3,5,winter
2011-10-25,4,3,0,1,1,1,3,4,winter
2011-10-25,4,4,0,1,1,0,5,5,winter
2011-10-25,4,5,0,1,1,0,24,24,winter
2011-10-25,4,6,0,1,1,3,95,98,winter
2011-10-25,4,7,0,1,1,15,299,314,winter
2011-10-25,4,8,0,1,1,25,383,408,winter
2011-10-25,4,9,0,1,1,29,194,223,winter
2011-10-25,4,10,0,1,1,26,102,128,winter
2011-10-25,4,11,0,1,1,46,120,166,winter
2011-10-25,4,12,0,1,1,35,165,200,winter
2011-10-25,4,13,0,1,1,37,161,198,winter
2011-10-25,4,14,0,1,1,66,134,200,winter
2011-10-25,4,15,0,1,1,63,171,234,winter
2011-10-25,4,16,0,1,1,52,233,285,winter
2011-10-25,4,17,0,1,1,68,517,585,winter
2011-10-25,4,18,0,1,1,65,453,518,winter
2011-10-25,4,19,0,1,1,44,294,338,winter
2011-10-25,4,20,0,1,1,40,208,248,winter
2011-10-25,4,21,0,1,1,32,169,201,winter
2011-10-25,4,22,0,1,1,22,148,170,winter
2011-10-25,4,23,0,1,1,15,79,94,winter
2011-10-26,4,0,0,1,1,4,28,32,winter
2011-10-26,4,1,0,1,1,3,9,12,winter
2011-10-26,4,2,0,1,1,2,1,3,winter
2011-10-26,4,3,0,1,1,0,3,3,winter
2011-10-26,4,4,0,1,1,0,5,5,winter
2011-10-26,4,5,0,1,1,0,21,21,winter
2011-10-26,4,6,0,1,1,0,92,92,winter
2011-10-26,4,7,0,1,1,15,284,299,winter
2011-10-26,4,8,0,1,2,26,438,464,winter
2011-10-26,4,9,0,1,2,14,226,240,winter
2011-10-26,4,10,0,1,2,26,105,131,winter
2011-10-26,4,11,0,1,1,23,132,155,winter
2011-10-26,4,12,0,1,3,39,155,194,winter
2011-10-26,4,13,0,1,3,20,62,82,winter
2011-10-26,4,14,0,1,2,14,52,66,winter
2011-10-26,4,15,0,1,2,11,59,70,winter
2011-10-26,4,16,0,1,2,17,196,213,winter
2011-10-26,4,17,0,1,2,40,414,454,winter
2011-10-26,4,18,0,1,1,55,398,453,winter
2011-10-26,4,19,0,1,1,25,306,331,winter
2011-10-26,4,20,0,1,1,27,180,207,winter
2011-10-26,4,21,0,1,2,17,140,157,winter
2011-10-26,4,22,0,1,2,23,112,135,winter
2011-10-26,4,23,0,1,2,3,72,75,winter
2011-10-27,4,0,0,1,1,3,23,26,winter
2011-10-27,4,1,0,1,1,2,9,11,winter
2011-10-27,4,2,0,1,3,3,5,8,winter
2011-10-27,4,3,0,1,3,1,3,4,winter
2011-10-27,4,4,0,1,3,1,3,4,winter
2011-10-27,4,5,0,1,3,1,14,15,winter
2011-10-27,4,6,0,1,3,4,42,46,winter
2011-10-27,4,7,0,1,2,9,128,137,winter
2011-10-27,4,8,0,1,3,12,304,316,winter
2011-10-27,4,9,0,1,2,16,155,171,winter
2011-10-27,4,10,0,1,3,10,52,62,winter
2011-10-27,4,11,0,1,3,8,44,52,winter
2011-10-27,4,12,0,1,3,8,45,53,winter
2011-10-27,4,13,0,1,2,10,64,74,winter
2011-10-27,4,14,0,1,2,16,76,92,winter
2011-10-27,4,15,0,1,2,12,95,107,winter
2011-10-27,4,16,0,1,2,14,193,207,winter
2011-10-27,4,17,0,1,2,31,291,322,winter
2011-10-27,4,18,0,1,2,14,226,240,winter
2011-10-27,4,19,0,1,2,19,200,219,winter
2011-10-27,4,20,0,1,1,11,171,182,winter
2011-10-27,4,21,0,1,1,13,119,132,winter
2011-10-27,4,22,0,1,1,14,97,111,winter
2011-10-27,4,23,0,1,1,8,60,68,winter
2011-10-28,4,0,0,1,1,4,40,44,winter
2011-10-28,4,1,0,1,1,7,9,16,winter
2011-10-28,4,2,0,1,1,1,3,4,winter
2011-10-28,4,3,0,1,1,4,4,8,winter
2011-10-28,4,4,0,1,1,5,5,10,winter
2011-10-28,4,5,0,1,2,0,25,25,winter
2011-10-28,4,6,0,1,1,1,74,75,winter
2011-10-28,4,7,0,1,1,6,199,205,winter
2011-10-28,4,8,0,1,1,13,361,374,winter
2011-10-28,4,9,0,1,1,19,210,229,winter
2011-10-28,4,10,0,1,1,28,102,130,winter
2011-10-28,4,11,0,1,1,40,128,168,winter
2011-10-28,4,12,0,1,2,46,167,213,winter
2011-10-28,4,13,0,1,2,43,185,228,winter
2011-10-28,4,14,0,1,2,33,152,185,winter
2011-10-28,4,15,0,1,2,44,171,215,winter
2011-10-28,4,16,0,1,2,46,262,308,winter
2011-10-28,4,17,0,1,2,35,411,446,winter
2011-10-28,4,18,0,1,2,36,332,368,winter
2011-10-28,4,19,0,1,2,16,188,204,winter
2011-10-28,4,20,0,1,3,12,131,143,winter
2011-10-28,4,21,0,1,3,5,69,74,winter
2011-10-28,4,22,0,1,3,4,32,36,winter
2011-10-28,4,23,0,1,3,8,31,39,winter
2011-10-29,4,0,0,0,3,0,19,19,winter
2011-10-29,4,1,0,0,3,0,18,18,winter
2011-10-29,4,2,0,0,3,1,16,17,winter
2011-10-29,4,3,0,0,3,0,8,8,winter
2011-10-29,4,4,0,0,3,0,1,1,winter
2011-10-29,4,5,0,0,3,0,1,1,winter
2011-10-29,4,6,0,0,3,4,1,5,winter
2011-10-29,4,7,0,0,3,1,6,7,winter
2011-10-29,4,8,0,0,3,4,16,20,winter
2011-10-29,4,9,0,0,3,1,19,20,winter
2011-10-29,4,10,0,0,3,0,12,12,winter
2011-10-29,4,11,0,0,3,1,26,27,winter
2011-10-29,4,12,0,0,3,6,44,50,winter
2011-10-29,4,13,0,0,3,0,30,30,winter
2011-10-29,4,14,0,0,3,0,29,29,winter
2011-10-29,4,15,0,0,3,3,38,41,winter
2011-10-29,4,16,0,0,3,3,19,22,winter
2011-10-29,4,17,0,0,3,3,28,31,winter
2011-10-29,4,18,0,0,3,6,37,43,winter
2011-10-29,4,19,0,0,1,3,36,39,winter
2011-10-29,4,20,0,0,1,7,40,47,winter
2011-10-29,4,21,0,0,1,1,49,50,winter
2011-10-29,4,22,0,0,1,10,44,54,winter
2011-10-29,4,23,0,0,1,3,33,36,winter
2011-10-30,4,0,0,0,1,7,47,54,winter
2011-10-30,4,1,0,0,1,9,34,43,winter
2011-10-30,4,2,0,0,1,7,43,50,winter
2011-10-30,4,3,0,0,1,7,26,33,winter
2011-10-30,4,4,0,0,1,1,10,11,winter
2011-10-30,4,5,0,0,1,0,4,4,winter
2011-10-30,4,6,0,0,1,2,8,10,winter
2011-10-30,4,7,0,0,1,7,15,22,winter
2011-10-30,4,8,0,0,1,20,60,80,winter
2011-10-30,4,9,0,0,1,55,92,147,winter
2011-10-30,4,10,0,0,1,53,125,178,winter
2011-10-30,4,11,0,0,1,58,182,240,winter
2011-10-30,4,12,0,0,1,85,229,314,winter
2011-10-30,4,13,0,0,1,113,232,345,winter
2011-10-30,4,14,0,0,1,91,209,300,winter
2011-10-30,4,15,0,0,1,88,202,290,winter
2011-10-30,4,16,0,0,1,107,213,320,winter
2011-10-30,4,17,0,0,1,54,191,245,winter
2011-10-30,4,18,0,0,1,51,162,213,winter
2011-10-30,4,19,0,0,1,28,125,153,winter
2011-10-30,4,20,0,0,1,18,74,92,winter
2011-10-30,4,21,0,0,1,4,75,79,winter
2011-10-30,4,22,0,0,1,13,58,71,winter
2011-10-30,4,23,0,0,1,7,30,37,winter
2011-10-31,4,0,0,1,1,3,20,23,winter
2011-10-31,4,1,0,1,1,5,8,13,winter
2011-10-31,4,2,0,1,1,0,3,3,winter
2011-10-31,4,3,0,1,1,0,3,3,winter
2011-10-31,4,4,0,1,1,1,5,6,winter
2011-10-31,4,5,0,1,1,0,18,18,winter
2011-10-31,4,6,0,1,1,4,82,86,winter
2011-10-31,4,7,0,1,1,11,216,227,winter
2011-10-31,4,8,0,1,2,17,355,372,winter
2011-10-31,4,9,0,1,2,14,197,211,winter
2011-10-31,4,10,0,1,2,18,87,105,winter
2011-10-31,4,11,0,1,1,31,97,128,winter
2011-10-31,4,12,0,1,1,30,140,170,winter
2011-10-31,4,13,0,1,2,24,128,152,winter
2011-10-31,4,14,0,1,2,22,119,141,winter
2011-10-31,4,15,0,1,1,27,141,168,winter
2011-10-31,4,16,0,1,1,30,242,272,winter
2011-10-31,4,17,0,1,1,44,442,486,winter
2011-10-31,4,18,0,1,1,30,392,422,winter
2011-10-31,4,19,0,1,1,12,226,238,winter
2011-10-31,4,20,0,1,1,18,154,172,winter
2011-10-31,4,21,0,1,2,7,109,116,winter
2011-10-31,4,22,0,1,2,8,77,85,winter
2011-10-31,4,23,0,1,2,6,46,52,winter
2011-11-01,4,0,0,1,2,3,18,21,winter
2011-11-01,4,1,0,1,1,3,8,11,winter
2011-11-01,4,2,0,1,2,1,3,4,winter
2011-11-01,4,3,0,1,2,1,5,6,winter
2011-11-01,4,4,0,1,1,1,7,8,winter
2011-11-01,4,5,0,1,1,0,18,18,winter
2011-11-01,4,6,0,1,1,3,90,93,winter
2011-11-01,4,7,0,1,1,8,246,254,winter
2011-11-01,4,8,0,1,1,17,402,419,winter
2011-11-01,4,9,0,1,1,16,206,222,winter
2011-11-01,4,10,0,1,1,21,114,135,winter
2011-11-01,4,11,0,1,1,16,101,117,winter
2011-11-01,4,12,0,1,1,23,153,176,winter
2011-11-01,4,13,0,1,1,20,147,167,winter
2011-11-01,4,14,0,1,1,32,118,150,winter
2011-11-01,4,15,0,1,1,38,148,186,winter
2011-11-01,4,16,0,1,1,46,252,298,winter
2011-11-01,4,17,0,1,1,36,470,506,winter
2011-11-01,4,18,0,1,1,39,421,460,winter
2011-11-01,4,19,0,1,1,39,274,313,winter
2011-11-01,4,20,0,1,1,18,191,209,winter
2011-11-01,4,21,0,1,1,13,114,127,winter
2011-11-01,4,22,0,1,1,5,91,96,winter
2011-11-01,4,23,0,1,1,11,61,72,winter
2011-11-02,4,0,0,1,1,0,19,19,winter
2011-11-02,4,1,0,1,1,2,8,10,winter
2011-11-02,4,2,0,1,1,0,2,2,winter
2011-11-02,4,3,0,1,1,0,2,2,winter
2011-11-02,4,4,0,1,1,0,4,4,winter
2011-11-02,4,5,0,1,1,0,27,27,winter
2011-11-02,4,6,0,1,1,1,91,92,winter
2011-11-02,4,7,0,1,1,11,240,251,winter
2011-11-02,4,8,0,1,1,20,452,472,winter
2011-11-02,4,9,0,1,1,15,213,228,winter
2011-11-02,4,10,0,1,1,25,108,133,winter
2011-11-02,4,11,0,1,1,27,117,144,winter
2011-11-02,4,12,0,1,1,32,157,189,winter
2011-11-02,4,13,0,1,1,22,139,161,winter
2011-11-02,4,14,0,1,1,40,132,172,winter
2011-11-02,4,15,0,1,1,26,161,187,winter
2011-11-02,4,16,0,1,1,35,231,266,winter
2011-11-02,4,17,0,1,1,30,523,553,winter
2011-11-02,4,18,0,1,1,31,448,479,winter
2011-11-02,4,19,0,1,1,25,257,282,winter
2011-11-02,4,20,0,1,1,5,177,182,winter
2011-11-02,4,21,0,1,1,13,155,168,winter
2011-11-02,4,22,0,1,1,7,99,106,winter
2011-11-02,4,23,0,1,1,3,54,57,winter
2011-11-03,4,0,0,1,1,3,28,31,winter
2011-11-03,4,1,0,1,1,3,12,15,winter
2011-11-03,4,2,0,1,1,2,5,7,winter
2011-11-03,4,3,0,1,1,1,4,5,winter
2011-11-03,4,4,0,1,1,1,3,4,winter
2011-11-03,4,5,0,1,1,1,27,28,winter
2011-11-03,4,6,0,1,1,3,96,99,winter
2011-11-03,4,7,0,1,2,12,280,292,winter
2011-11-03,4,8,0,1,2,8,394,402,winter
2011-11-03,4,9,0,1,2,9,155,164,winter
2011-11-03,4,10,0,1,2,12,98,110,winter
2011-11-03,4,11,0,1,1,12,108,120,winter
2011-11-03,4,12,0,1,1,17,162,179,winter
2011-11-03,4,13,0,1,2,19,150,169,winter
2011-11-03,4,14,0,1,1,32,120,152,winter
2011-11-03,4,15,0,1,1,24,138,162,winter
2011-11-03,4,16,0,1,1,33,234,267,winter
2011-11-03,4,17,0,1,1,33,465,498,winter
2011-11-03,4,18,0,1,1,24,409,433,winter
2011-11-03,4,19,0,1,1,18,234,252,winter
2011-11-03,4,20,0,1,1,11,198,209,winter
2011-11-03,4,21,0,1,1,4,140,144,winter
2011-11-03,4,22,0,1,1,21,116,137,winter
2011-11-03,4,23,0,1,1,15,80,95,winter
2011-11-04,4,0,0,1,2,11,32,43,winter
2011-11-04,4,1,0,1,2,1,16,17,winter
2011-11-04,4,2,0,1,2,2,8,10,winter
2011-11-04,4,3,0,1,2,1,7,8,winter
2011-11-04,4,4,0,1,2,1,6,7,winter
2011-11-04,4,5,0,1,2,0,23,23,winter
2011-11-04,4,6,0,1,2,2,64,66,winter
2011-11-04,4,7,0,1,2,10,235,245,winter
2011-11-04,4,8,0,1,2,8,387,395,winter
2011-11-04,4,9,0,1,2,15,239,254,winter
2011-11-04,4,10,0,1,2,19,115,134,winter
2011-11-04,4,11,0,1,2,34,128,162,winter
2011-11-04,4,12,0,1,2,44,153,197,winter
2011-11-04,4,13,0,1,1,33,161,194,winter
2011-11-04,4,14,0,1,1,54,147,201,winter
2011-11-04,4,15,0,1,1,45,192,237,winter
2011-11-04,4,16,0,1,1,53,237,290,winter
2011-11-04,4,17,0,1,1,42,438,480,winter
2011-11-04,4,18,0,1,1,35,339,374,winter
2011-11-04,4,19,0,1,1,14,182,196,winter
2011-11-04,4,20,0,1,1,15,171,186,winter
2011-11-04,4,21,0,1,1,8,115,123,winter
2011-11-04,4,22,0,1,1,6,109,115,winter
2011-11-04,4,23,0,1,1,17,72,89,winter
2011-11-05,4,0,0,0,1,4,48,52,winter
2011-11-05,4,1,0,0,1,5,57,62,winter
2011-11-05,4,2,0,0,1,7,24,31,winter
2011-11-05,4,3,0,0,1,0,8,8,winter
2011-11-05,4,4,0,0,1,3,5,8,winter
2011-11-05,4,5,0,0,1,0,2,2,winter
2011-11-05,4,6,0,0,1,3,20,23,winter
2011-11-05,4,7,0,0,1,3,31,34,winter
2011-11-05,4,8,0,0,1,4,80,84,winter
2011-11-05,4,9,0,0,1,30,111,141,winter
2011-11-05,4,10,0,0,1,56,171,227,winter
2011-11-05,4,11,0,0,1,69,169,238,winter
2011-11-05,4,12,0,0,1,137,235,372,winter
2011-11-05,4,13,0,0,1,148,207,355,winter
2011-11-05,4,14,0,0,1,159,227,386,winter
2011-11-05,4,15,0,0,1,141,202,343,winter
2011-11-05,4,16,0,0,1,128,207,335,winter
2011-11-05,4,17,0,0,1,100,234,334,winter
2011-11-05,4,18,0,0,1,52,185,237,winter
2011-11-05,4,19,0,0,1,45,159,204,winter
2011-11-05,4,20,0,0,1,29,136,165,winter
2011-11-05,4,21,0,0,1,19,99,118,winter
2011-11-05,4,22,0,0,1,10,72,82,winter
2011-11-05,4,23,0,0,1,4,81,85,winter
2011-11-06,4,0,0,0,1,10,65,75,winter
2011-11-06,4,1,0,0,1,11,104,115,winter
2011-11-06,4,2,0,0,1,6,23,29,winter
2011-11-06,4,3,0,0,1,5,4,9,winter
2011-11-06,4,4,0,0,1,0,6,6,winter
2011-11-06,4,5,0,0,1,0,5,5,winter
2011-11-06,4,6,0,0,1,5,11,16,winter
2011-11-06,4,7,0,0,1,4,24,28,winter
2011-11-06,4,8,0,0,2,19,71,90,winter
2011-11-06,4,9,0,0,2,36,134,170,winter
2011-11-06,4,10,0,0,1,76,186,262,winter
2011-11-06,4,11,0,0,1,104,216,320,winter
2011-11-06,4,12,0,0,1,120,226,346,winter
2011-11-06,4,13,0,0,1,105,209,314,winter
2011-11-06,4,14,0,0,1,101,219,320,winter
2011-11-06,4,15,0,0,1,96,210,306,winter
2011-11-06,4,16,0,0,1,84,263,347,winter
2011-11-06,4,17,0,0,1,71,185,256,winter
2011-11-06,4,18,0,0,1,39,146,185,winter
2011-11-06,4,19,0,0,1,21,130,151,winter
2011-11-06,4,20,0,0,1,16,100,116,winter
2011-11-06,4,21,0,0,1,11,77,88,winter
2011-11-06,4,22,0,0,1,5,40,45,winter
2011-11-06,4,23,0,0,1,7,43,50,winter
2011-11-07,4,0,0,1,1,1,14,15,winter
2011-11-07,4,1,0,1,1,2,6,8,winter
2011-11-07,4,2,0,1,1,0,2,2,winter
2011-11-07,4,3,0,1,1,0,3,3,winter
2011-11-07,4,4,0,1,1,2,4,6,winter
2011-11-07,4,5,0,1,1,1,25,26,winter
2011-11-07,4,6,0,1,2,2,97,99,winter
2011-11-07,4,7,0,1,2,6,305,311,winter
2011-11-07,4,8,0,1,2,13,397,410,winter
2011-11-07,4,9,0,1,2,18,156,174,winter
2011-11-07,4,10,0,1,1,28,95,123,winter
2011-11-07,4,11,0,1,1,28,100,128,winter
2011-11-07,4,12,0,1,1,21,158,179,winter
2011-11-07,4,13,0,1,1,32,157,189,winter
2011-11-07,4,14,0,1,1,30,115,145,winter
2011-11-07,4,15,0,1,1,38,132,170,winter
2011-11-07,4,16,0,1,1,40,255,295,winter
2011-11-07,4,17,0,1,1,39,489,528,winter
2011-11-07,4,18,0,1,1,18,407,425,winter
2011-11-07,4,19,0,1,1,20,280,300,winter
2011-11-07,4,20,0,1,1,17,187,204,winter
2011-11-07,4,21,0,1,1,10,129,139,winter
2011-11-07,4,22,0,1,1,6,102,108,winter
2011-11-07,4,23,0,1,1,1,47,48,winter
2011-11-08,4,0,0,1,1,0,18,18,winter
2011-11-08,4,1,0,1,1,3,8,11,winter
2011-11-08,4,2,0,1,1,0,1,1,winter
2011-11-08,4,3,0,1,1,0,3,3,winter
2011-11-08,4,4,0,1,1,0,4,4,winter
2011-11-08,4,5,0,1,1,1,17,18,winter
2011-11-08,4,6,0,1,1,3,96,99,winter
2011-11-08,4,7,0,1,1,7,316,323,winter
2011-11-08,4,8,0,1,1,11,455,466,winter
2011-11-08,4,9,0,1,1,14,177,191,winter
2011-11-08,4,10,0,1,1,25,104,129,winter
2011-11-08,4,11,0,1,1,21,126,147,winter
2011-11-08,4,12,0,1,1,28,175,203,winter
2011-11-08,4,13,0,1,1,31,165,196,winter
2011-11-08,4,14,0,1,1,32,129,161,winter
2011-11-08,4,15,0,1,1,33,155,188,winter
2011-11-08,4,16,0,1,1,39,250,289,winter
2011-11-08,4,17,0,1,1,40,459,499,winter
2011-11-08,4,18,0,1,1,30,432,462,winter
2011-11-08,4,19,0,1,1,14,264,278,winter
2011-11-08,4,20,0,1,1,12,169,181,winter
2011-11-08,4,21,0,1,1,16,166,182,winter
2011-11-08,4,22,0,1,1,13,95,108,winter
2011-11-08,4,23,0,1,1,3,45,48,winter
2011-11-09,4,0,0,1,1,0,13,13,winter
2011-11-09,4,1,0,1,1,0,10,10,winter
2011-11-09,4,2,0,1,1,0,5,5,winter
2011-11-09,4,3,0,1,1,0,4,4,winter
2011-11-09,4,4,0,1,1,0,4,4,winter
2011-11-09,4,5,0,1,1,0,28,28,winter
2011-11-09,4,6,0,1,1,0,98,98,winter
2011-11-09,4,7,0,1,1,0,300,300,winter
2011-11-09,4,8,0,1,1,19,437,456,winter
2011-11-09,4,9,0,1,1,22,197,219,winter
2011-11-09,4,10,0,1,1,16,89,105,winter
2011-11-09,4,11,0,1,1,21,131,152,winter
2011-11-09,4,12,0,1,1,24,156,180,winter
2011-11-09,4,13,0,1,1,31,136,167,winter
2011-11-09,4,14,0,1,1,26,153,179,winter
2011-11-09,4,15,0,1,1,21,130,151,winter
2011-11-09,4,16,0,1,1,24,257,281,winter
2011-11-09,4,17,0,1,1,27,458,485,winter
2011-11-09,4,18,0,1,1,21,387,408,winter
2011-11-09,4,19,0,1,1,12,292,304,winter
2011-11-09,4,20,0,1,1,18,201,219,winter
2011-11-09,4,21,0,1,1,9,152,161,winter
2011-11-09,4,22,0,1,1,9,105,114,winter
2011-11-09,4,23,0,1,1,5,61,66,winter
2011-11-10,4,0,0,1,1,0,24,24,winter
2011-11-10,4,1,0,1,2,1,10,11,winter
2011-11-10,4,2,0,1,2,0,5,5,winter
2011-11-10,4,3,0,1,1,0,11,11,winter
2011-11-10,4,4,0,1,1,1,2,3,winter
2011-11-10,4,5,0,1,2,1,22,23,winter
2011-11-10,4,6,0,1,2,4,110,114,winter
2011-11-10,4,7,0,1,2,6,266,272,winter
2011-11-10,4,8,0,1,2,18,418,436,winter
2011-11-10,4,9,0,1,2,23,188,211,winter
2011-11-10,4,10,0,1,2,17,100,117,winter
2011-11-10,4,11,0,1,2,9,99,108,winter
2011-11-10,4,12,0,1,2,18,149,167,winter
2011-11-10,4,13,0,1,3,9,87,96,winter
2011-11-10,4,14,0,1,3,6,58,64,winter
2011-11-10,4,15,0,1,3,5,57,62,winter
2011-11-10,4,16,0,1,3,6,67,73,winter
2011-11-10,4,17,0,1,3,9,168,177,winter
2011-11-10,4,18,0,1,2,10,263,273,winter
2011-11-10,4,19,0,1,2,19,192,211,winter
2011-11-10,4,20,0,1,2,8,160,168,winter
2011-11-10,4,21,0,1,1,6,130,136,winter
2011-11-10,4,22,0,1,1,5,84,89,winter
2011-11-10,4,23,0,1,2,9,73,82,winter
2011-11-11,4,0,1,0,1,10,56,66,winter
2011-11-11,4,1,1,0,1,3,16,19,winter
2011-11-11,4,2,1,0,1,1,10,11,winter
2011-11-11,4,3,1,0,1,0,6,6,winter
2011-11-11,4,4,1,0,1,0,8,8,winter
2011-11-11,4,5,1,0,1,0,13,13,winter
2011-11-11,4,6,1,0,1,0,46,46,winter
2011-11-11,4,7,1,0,1,5,116,121,winter
2011-11-11,4,8,1,0,1,9,249,258,winter
2011-11-11,4,9,1,0,1,15,186,201,winter
2011-11-11,4,10,1,0,1,38,162,200,winter
2011-11-11,4,11,1,0,1,20,150,170,winter
2011-11-11,4,12,1,0,1,41,198,239,winter
2011-11-11,4,13,1,0,1,57,179,236,winter
2011-11-11,4,14,1,0,1,64,183,247,winter
2011-11-11,4,15,1,0,1,29,187,216,winter
2011-11-11,4,16,1,0,1,49,189,238,winter
2011-11-11,4,17,1,0,1,24,286,310,winter
2011-11-11,4,18,1,0,1,23,185,208,winter
2011-11-11,4,19,1,0,1,17,182,199,winter
2011-11-11,4,20,1,0,1,12,97,109,winter
2011-11-11,4,21,1,0,1,4,79,83,winter
2011-11-11,4,22,1,0,1,13,78,91,winter
2011-11-11,4,23,1,0,1,6,67,73,winter
2011-11-12,4,0,0,0,1,12,52,64,winter
2011-11-12,4,1,0,0,1,9,45,54,winter
2011-11-12,4,2,0,0,1,7,39,46,winter
2011-11-12,4,3,0,0,1,4,13,17,winter
2011-11-12,4,4,0,0,1,0,7,7,winter
2011-11-12,4,5,0,0,1,1,3,4,winter
2011-11-12,4,6,0,0,1,0,7,7,winter
2011-11-12,4,7,0,0,1,3,24,27,winter
2011-11-12,4,8,0,0,1,14,87,101,winter
2011-11-12,4,9,0,0,1,18,142,160,winter
2011-11-12,4,10,0,0,1,62,170,232,winter
2011-11-12,4,11,0,0,1,102,213,315,winter
2011-11-12,4,12,0,0,1,142,224,366,winter
2011-11-12,4,13,0,0,1,128,225,353,winter
2011-11-12,4,14,0,0,1,191,244,435,winter
2011-11-12,4,15,0,0,1,165,221,386,winter
2011-11-12,4,16,0,0,1,137,224,361,winter
2011-11-12,4,17,0,0,1,92,193,285,winter
2011-11-12,4,18,0,0,1,53,150,203,winter
2011-11-12,4,19,0,0,1,32,139,171,winter
2011-11-12,4,20,0,0,1,31,101,132,winter
2011-11-12,4,21,0,0,1,19,103,122,winter
2011-11-12,4,22,0,0,1,30,88,118,winter
2011-11-12,4,23,0,0,1,23,78,101,winter
2011-11-13,4,0,0,0,2,12,61,73,winter
2011-11-13,4,1,0,0,2,13,58,71,winter
2011-11-13,4,2,0,0,1,9,48,57,winter
2011-11-13,4,3,0,0,2,8,20,28,winter
2011-11-13,4,4,0,0,2,1,5,6,winter
2011-11-13,4,5,0,0,1,2,3,5,winter
2011-11-13,4,6,0,0,1,5,18,23,winter
2011-11-13,4,7,0,0,1,13,30,43,winter
2011-11-13,4,8,0,0,1,24,55,79,winter
2011-11-13,4,9,0,0,1,38,97,135,winter
2011-11-13,4,10,0,0,1,63,178,241,winter
2011-11-13,4,11,0,0,1,108,187,295,winter
2011-11-13,4,12,0,0,2,112,242,354,winter
2011-11-13,4,13,0,0,2,105,234,339,winter
2011-11-13,4,14,0,0,2,108,263,371,winter
2011-11-13,4,15,0,0,2,89,221,310,winter
2011-11-13,4,16,0,0,2,93,226,319,winter
2011-11-13,4,17,0,0,1,44,187,231,winter
2011-11-13,4,18,0,0,1,35,155,190,winter
2011-11-13,4,19,0,0,1,36,121,157,winter
2011-11-13,4,20,0,0,1,24,115,139,winter
2011-11-13,4,21,0,0,1,19,76,95,winter
2011-11-13,4,22,0,0,1,25,64,89,winter
2011-11-13,4,23,0,0,1,18,49,67,winter
2011-11-14,4,0,0,1,1,8,22,30,winter
2011-11-14,4,1,0,1,1,5,6,11,winter
2011-11-14,4,2,0,1,1,7,10,17,winter
2011-11-14,4,3,0,1,1,4,3,7,winter
2011-11-14,4,4,0,1,1,0,5,5,winter
2011-11-14,4,5,0,1,2,0,19,19,winter
2011-11-14,4,6,0,1,2,10,104,114,winter
2011-11-14,4,7,0,1,1,11,311,322,winter
2011-11-14,4,8,0,1,2,27,425,452,winter
2011-11-14,4,9,0,1,2,29,204,233,winter
2011-11-14,4,10,0,1,2,26,85,111,winter
2011-11-14,4,11,0,1,2,22,106,128,winter
2011-11-14,4,12,0,1,1,36,166,202,winter
2011-11-14,4,13,0,1,1,50,153,203,winter
2011-11-14,4,14,0,1,1,47,138,185,winter
2011-11-14,4,15,0,1,1,53,142,195,winter
2011-11-14,4,16,0,1,1,51,264,315,winter
2011-11-14,4,17,0,1,1,55,464,519,winter
2011-11-14,4,18,0,1,1,29,460,489,winter
2011-11-14,4,19,0,1,1,28,274,302,winter
2011-11-14,4,20,0,1,1,30,210,240,winter
2011-11-14,4,21,0,1,1,37,176,213,winter
2011-11-14,4,22,0,1,1,17,96,113,winter
2011-11-14,4,23,0,1,1,13,48,61,winter
2011-11-15,4,0,0,1,1,7,15,22,winter
2011-11-15,4,1,0,1,1,5,5,10,winter
2011-11-15,4,2,0,1,1,7,8,15,winter
2011-11-15,4,3,0,1,2,0,4,4,winter
2011-11-15,4,4,0,1,1,1,6,7,winter
2011-11-15,4,5,0,1,1,2,26,28,winter
2011-11-15,4,6,0,1,2,4,104,108,winter
2011-11-15,4,7,0,1,2,21,298,319,winter
2011-11-15,4,8,0,1,2,27,453,480,winter
2011-11-15,4,9,0,1,2,26,174,200,winter
2011-11-15,4,10,0,1,2,23,115,138,winter
2011-11-15,4,11,0,1,2,18,116,134,winter
2011-11-15,4,12,0,1,2,28,148,176,winter
2011-11-15,4,13,0,1,3,21,132,153,winter
2011-11-15,4,14,0,1,2,27,120,147,winter
2011-11-15,4,15,0,1,2,36,155,191,winter
2011-11-15,4,16,0,1,2,31,240,271,winter
2011-11-15,4,17,0,1,2,29,422,451,winter
2011-11-15,4,18,0,1,2,27,414,441,winter
2011-11-15,4,19,0,1,2,27,259,286,winter
2011-11-15,4,20,0,1,2,26,212,238,winter
2011-11-15,4,21,0,1,2,23,145,168,winter
2011-11-15,4,22,0,1,2,19,109,128,winter
2011-11-15,4,23,0,1,2,14,66,80,winter
2011-11-16,4,0,0,1,2,5,26,31,winter
2011-11-16,4,1,0,1,3,0,5,5,winter
2011-11-16,4,2,0,1,2,4,6,10,winter
2011-11-16,4,3,0,1,2,2,3,5,winter
2011-11-16,4,4,0,1,2,1,3,4,winter
2011-11-16,4,5,0,1,3,0,13,13,winter
2011-11-16,4,6,0,1,2,4,52,56,winter
2011-11-16,4,7,0,1,3,7,130,137,winter
2011-11-16,4,8,0,1,3,9,223,232,winter
2011-11-16,4,9,0,1,3,5,77,82,winter
2011-11-16,4,10,0,1,3,4,32,36,winter
2011-11-16,4,11,0,1,3,7,53,60,winter
2011-11-16,4,12,0,1,3,5,49,54,winter
2011-11-16,4,13,0,1,3,6,52,58,winter
2011-11-16,4,14,0,1,2,12,49,61,winter
2011-11-16,4,15,0,1,3,16,50,66,winter
2011-11-16,4,16,0,1,3,13,110,123,winter
2011-11-16,4,17,0,1,2,17,216,233,winter
2011-11-16,4,18,0,1,3,13,176,189,winter
2011-11-16,4,19,0,1,3,3,108,111,winter
2011-11-16,4,20,0,1,3,5,94,99,winter
2011-11-16,4,21,0,1,3,3,72,75,winter
2011-11-16,4,22,0,1,3,1,45,46,winter
2011-11-16,4,23,0,1,3,3,28,31,winter
2011-11-17,4,0,0,1,2,2,22,24,winter
2011-11-17,4,1,0,1,2,0,5,5,winter
2011-11-17,4,2,0,1,2,0,5,5,winter
2011-11-17,4,3,0,1,2,0,3,3,winter
2011-11-17,4,4,0,1,2,1,3,4,winter
2011-11-17,4,5,0,1,3,1,21,22,winter
2011-11-17,4,6,0,1,3,3,72,75,winter
2011-11-17,4,7,0,1,3,4,164,168,winter
2011-11-17,4,8,0,1,3,12,343,355,winter
2011-11-17,4,9,0,1,2,14,184,198,winter
2011-11-17,4,10,0,1,2,7,74,81,winter
2011-11-17,4,11,0,1,3,4,93,97,winter
2011-11-17,4,12,0,1,2,6,115,121,winter
2011-11-17,4,13,0,1,2,15,109,124,winter
2011-11-17,4,14,0,1,2,5,105,110,winter
2011-11-17,4,15,0,1,2,10,106,116,winter
2011-11-17,4,16,0,1,1,8,187,195,winter
2011-11-17,4,17,0,1,1,20,379,399,winter
2011-11-17,4,18,0,1,1,9,298,307,winter
2011-11-17,4,19,0,1,1,7,210,217,winter
2011-11-17,4,20,0,1,1,7,162,169,winter
2011-11-17,4,21,0,1,1,3,113,116,winter
2011-11-17,4,22,0,1,1,1,83,84,winter
2011-11-17,4,23,0,1,1,0,58,58,winter
2011-11-18,4,0,0,1,1,2,28,30,winter
2011-11-18,4,1,0,1,1,0,10,10,winter
2011-11-18,4,2,0,1,1,2,8,10,winter
2011-11-18,4,3,0,1,1,0,2,2,winter
2011-11-18,4,4,0,1,1,0,5,5,winter
2011-11-18,4,5,0,1,1,0,22,22,winter
2011-11-18,4,6,0,1,1,1,70,71,winter
2011-11-18,4,7,0,1,1,5,211,216,winter
2011-11-18,4,8,0,1,1,6,369,375,winter
2011-11-18,4,9,0,1,1,6,207,213,winter
2011-11-18,4,10,0,1,1,10,105,115,winter
2011-11-18,4,11,0,1,1,18,122,140,winter
2011-11-18,4,12,0,1,1,22,143,165,winter
2011-11-18,4,13,0,1,1,31,146,177,winter
2011-11-18,4,14,0,1,1,31,123,154,winter
2011-11-18,4,15,0,1,1,27,151,178,winter
2011-11-18,4,16,0,1,1,19,190,209,winter
2011-11-18,4,17,0,1,1,17,361,378,winter
2011-11-18,4,18,0,1,1,16,312,328,winter
2011-11-18,4,19,0,1,1,7,183,190,winter
2011-11-18,4,20,0,1,1,8,129,137,winter
2011-11-18,4,21,0,1,1,3,108,111,winter
2011-11-18,4,22,0,1,1,9,88,97,winter
2011-11-18,4,23,0,1,1,5,54,59,winter
2011-11-19,4,0,0,0,1,4,49,53,winter
2011-11-19,4,1,0,0,1,1,34,35,winter
2011-11-19,4,2,0,0,1,12,34,46,winter
2011-11-19,4,3,0,0,1,4,11,15,winter
2011-11-19,4,4,0,0,1,4,4,8,winter
2011-11-19,4,5,0,0,1,0,2,2,winter
2011-11-19,4,6,0,0,1,2,10,12,winter
2011-11-19,4,7,0,0,1,3,38,41,winter
2011-11-19,4,8,0,0,1,12,80,92,winter
2011-11-19,4,9,0,0,1,12,130,142,winter
2011-11-19,4,10,0,0,1,35,165,200,winter
2011-11-19,4,11,0,0,1,50,183,233,winter
2011-11-19,4,12,0,0,1,93,218,311,winter
2011-11-19,4,13,0,0,1,118,245,363,winter
2011-11-19,4,14,0,0,1,121,228,349,winter
2011-11-19,4,15,0,0,1,120,262,382,winter
2011-11-19,4,16,0,0,1,99,188,287,winter
2011-11-19,4,17,0,0,1,61,171,232,winter
2011-11-19,4,18,0,0,1,36,172,208,winter
2011-11-19,4,19,0,0,2,33,149,182,winter
2011-11-19,4,20,0,0,2,48,115,163,winter
2011-11-19,4,21,0,0,2,29,79,108,winter
2011-11-19,4,22,0,0,2,26,80,106,winter
2011-11-19,4,23,0,0,1,20,73,93,winter
2011-11-20,4,0,0,0,1,14,79,93,winter
2011-11-20,4,1,0,0,1,11,73,84,winter
2011-11-20,4,2,0,0,1,12,44,56,winter
2011-11-20,4,3,0,0,2,6,31,37,winter
2011-11-20,4,4,0,0,2,2,10,12,winter
2011-11-20,4,5,0,0,2,0,4,4,winter
2011-11-20,4,6,0,0,2,3,6,9,winter
2011-11-20,4,7,0,0,1,4,19,23,winter
2011-11-20,4,8,0,0,2,13,52,65,winter
2011-11-20,4,9,0,0,1,29,109,138,winter
2011-11-20,4,10,0,0,2,46,183,229,winter
2011-11-20,4,11,0,0,2,74,212,286,winter
2011-11-20,4,12,0,0,2,70,234,304,winter
2011-11-20,4,13,0,0,2,84,285,369,winter
2011-11-20,4,14,0,0,1,113,250,363,winter
2011-11-20,4,15,0,0,2,109,242,351,winter
2011-11-20,4,16,0,0,2,81,225,306,winter
2011-11-20,4,17,0,0,2,35,168,203,winter
2011-11-20,4,18,0,0,2,22,123,145,winter
2011-11-20,4,19,0,0,2,17,140,157,winter
2011-11-20,4,20,0,0,2,23,90,113,winter
2011-11-20,4,21,0,0,2,11,94,105,winter
2011-11-20,4,22,0,0,3,5,35,40,winter
2011-11-20,4,23,0,0,3,3,25,28,winter
2011-11-21,4,0,0,1,2,4,13,17,winter
2011-11-21,4,1,0,1,3,4,8,12,winter
2011-11-21,4,2,0,1,3,1,2,3,winter
2011-11-21,4,3,0,1,3,0,4,4,winter
2011-11-21,4,4,0,1,3,0,5,5,winter
2011-11-21,4,5,0,1,2,0,20,20,winter
2011-11-21,4,6,0,1,2,0,76,76,winter
2011-11-21,4,7,0,1,2,17,229,246,winter
2011-11-21,4,8,0,1,2,13,378,391,winter
2011-11-21,4,9,0,1,2,15,222,237,winter
2011-11-21,4,10,0,1,2,25,110,135,winter
2011-11-21,4,11,0,1,2,16,112,128,winter
2011-11-21,4,12,0,1,2,24,138,162,winter
2011-11-21,4,13,0,1,2,13,121,134,winter
2011-11-21,4,14,0,1,2,14,121,135,winter
2011-11-21,4,15,0,1,3,15,93,108,winter
2011-11-21,4,16,0,1,3,13,95,108,winter
2011-11-21,4,17,0,1,3,10,200,210,winter
2011-11-21,4,18,0,1,3,8,184,192,winter
2011-11-21,4,19,0,1,3,2,135,137,winter
2011-11-21,4,20,0,1,3,5,75,80,winter
2011-11-21,4,21,0,1,3,11,103,114,winter
2011-11-21,4,22,0,1,3,6,72,78,winter
2011-11-21,4,23,0,1,3,4,29,33,winter
2011-11-22,4,0,0,1,3,0,14,14,winter
2011-11-22,4,1,0,1,3,1,5,6,winter
2011-11-22,4,2,0,1,3,2,4,6,winter
2011-11-22,4,3,0,1,3,1,2,3,winter
2011-11-22,4,4,0,1,3,0,7,7,winter
2011-11-22,4,5,0,1,3,1,17,18,winter
2011-11-22,4,6,0,1,2,1,63,64,winter
2011-11-22,4,7,0,1,3,2,119,121,winter
2011-11-22,4,8,0,1,3,5,185,190,winter
2011-11-22,4,9,0,1,3,2,147,149,winter
2011-11-22,4,10,0,1,3,6,46,52,winter
2011-11-22,4,11,0,1,3,4,28,32,winter
2011-11-22,4,12,0,1,3,3,18,21,winter
2011-11-22,4,13,0,1,3,4,22,26,winter
2011-11-22,4,14,0,1,3,4,31,35,winter
2011-11-22,4,15,0,1,3,2,32,34,winter
2011-11-22,4,16,0,1,3,3,59,62,winter
2011-11-22,4,17,0,1,3,4,161,165,winter
2011-11-22,4,18,0,1,3,0,148,148,winter
2011-11-22,4,19,0,1,3,5,106,111,winter
2011-11-22,4,20,0,1,2,6,121,127,winter
2011-11-22,4,21,0,1,2,4,86,90,winter
2011-11-22,4,22,0,1,2,6,81,87,winter
2011-11-22,4,23,0,1,2,3,36,39,winter
2011-11-23,4,0,0,1,2,2,14,16,winter
2011-11-23,4,1,0,1,2,0,8,8,winter
2011-11-23,4,2,0,1,3,1,5,6,winter
2011-11-23,4,3,0,1,3,1,2,3,winter
2011-11-23,4,4,0,1,3,0,5,5,winter
2011-11-23,4,5,0,1,2,1,16,17,winter
2011-11-23,4,6,0,1,2,1,68,69,winter
2011-11-23,4,7,0,1,2,2,154,156,winter
2011-11-23,4,8,0,1,2,7,316,323,winter
2011-11-23,4,9,0,1,2,3,164,167,winter
2011-11-23,4,10,0,1,2,6,70,76,winter
2011-11-23,4,11,0,1,2,9,107,116,winter
2011-11-23,4,12,0,1,1,9,151,160,winter
2011-11-23,4,13,0,1,2,12,162,174,winter
2011-11-23,4,14,0,1,1,13,200,213,winter
2011-11-23,4,15,0,1,2,13,194,207,winter
2011-11-23,4,16,0,1,2,4,169,173,winter
2011-11-23,4,17,0,1,3,7,156,163,winter
2011-11-23,4,18,0,1,2,7,138,145,winter
2011-11-23,4,19,0,1,1,6,116,122,winter
2011-11-23,4,20,0,1,1,1,67,68,winter
2011-11-23,4,21,0,1,1,0,66,66,winter
2011-11-23,4,22,0,1,1,3,59,62,winter
2011-11-23,4,23,0,1,1,4,47,51,winter
2011-11-24,4,0,1,0,1,1,22,23,winter
2011-11-24,4,1,1,0,1,1,23,24,winter
2011-11-24,4,2,1,0,1,3,19,22,winter
2011-11-24,4,3,1,0,1,1,4,5,winter
2011-11-24,4,4,1,0,1,1,1,2,winter
2011-11-24,4,5,1,0,1,1,10,11,winter
2011-11-24,4,6,1,0,1,1,5,6,winter
2011-11-24,4,7,1,0,1,9,31,40,winter
2011-11-24,4,8,1,0,1,4,42,46,winter
2011-11-24,4,9,1,0,1,13,68,81,winter
2011-11-24,4,10,1,0,1,34,64,98,winter
2011-11-24,4,11,1,0,1,52,90,142,winter
2011-11-24,4,12,1,0,1,62,88,150,winter
2011-11-24,4,13,1,0,1,84,91,175,winter
2011-11-24,4,14,1,0,1,74,94,168,winter
2011-11-24,4,15,1,0,1,78,71,149,winter
2011-11-24,4,16,1,0,1,48,66,114,winter
2011-11-24,4,17,1,0,1,34,40,74,winter
2011-11-24,4,18,1,0,1,13,24,37,winter
2011-11-24,4,19,1,0,1,15,13,28,winter
2011-11-24,4,20,1,0,1,14,17,31,winter
2011-11-24,4,21,1,0,1,7,19,26,winter
2011-11-24,4,22,1,0,1,8,14,22,winter
2011-11-24,4,23,1,0,1,2,19,21,winter
2011-11-25,4,0,0,1,1,7,22,29,winter
2011-11-25,4,1,0,1,1,2,12,14,winter
2011-11-25,4,2,0,1,1,4,6,10,winter
2011-11-25,4,3,0,1,1,0,2,2,winter
2011-11-25,4,4,0,1,1,4,3,7,winter
2011-11-25,4,5,0,1,1,2,3,5,winter
2011-11-25,4,6,0,1,1,4,9,13,winter
2011-11-25,4,7,0,1,1,4,31,35,winter
2011-11-25,4,8,0,1,1,6,68,74,winter
2011-11-25,4,9,0,1,1,25,70,95,winter
2011-11-25,4,10,0,1,1,60,82,142,winter
2011-11-25,4,11,0,1,1,99,127,226,winter
2011-11-25,4,12,0,1,1,126,146,272,winter
2011-11-25,4,13,0,1,1,143,140,283,winter
2011-11-25,4,14,0,1,1,122,150,272,winter
2011-11-25,4,15,0,1,1,165,145,310,winter
2011-11-25,4,16,0,1,1,122,139,261,winter
2011-11-25,4,17,0,1,1,57,127,184,winter
2011-11-25,4,18,0,1,1,45,108,153,winter
2011-11-25,4,19,0,1,1,38,96,134,winter
2011-11-25,4,20,0,1,1,19,76,95,winter
2011-11-25,4,21,0,1,1,24,61,85,winter
2011-11-25,4,22,0,1,1,12,46,58,winter
2011-11-25,4,23,0,1,1,5,28,33,winter
2011-11-26,4,0,0,0,1,9,38,47,winter
2011-11-26,4,1,0,0,1,5,24,29,winter
2011-11-26,4,2,0,0,1,3,20,23,winter
2011-11-26,4,3,0,0,1,8,9,17,winter
2011-11-26,4,4,0,0,1,0,4,4,winter
2011-11-26,4,5,0,0,1,0,3,3,winter
2011-11-26,4,6,0,0,2,2,8,10,winter
2011-11-26,4,7,0,0,1,4,13,17,winter
2011-11-26,4,8,0,0,1,10,50,60,winter
2011-11-26,4,9,0,0,1,16,67,83,winter
2011-11-26,4,10,0,0,1,57,84,141,winter
2011-11-26,4,11,0,0,1,107,123,230,winter
2011-11-26,4,12,0,0,1,137,172,309,winter
2011-11-26,4,13,0,0,1,177,148,325,winter
2011-11-26,4,14,0,0,2,141,158,299,winter
2011-11-26,4,15,0,0,2,154,160,314,winter
2011-11-26,4,16,0,0,2,137,138,275,winter
2011-11-26,4,17,0,0,2,62,122,184,winter
2011-11-26,4,18,0,0,2,67,118,185,winter
2011-11-26,4,19,0,0,2,46,100,146,winter
2011-11-26,4,20,0,0,2,55,86,141,winter
2011-11-26,4,21,0,0,2,20,72,92,winter
2011-11-26,4,22,0,0,2,14,51,65,winter
2011-11-26,4,23,0,0,1,18,51,69,winter
2011-11-27,4,0,0,0,1,7,39,46,winter
2011-11-27,4,1,0,0,1,9,35,44,winter
2011-11-27,4,2,0,0,1,9,22,31,winter
2011-11-27,4,3,0,0,1,9,8,17,winter
2011-11-27,4,4,0,0,1,0,4,4,winter
2011-11-27,4,5,0,0,1,0,5,5,winter
2011-11-27,4,6,0,0,1,0,9,9,winter
2011-11-27,4,7,0,0,1,12,11,23,winter
2011-11-27,4,8,0,0,1,6,36,42,winter
2011-11-27,4,9,0,0,1,21,90,111,winter
2011-11-27,4,10,0,0,1,58,131,189,winter
2011-11-27,4,11,0,0,1,83,157,240,winter
2011-11-27,4,12,0,0,1,63,193,256,winter
2011-11-27,4,13,0,0,1,97,216,313,winter
2011-11-27,4,14,0,0,1,113,200,313,winter
2011-11-27,4,15,0,0,1,96,221,317,winter
2011-11-27,4,16,0,0,1,94,229,323,winter
2011-11-27,4,17,0,0,1,37,167,204,winter
2011-11-27,4,18,0,0,1,25,130,155,winter
2011-11-27,4,19,0,0,1,30,109,139,winter
2011-11-27,4,20,0,0,1,10,94,104,winter
2011-11-27,4,21,0,0,1,13,75,88,winter
2011-11-27,4,22,0,0,1,13,53,66,winter
2011-11-27,4,23,0,0,1,5,27,32,winter
2011-11-28,4,0,0,1,1,6,10,16,winter
2011-11-28,4,1,0,1,1,1,12,13,winter
2011-11-28,4,3,0,1,1,1,4,5,winter
2011-11-28,4,4,0,1,1,0,4,4,winter
2011-11-28,4,5,0,1,1,0,34,34,winter
2011-11-28,4,6,0,1,1,6,98,104,winter
2011-11-28,4,7,0,1,1,7,270,277,winter
2011-11-28,4,8,0,1,2,13,394,407,winter
2011-11-28,4,9,0,1,2,17,191,208,winter
2011-11-28,4,10,0,1,2,21,86,107,winter
2011-11-28,4,11,0,1,2,11,107,118,winter
2011-11-28,4,12,0,1,1,13,165,178,winter
2011-11-28,4,13,0,1,2,25,137,162,winter
2011-11-28,4,14,0,1,1,14,129,143,winter
2011-11-28,4,15,0,1,1,18,132,150,winter
2011-11-28,4,16,0,1,1,24,240,264,winter
2011-11-28,4,17,0,1,1,24,444,468,winter
2011-11-28,4,18,0,1,1,20,396,416,winter
2011-11-28,4,19,0,1,1,4,260,264,winter
2011-11-28,4,20,0,1,2,12,206,218,winter
2011-11-28,4,21,0,1,2,4,152,156,winter
2011-11-28,4,22,0,1,2,7,102,109,winter
2011-11-28,4,23,0,1,2,5,41,46,winter
2011-11-29,4,0,0,1,1,4,18,22,winter
2011-11-29,4,1,0,1,1,1,16,17,winter
2011-11-29,4,2,0,1,2,0,5,5,winter
2011-11-29,4,3,0,1,2,0,2,2,winter
2011-11-29,4,4,0,1,2,1,5,6,winter
2011-11-29,4,5,0,1,1,1,21,22,winter
2011-11-29,4,6,0,1,1,1,88,89,winter
2011-11-29,4,7,0,1,1,12,330,342,winter
2011-11-29,4,8,0,1,1,9,440,449,winter
2011-11-29,4,9,0,1,3,5,197,202,winter
2011-11-29,4,10,0,1,3,2,34,36,winter
2011-11-29,4,11,0,1,3,1,10,11,winter
2011-11-29,4,12,0,1,3,1,17,18,winter
2011-11-29,4,13,0,1,3,0,22,22,winter
2011-11-29,4,14,0,1,3,1,35,36,winter
2011-11-29,4,15,0,1,3,5,60,65,winter
2011-11-29,4,16,0,1,3,5,146,151,winter
2011-11-29,4,17,0,1,2,8,346,354,winter
2011-11-29,4,18,0,1,2,11,347,358,winter
2011-11-29,4,19,0,1,2,6,244,250,winter
2011-11-29,4,20,0,1,2,8,176,184,winter
2011-11-29,4,21,0,1,2,9,116,125,winter
2011-11-29,4,22,0,1,1,5,90,95,winter
2011-11-29,4,23,0,1,1,0,53,53,winter
2011-11-30,4,0,0,1,1,1,23,24,winter
2011-11-30,4,1,0,1,1,0,8,8,winter
2011-11-30,4,2,0,1,1,0,5,5,winter
2011-11-30,4,3,0,1,1,0,1,1,winter
2011-11-30,4,4,0,1,1,0,5,5,winter
2011-11-30,4,5,0,1,1,1,21,22,winter
2011-11-30,4,6,0,1,1,3,100,103,winter
2011-11-30,4,7,0,1,1,9,276,285,winter
2011-11-30,4,8,0,1,1,13,465,478,winter
2011-11-30,4,9,0,1,1,7,186,193,winter
2011-11-30,4,10,0,1,1,15,95,110,winter
2011-11-30,4,11,0,1,1,10,112,122,winter
2011-11-30,4,12,0,1,2,12,148,160,winter
2011-11-30,4,13,0,1,2,16,131,147,winter
2011-11-30,4,14,0,1,2,13,99,112,winter
2011-11-30,4,15,0,1,1,11,104,115,winter
2011-11-30,4,16,0,1,1,27,199,226,winter
2011-11-30,4,17,0,1,2,15,365,380,winter
2011-11-30,4,18,0,1,1,7,369,376,winter
2011-11-30,4,19,0,1,2,6,273,279,winter
2011-11-30,4,20,0,1,2,6,184,190,winter
2011-11-30,4,21,0,1,1,7,128,135,winter
2011-11-30,4,22,0,1,1,5,82,87,winter
2011-11-30,4,23,0,1,1,4,46,50,winter
2011-12-01,4,0,0,1,1,1,19,20,winter
2011-12-01,4,1,0,1,1,1,9,10,winter
2011-12-01,4,2,0,1,1,1,8,9,winter
2011-12-01,4,3,0,1,1,1,6,7,winter
2011-12-01,4,4,0,1,1,0,1,1,winter
2011-12-01,4,5,0,1,1,1,23,24,winter
2011-12-01,4,6,0,1,1,5,92,97,winter
2011-12-01,4,7,0,1,1,11,265,276,winter
2011-12-01,4,8,0,1,1,15,462,477,winter
2011-12-01,4,9,0,1,1,9,215,224,winter
2011-12-01,4,10,0,1,1,7,86,93,winter
2011-12-01,4,11,0,1,1,7,95,102,winter
2011-12-01,4,12,0,1,1,9,139,148,winter
2011-12-01,4,13,0,1,1,17,137,154,winter
2011-12-01,4,14,0,1,1,20,130,150,winter
2011-12-01,4,15,0,1,1,10,144,154,winter
2011-12-01,4,16,0,1,1,9,192,201,winter
2011-12-01,4,17,0,1,1,9,409,418,winter
2011-12-01,4,18,0,1,1,12,393,405,winter
2011-12-01,4,19,0,1,1,9,219,228,winter
2011-12-01,4,20,0,1,1,12,178,190,winter
2011-12-01,4,21,0,1,1,8,154,162,winter
2011-12-01,4,22,0,1,1,5,99,104,winter
2011-12-01,4,23,0,1,1,3,70,73,winter
2011-12-02,4,0,0,1,1,6,32,38,winter
2011-12-02,4,1,0,1,1,1,14,15,winter
2011-12-02,4,2,0,1,1,0,10,10,winter
2011-12-02,4,3,0,1,1,0,1,1,winter
2011-12-02,4,4,0,1,1,0,3,3,winter
2011-12-02,4,5,0,1,1,0,23,23,winter
2011-12-02,4,6,0,1,1,3,84,87,winter
2011-12-02,4,7,0,1,1,6,199,205,winter
2011-12-02,4,8,0,1,1,13,432,445,winter
2011-12-02,4,9,0,1,1,12,234,246,winter
2011-12-02,4,10,0,1,1,16,89,105,winter
2011-12-02,4,11,0,1,1,18,142,160,winter
2011-12-02,4,12,0,1,1,18,186,204,winter
2011-12-02,4,13,0,1,1,19,188,207,winter
2011-12-02,4,14,0,1,1,25,145,170,winter
2011-12-02,4,15,0,1,1,24,175,199,winter
2011-12-02,4,16,0,1,1,22,254,276,winter
2011-12-02,4,17,0,1,1,20,391,411,winter
2011-12-02,4,18,0,1,1,10,362,372,winter
2011-12-02,4,19,0,1,1,13,252,265,winter
2011-12-02,4,20,0,1,1,12,178,190,winter
2011-12-02,4,21,0,1,1,9,102,111,winter
2011-12-02,4,22,0,1,1,7,95,102,winter
2011-12-02,4,23,0,1,1,14,81,95,winter
2011-12-03,4,0,0,0,1,10,65,75,winter
2011-12-03,4,1,0,0,1,9,62,71,winter
2011-12-03,4,2,0,0,1,9,41,50,winter
2011-12-03,4,3,0,0,1,4,5,9,winter
2011-12-03,4,4,0,0,1,1,7,8,winter
2011-12-03,4,5,0,0,1,0,6,6,winter
2011-12-03,4,6,0,0,1,1,10,11,winter
2011-12-03,4,7,0,0,1,2,24,26,winter
2011-12-03,4,8,0,0,1,1,62,63,winter
2011-12-03,4,9,0,0,1,25,99,124,winter
2011-12-03,4,10,0,0,1,22,173,195,winter
2011-12-03,4,11,0,0,1,48,227,275,winter
2011-12-03,4,12,0,0,1,78,280,358,winter
2011-12-03,4,13,0,0,1,70,222,292,winter
2011-12-03,4,14,0,0,1,92,251,343,winter
2011-12-03,4,15,0,0,1,100,237,337,winter
2011-12-03,4,16,0,0,1,75,230,305,winter
2011-12-03,4,17,0,0,1,46,186,232,winter
2011-12-03,4,18,0,0,1,31,193,224,winter
2011-12-03,4,19,0,0,1,31,144,175,winter
2011-12-03,4,20,0,0,1,17,110,127,winter
2011-12-03,4,21,0,0,2,5,104,109,winter
2011-12-03,4,22,0,0,2,17,97,114,winter
2011-12-03,4,23,0,0,1,12,73,85,winter
2011-12-04,4,0,0,0,1,19,64,83,winter
2011-12-04,4,1,0,0,1,20,54,74,winter
2011-12-04,4,2,0,0,1,11,51,62,winter
2011-12-04,4,3,0,0,1,7,34,41,winter
2011-12-04,4,4,0,0,1,2,9,11,winter
2011-12-04,4,5,0,0,1,2,2,4,winter
2011-12-04,4,6,0,0,1,1,3,4,winter
2011-12-04,4,7,0,0,1,3,23,26,winter
2011-12-04,4,8,0,0,1,7,48,55,winter
2011-12-04,4,9,0,0,1,12,114,126,winter
2011-12-04,4,10,0,0,1,36,180,216,winter
2011-12-04,4,11,0,0,1,48,206,254,winter
2011-12-04,4,12,0,0,1,82,247,329,winter
2011-12-04,4,13,0,0,1,88,269,357,winter
2011-12-04,4,14,0,0,1,77,246,323,winter
2011-12-04,4,15,0,0,1,69,227,296,winter
2011-12-04,4,16,0,0,1,64,266,330,winter
2011-12-04,4,17,0,0,1,38,207,245,winter
2011-12-04,4,18,0,0,1,10,161,171,winter
2011-12-04,4,19,0,0,1,15,158,173,winter
2011-12-04,4,20,0,0,1,8,116,124,winter
2011-12-04,4,21,0,0,1,7,65,72,winter
2011-12-04,4,22,0,0,1,5,59,64,winter
2011-12-04,4,23,0,0,1,3,42,45,winter
2011-12-05,4,0,0,1,1,3,21,24,winter
2011-12-05,4,1,0,1,1,2,10,12,winter
2011-12-05,4,2,0,1,1,0,8,8,winter
2011-12-05,4,3,0,1,1,0,2,2,winter
2011-12-05,4,4,0,1,1,0,7,7,winter
2011-12-05,4,5,0,1,1,1,24,25,winter
2011-12-05,4,6,0,1,1,1,89,90,winter
2011-12-05,4,7,0,1,1,9,274,283,winter
2011-12-05,4,8,0,1,1,12,392,404,winter
2011-12-05,4,9,0,1,2,12,178,190,winter
2011-12-05,4,10,0,1,2,9,78,87,winter
2011-12-05,4,11,0,1,2,17,106,123,winter
2011-12-05,4,12,0,1,2,29,125,154,winter
2011-12-05,4,13,0,1,2,18,153,171,winter
2011-12-05,4,14,0,1,2,7,126,133,winter
2011-12-05,4,15,0,1,2,16,132,148,winter
2011-12-05,4,16,0,1,1,10,238,248,winter
2011-12-05,4,17,0,1,1,16,430,446,winter
2011-12-05,4,18,0,1,1,13,386,399,winter
2011-12-05,4,19,0,1,2,13,295,308,winter
2011-12-05,4,20,0,1,2,15,190,205,winter
2011-12-05,4,21,0,1,2,10,166,176,winter
2011-12-05,4,22,0,1,2,12,94,106,winter
2011-12-05,4,23,0,1,2,8,54,62,winter
2011-12-06,4,0,0,1,2,3,25,28,winter
2011-12-06,4,1,0,1,2,2,14,16,winter
2011-12-06,4,2,0,1,2,0,3,3,winter
2011-12-06,4,3,0,1,2,0,3,3,winter
2011-12-06,4,4,0,1,3,0,7,7,winter
2011-12-06,4,5,0,1,3,0,20,20,winter
2011-12-06,4,6,0,1,2,5,81,86,winter
2011-12-06,4,7,0,1,2,7,227,234,winter
2011-12-06,4,8,0,1,2,13,401,414,winter
2011-12-06,4,9,0,1,2,4,200,204,winter
2011-12-06,4,10,0,1,3,6,44,50,winter
2011-12-06,4,11,0,1,3,4,28,32,winter
2011-12-06,4,12,0,1,3,5,50,55,winter
2011-12-06,4,13,0,1,3,6,65,71,winter
2011-12-06,4,14,0,1,3,6,69,75,winter
2011-12-06,4,15,0,1,3,2,43,45,winter
2011-12-06,4,16,0,1,3,4,84,88,winter
2011-12-06,4,17,0,1,2,13,249,262,winter
2011-12-06,4,18,0,1,2,17,287,304,winter
2011-12-06,4,19,0,1,3,10,223,233,winter
2011-12-06,4,20,0,1,3,3,107,110,winter
2011-12-06,4,21,0,1,2,6,108,114,winter
2011-12-06,4,22,0,1,3,5,82,87,winter
2011-12-06,4,23,0,1,3,5,48,53,winter
2011-12-07,4,0,0,1,1,3,30,33,winter
2011-12-07,4,1,0,1,2,4,9,13,winter
2011-12-07,4,2,0,1,3,2,4,6,winter
2011-12-07,4,3,0,1,3,0,3,3,winter
2011-12-07,4,4,0,1,3,0,1,1,winter
2011-12-07,4,5,0,1,3,0,3,3,winter
2011-12-07,4,6,0,1,3,0,18,18,winter
2011-12-07,4,7,0,1,3,3,43,46,winter
2011-12-07,4,8,0,1,3,6,80,86,winter
2011-12-07,4,9,0,1,3,0,64,64,winter
2011-12-07,4,10,0,1,3,1,32,33,winter
2011-12-07,4,11,0,1,3,3,47,50,winter
2011-12-07,4,12,0,1,3,4,29,33,winter
2011-12-07,4,13,0,1,3,5,28,33,winter
2011-12-07,4,14,0,1,3,1,24,25,winter
2011-12-07,4,15,0,1,3,5,25,30,winter
2011-12-07,4,16,0,1,3,3,28,31,winter
2011-12-07,4,17,0,1,3,4,48,52,winter
2011-12-07,4,18,0,1,3,3,48,51,winter
2011-12-07,4,19,0,1,3,2,31,33,winter
2011-12-07,4,20,0,1,3,1,25,26,winter
2011-12-07,4,21,0,1,3,0,6,6,winter
2011-12-07,4,22,0,1,3,0,13,13,winter
2011-12-07,4,23,0,1,1,0,16,16,winter
2011-12-08,4,0,0,1,2,0,21,21,winter
2011-12-08,4,1,0,1,1,1,6,7,winter
2011-12-08,4,2,0,1,1,0,4,4,winter
2011-12-08,4,3,0,1,1,0,1,1,winter
2011-12-08,4,4,0,1,2,0,2,2,winter
2011-12-08,4,5,0,1,1,0,12,12,winter
2011-12-08,4,6,0,1,1,0,71,71,winter
2011-12-08,4,7,0,1,1,11,233,244,winter
2011-12-08,4,8,0,1,1,11,418,429,winter
2011-12-08,4,9,0,1,1,7,218,225,winter
2011-12-08,4,10,0,1,1,1,109,110,winter
2011-12-08,4,11,0,1,1,6,100,106,winter
2011-12-08,4,12,0,1,1,8,148,156,winter
2011-12-08,4,13,0,1,1,9,115,124,winter
2011-12-08,4,14,0,1,1,16,121,137,winter
2011-12-08,4,15,0,1,1,19,98,117,winter
2011-12-08,4,16,0,1,1,7,201,208,winter
2011-12-08,4,17,0,1,1,10,321,331,winter
2011-12-08,4,18,0,1,1,12,306,318,winter
2011-12-08,4,19,0,1,1,12,220,232,winter
2011-12-08,4,20,0,1,1,5,170,175,winter
2011-12-08,4,21,0,1,1,4,135,139,winter
2011-12-08,4,22,0,1,1,8,84,92,winter
2011-12-08,4,23,0,1,1,3,58,61,winter
2011-12-09,4,0,0,1,1,8,26,34,winter
2011-12-09,4,1,0,1,1,2,12,14,winter
2011-12-09,4,2,0,1,1,2,10,12,winter
2011-12-09,4,3,0,1,1,1,5,6,winter
2011-12-09,4,4,0,1,1,1,1,2,winter
2011-12-09,4,5,0,1,1,0,20,20,winter
2011-12-09,4,6,0,1,1,1,62,63,winter
2011-12-09,4,7,0,1,1,4,195,199,winter
2011-12-09,4,8,0,1,1,7,378,385,winter
2011-12-09,4,9,0,1,1,8,256,264,winter
2011-12-09,4,10,0,1,2,11,115,126,winter
2011-12-09,4,11,0,1,1,15,121,136,winter
2011-12-09,4,12,0,1,1,27,146,173,winter
2011-12-09,4,13,0,1,1,27,141,168,winter
2011-12-09,4,14,0,1,1,24,163,187,winter
2011-12-09,4,15,0,1,1,29,160,189,winter
2011-12-09,4,16,0,1,1,24,226,250,winter
2011-12-09,4,17,0,1,1,10,352,362,winter
2011-12-09,4,18,0,1,1,10,308,318,winter
2011-12-09,4,19,0,1,1,10,189,199,winter
2011-12-09,4,20,0,1,1,10,140,150,winter
2011-12-09,4,21,0,1,1,9,131,140,winter
2011-12-09,4,22,0,1,1,15,114,129,winter
2011-12-09,4,23,0,1,1,6,88,94,winter
2011-12-10,4,0,0,0,2,11,66,77,winter
2011-12-10,4,1,0,0,2,11,55,66,winter
2011-12-10,4,2,0,0,2,12,48,60,winter
2011-12-10,4,3,0,0,2,5,20,25,winter
2011-12-10,4,4,0,0,2,0,3,3,winter
2011-12-10,4,5,0,0,1,0,6,6,winter
2011-12-10,4,6,0,0,1,1,10,11,winter
2011-12-10,4,7,0,0,1,0,11,11,winter
2011-12-10,4,8,0,0,1,5,68,73,winter
2011-12-10,4,9,0,0,1,15,134,149,winter
2011-12-10,4,10,0,0,1,31,161,192,winter
2011-12-10,4,11,0,0,1,44,192,236,winter
2011-12-10,4,12,0,0,1,48,235,283,winter
2011-12-10,4,13,0,0,1,47,239,286,winter
2011-12-10,4,14,0,0,1,51,242,293,winter
2011-12-10,4,15,0,0,1,60,239,299,winter
2011-12-10,4,16,0,0,1,58,183,241,winter
2011-12-10,4,17,0,0,1,34,151,185,winter
2011-12-10,4,18,0,0,1,28,144,172,winter
2011-12-10,4,19,0,0,1,15,139,154,winter
2011-12-10,4,20,0,0,1,10,114,124,winter
2011-12-10,4,21,0,0,1,4,79,83,winter
2011-12-10,4,22,0,0,1,7,88,95,winter
2011-12-10,4,23,0,0,1,5,61,66,winter
2011-12-11,4,0,0,0,1,5,69,74,winter
2011-12-11,4,1,0,0,1,8,54,62,winter
2011-12-11,4,2,0,0,1,5,47,52,winter
2011-12-11,4,3,0,0,1,2,17,19,winter
2011-12-11,4,4,0,0,1,0,5,5,winter
2011-12-11,4,5,0,0,1,0,6,6,winter
2011-12-11,4,6,0,0,1,0,10,10,winter
2011-12-11,4,7,0,0,1,1,30,31,winter
2011-12-11,4,8,0,0,1,4,68,72,winter
2011-12-11,4,9,0,0,1,19,88,107,winter
2011-12-11,4,10,0,0,1,30,164,194,winter
2011-12-11,4,11,0,0,1,31,166,197,winter
2011-12-11,4,12,0,0,1,42,246,288,winter
2011-12-11,4,13,0,0,1,44,224,268,winter
2011-12-11,4,14,0,0,1,44,198,242,winter
2011-12-11,4,15,0,0,1,47,219,266,winter
2011-12-11,4,16,0,0,1,32,174,206,winter
2011-12-11,4,17,0,0,1,13,150,163,winter
2011-12-11,4,18,0,0,1,12,151,163,winter
2011-12-11,4,19,0,0,1,7,98,105,winter
2011-12-11,4,20,0,0,1,10,62,72,winter
2011-12-11,4,21,0,0,1,10,53,63,winter
2011-12-11,4,22,0,0,1,7,36,43,winter
2011-12-11,4,23,0,0,1,4,31,35,winter
2011-12-12,4,0,0,1,1,4,16,20,winter
2011-12-12,4,1,0,1,1,0,9,9,winter
2011-12-12,4,2,0,1,1,0,4,4,winter
2011-12-12,4,3,0,1,1,0,2,2,winter
2011-12-12,4,4,0,1,1,0,3,3,winter
2011-12-12,4,5,0,1,1,0,21,21,winter
2011-12-12,4,6,0,1,1,1,63,64,winter
2011-12-12,4,7,0,1,1,4,231,235,winter
2011-12-12,4,8,0,1,2,7,378,385,winter
2011-12-12,4,9,0,1,2,12,208,220,winter
2011-12-12,4,10,0,1,2,14,91,105,winter
2011-12-12,4,11,0,1,2,15,100,115,winter
2011-12-12,4,12,0,1,1,7,138,145,winter
2011-12-12,4,13,0,1,2,13,153,166,winter
2011-12-12,4,14,0,1,2,16,95,111,winter
2011-12-12,4,15,0,1,2,8,124,132,winter
2011-12-12,4,16,0,1,2,5,209,214,winter
2011-12-12,4,17,0,1,2,7,352,359,winter
2011-12-12,4,18,0,1,1,8,349,357,winter
2011-12-12,4,19,0,1,1,9,232,241,winter
2011-12-12,4,20,0,1,1,8,157,165,winter
2011-12-12,4,21,0,1,1,2,119,121,winter
2011-12-12,4,22,0,1,1,0,71,71,winter
2011-12-12,4,23,0,1,1,3,42,45,winter
2011-12-13,4,0,0,1,1,1,16,17,winter
2011-12-13,4,1,0,1,1,0,4,4,winter
2011-12-13,4,2,0,1,1,1,1,2,winter
2011-12-13,4,3,0,1,1,0,3,3,winter
2011-12-13,4,4,0,1,1,0,4,4,winter
2011-12-13,4,5,0,1,1,0,20,20,winter
2011-12-13,4,6,0,1,1,0,92,92,winter
2011-12-13,4,7,0,1,1,2,221,223,winter
2011-12-13,4,8,0,1,1,9,391,400,winter
2011-12-13,4,9,0,1,1,10,223,233,winter
2011-12-13,4,10,0,1,1,3,99,102,winter
2011-12-13,4,11,0,1,1,9,115,124,winter
2011-12-13,4,12,0,1,1,20,147,167,winter
2011-12-13,4,13,0,1,1,7,120,127,winter
2011-12-13,4,14,0,1,1,18,116,134,winter
2011-12-13,4,15,0,1,1,7,144,151,winter
2011-12-13,4,16,0,1,1,13,194,207,winter
2011-12-13,4,17,0,1,1,17,381,398,winter
2011-12-13,4,18,0,1,1,12,370,382,winter
2011-12-13,4,19,0,1,1,5,262,267,winter
2011-12-13,4,20,0,1,1,7,154,161,winter
2011-12-13,4,21,0,1,1,5,134,139,winter
2011-12-13,4,22,0,1,1,5,102,107,winter
2011-12-13,4,23,0,1,1,4,55,59,winter
2011-12-14,4,0,0,1,1,0,22,22,winter
2011-12-14,4,1,0,1,1,0,8,8,winter
2011-12-14,4,2,0,1,1,0,2,2,winter
2011-12-14,4,3,0,1,1,0,3,3,winter
2011-12-14,4,4,0,1,1,0,4,4,winter
2011-12-14,4,5,0,1,2,0,26,26,winter
2011-12-14,4,6,0,1,2,0,87,87,winter
2011-12-14,4,7,0,1,1,4,243,247,winter
2011-12-14,4,8,0,1,2,9,458,467,winter
2011-12-14,4,9,0,1,2,9,230,239,winter
2011-12-14,4,10,0,1,2,9,133,142,winter
2011-12-14,4,11,0,1,2,12,103,115,winter
2011-12-14,4,12,0,1,2,6,138,144,winter
2011-12-14,4,13,0,1,2,14,119,133,winter
2011-12-14,4,14,0,1,2,17,134,151,winter
2011-12-14,4,15,0,1,2,24,143,167,winter
2011-12-14,4,16,0,1,2,12,233,245,winter
2011-12-14,4,17,0,1,2,19,377,396,winter
2011-12-14,4,18,0,1,2,11,379,390,winter
2011-12-14,4,19,0,1,2,9,259,268,winter
2011-12-14,4,20,0,1,2,6,169,175,winter
2011-12-14,4,21,0,1,2,9,145,154,winter
2011-12-14,4,22,0,1,1,5,99,104,winter
2011-12-14,4,23,0,1,1,3,48,51,winter
2011-12-15,4,0,0,1,1,5,45,50,winter
2011-12-15,4,1,0,1,2,5,15,20,winter
2011-12-15,4,2,0,1,2,2,5,7,winter
2011-12-15,4,3,0,1,2,1,2,3,winter
2011-12-15,4,4,0,1,2,0,6,6,winter
2011-12-15,4,5,0,1,2,0,24,24,winter
2011-12-15,4,6,0,1,1,2,90,92,winter
2011-12-15,4,7,0,1,1,6,252,258,winter
2011-12-15,4,8,0,1,2,8,449,457,winter
2011-12-15,4,9,0,1,2,6,274,280,winter
2011-12-15,4,10,0,1,2,4,105,109,winter
2011-12-15,4,11,0,1,2,9,126,135,winter
2011-12-15,4,12,0,1,2,17,140,157,winter
2011-12-15,4,13,0,1,2,14,150,164,winter
2011-12-15,4,14,0,1,2,8,124,132,winter
2011-12-15,4,15,0,1,3,6,76,82,winter
2011-12-15,4,16,0,1,3,7,124,131,winter
2011-12-15,4,17,0,1,2,14,310,324,winter
2011-12-15,4,18,0,1,2,14,363,377,winter
2011-12-15,4,19,0,1,2,13,274,287,winter
2011-12-15,4,20,0,1,1,12,209,221,winter
2011-12-15,4,21,0,1,1,10,145,155,winter
2011-12-15,4,22,0,1,1,8,116,124,winter
2011-12-15,4,23,0,1,1,10,104,114,winter
2011-12-16,4,0,0,1,1,12,60,72,winter
2011-12-16,4,1,0,1,1,3,28,31,winter
2011-12-16,4,2,0,1,1,0,23,23,winter
2011-12-16,4,3,0,1,1,2,3,5,winter
2011-12-16,4,4,0,1,2,1,4,5,winter
2011-12-16,4,5,0,1,1,0,26,26,winter
2011-12-16,4,6,0,1,2,2,80,82,winter
2011-12-16,4,7,0,1,2,5,226,231,winter
2011-12-16,4,8,0,1,1,10,449,459,winter
2011-12-16,4,9,0,1,1,8,235,243,winter
2011-12-16,4,10,0,1,1,10,122,132,winter
2011-12-16,4,11,0,1,2,9,135,144,winter
2011-12-16,4,12,0,1,2,10,163,173,winter
2011-12-16,4,13,0,1,2,12,125,137,winter
2011-12-16,4,14,0,1,2,13,115,128,winter
2011-12-16,4,15,0,1,2,12,141,153,winter
2011-12-16,4,16,0,1,2,12,212,224,winter
2011-12-16,4,17,0,1,2,13,352,365,winter
2011-12-16,4,18,0,1,2,10,285,295,winter
2011-12-16,4,19,0,1,2,11,203,214,winter
2011-12-16,4,20,0,1,2,6,146,152,winter
2011-12-16,4,21,0,1,2,7,95,102,winter
2011-12-16,4,22,0,1,2,6,100,106,winter
2011-12-16,4,23,0,1,2,4,71,75,winter
2011-12-17,4,0,0,0,1,3,59,62,winter
2011-12-17,4,1,0,0,2,4,39,43,winter
2011-12-17,4,2,0,0,2,11,47,58,winter
2011-12-17,4,3,0,0,1,4,22,26,winter
2011-12-17,4,4,0,0,1,0,9,9,winter
2011-12-17,4,5,0,0,2,2,7,9,winter
2011-12-17,4,6,0,0,2,0,17,17,winter
2011-12-17,4,7,0,0,2,0,20,20,winter
2011-12-17,4,8,0,0,2,4,55,59,winter
2011-12-17,4,9,0,0,2,5,95,100,winter
2011-12-17,4,10,0,0,2,10,171,181,winter
2011-12-17,4,11,0,0,2,21,188,209,winter
2011-12-17,4,12,0,0,2,28,216,244,winter
2011-12-17,4,13,0,0,2,32,204,236,winter
2011-12-17,4,14,0,0,1,30,207,237,winter
2011-12-17,4,15,0,0,1,33,195,228,winter
2011-12-17,4,16,0,0,1,30,192,222,winter
2011-12-17,4,17,0,0,1,12,153,165,winter
2011-12-17,4,18,0,0,1,7,150,157,winter
2011-12-17,4,19,0,0,3,11,95,106,winter
2011-12-17,4,20,0,0,1,7,99,106,winter
2011-12-17,4,21,0,0,1,8,88,96,winter
2011-12-17,4,22,0,0,1,7,73,80,winter
2011-12-17,4,23,0,0,1,6,63,69,winter
2011-12-18,4,0,0,0,1,7,64,71,winter
2011-12-18,4,1,0,0,1,3,43,46,winter
2011-12-18,4,2,0,0,1,2,39,41,winter
2011-12-18,4,3,0,0,1,2,16,18,winter
2011-12-18,4,4,0,0,1,0,1,1,winter
2011-12-18,4,5,0,0,1,1,4,5,winter
2011-12-18,4,6,0,0,1,0,3,3,winter
2011-12-18,4,7,0,0,1,1,11,12,winter
2011-12-18,4,8,0,0,1,1,31,32,winter
2011-12-18,4,9,0,0,1,6,75,81,winter
2011-12-18,4,10,0,0,1,7,122,129,winter
2011-12-18,4,11,0,0,2,20,168,188,winter
2011-12-18,4,12,0,0,1,26,202,228,winter
2011-12-18,4,13,0,0,1,18,210,228,winter
2011-12-18,4,14,0,0,1,19,200,219,winter
2011-12-18,4,15,0,0,1,23,184,207,winter
2011-12-18,4,16,0,0,1,27,207,234,winter
2011-12-18,4,17,0,0,1,10,126,136,winter
2011-12-18,4,18,0,0,1,15,123,138,winter
2011-12-18,4,19,0,0,1,5,130,135,winter
2011-12-18,4,20,0,0,1,10,94,104,winter
2011-12-18,4,21,0,0,1,9,80,89,winter
2011-12-18,4,22,0,0,1,2,47,49,winter
2011-12-18,4,23,0,0,1,6,31,37,winter
2011-12-19,4,0,0,1,1,3,14,17,winter
2011-12-19,4,1,0,1,1,3,8,11,winter
2011-12-19,4,2,0,1,1,0,3,3,winter
2011-12-19,4,3,0,1,1,0,3,3,winter
2011-12-19,4,4,0,1,1,0,4,4,winter
2011-12-19,4,5,0,1,1,0,21,21,winter
2011-12-19,4,6,0,1,1,0,68,68,winter
2011-12-19,4,7,0,1,1,4,187,191,winter
2011-12-19,4,8,0,1,1,8,389,397,winter
2011-12-19,4,9,0,1,1,17,166,183,winter
2011-12-19,4,10,0,1,1,12,96,108,winter
2011-12-19,4,11,0,1,1,22,105,127,winter
2011-12-19,4,12,0,1,1,13,128,141,winter
2011-12-19,4,13,0,1,1,15,127,142,winter
2011-12-19,4,14,0,1,1,30,107,137,winter
2011-12-19,4,15,0,1,1,24,135,159,winter
2011-12-19,4,16,0,1,1,19,189,208,winter
2011-12-19,4,17,0,1,1,16,362,378,winter
2011-12-19,4,18,0,1,1,11,343,354,winter
2011-12-19,4,19,0,1,2,17,234,251,winter
2011-12-19,4,20,0,1,1,9,197,206,winter
2011-12-19,4,21,0,1,2,15,112,127,winter
2011-12-19,4,22,0,1,2,12,95,107,winter
2011-12-19,4,23,0,1,1,10,50,60,winter
2011-12-20,4,0,0,1,1,0,21,21,winter
2011-12-20,4,1,0,1,1,0,6,6,winter
2011-12-20,4,2,0,1,2,1,10,11,winter
2011-12-20,4,3,0,1,2,1,1,2,winter
2011-12-20,4,4,0,1,2,0,4,4,winter
2011-12-20,4,5,0,1,2,0,15,15,winter
2011-12-20,4,6,0,1,2,1,71,72,winter
2011-12-20,4,7,0,1,2,7,261,268,winter
2011-12-20,4,8,0,1,2,10,422,432,winter
2011-12-20,4,9,0,1,2,14,245,259,winter
2011-12-20,4,10,0,1,2,20,109,129,winter
2011-12-20,4,11,0,1,2,13,116,129,winter
2011-12-20,4,12,0,1,2,16,159,175,winter
2011-12-20,4,13,0,1,2,18,163,181,winter
2011-12-20,4,14,0,1,2,11,127,138,winter
2011-12-20,4,15,0,1,2,15,139,154,winter
2011-12-20,4,16,0,1,1,20,218,238,winter
2011-12-20,4,17,0,1,1,14,417,431,winter
2011-12-20,4,18,0,1,1,26,385,411,winter
2011-12-20,4,19,0,1,1,6,218,224,winter
2011-12-20,4,20,0,1,1,3,144,147,winter
2011-12-20,4,21,0,1,1,4,139,143,winter
2011-12-20,4,22,0,1,2,3,104,107,winter
2011-12-20,4,23,0,1,2,13,40,53,winter
2011-12-21,1,0,0,1,2,7,18,25,springer
2011-12-21,1,1,0,1,2,1,10,11,springer
2011-12-21,1,2,0,1,2,0,4,4,springer
2011-12-21,1,3,0,1,2,0,2,2,springer
2011-12-21,1,4,0,1,2,0,2,2,springer
2011-12-21,1,5,0,1,2,0,28,28,springer
2011-12-21,1,6,0,1,2,1,75,76,springer
2011-12-21,1,7,0,1,2,5,224,229,springer
2011-12-21,1,8,0,1,3,12,393,405,springer
2011-12-21,1,9,0,1,2,14,220,234,springer
2011-12-21,1,10,0,1,2,6,83,89,springer
2011-12-21,1,11,0,1,2,3,53,56,springer
2011-12-21,1,12,0,1,3,3,58,61,springer
2011-12-21,1,13,0,1,3,3,55,58,springer
2011-12-21,1,14,0,1,2,11,40,51,springer
2011-12-21,1,15,0,1,2,4,57,61,springer
2011-12-21,1,16,0,1,3,6,95,101,springer
2011-12-21,1,17,0,1,3,3,226,229,springer
2011-12-21,1,18,0,1,2,2,278,280,springer
2011-12-21,1,19,0,1,2,9,200,209,springer
2011-12-21,1,20,0,1,2,5,162,167,springer
2011-12-21,1,21,0,1,1,9,114,123,springer
2011-12-21,1,22,0,1,1,3,102,105,springer
2011-12-21,1,23,0,1,1,0,54,54,springer
2011-12-22,1,0,0,1,2,3,24,27,springer
2011-12-22,1,1,0,1,1,0,15,15,springer
2011-12-22,1,2,0,1,1,1,10,11,springer
2011-12-22,1,3,0,1,1,0,6,6,springer
2011-12-22,1,4,0,1,1,0,3,3,springer
2011-12-22,1,5,0,1,1,1,15,16,springer
2011-12-22,1,6,0,1,1,1,63,64,springer
2011-12-22,1,7,0,1,1,4,182,186,springer
2011-12-22,1,8,0,1,2,10,333,343,springer
2011-12-22,1,9,0,1,2,10,218,228,springer
2011-12-22,1,10,0,1,2,13,128,141,springer
2011-12-22,1,11,0,1,2,10,135,145,springer
2011-12-22,1,12,0,1,2,22,180,202,springer
2011-12-22,1,13,0,1,2,21,167,188,springer
2011-12-22,1,14,0,1,2,23,136,159,springer
2011-12-22,1,15,0,1,2,28,186,214,springer
2011-12-22,1,16,0,1,2,30,226,256,springer
2011-12-22,1,17,0,1,2,24,332,356,springer
2011-12-22,1,18,0,1,2,11,277,288,springer
2011-12-22,1,19,0,1,2,12,130,142,springer
2011-12-22,1,20,0,1,3,0,33,33,springer
2011-12-22,1,21,0,1,3,2,15,17,springer
2011-12-22,1,22,0,1,3,0,17,17,springer
2011-12-22,1,23,0,1,3,1,10,11,springer
2011-12-23,1,0,0,1,3,2,7,9,springer
2011-12-23,1,1,0,1,3,1,11,12,springer
2011-12-23,1,2,0,1,3,1,12,13,springer
2011-12-23,1,3,0,1,3,0,4,4,springer
2011-12-23,1,4,0,1,3,0,2,2,springer
2011-12-23,1,5,0,1,1,0,8,8,springer
2011-12-23,1,6,0,1,1,0,40,40,springer
2011-12-23,1,7,0,1,1,4,88,92,springer
2011-12-23,1,8,0,1,1,9,173,182,springer
2011-12-23,1,9,0,1,1,4,152,156,springer
2011-12-23,1,10,0,1,1,8,96,104,springer
2011-12-23,1,11,0,1,1,26,148,174,springer
2011-12-23,1,12,0,1,1,14,156,170,springer
2011-12-23,1,13,0,1,1,17,177,194,springer
2011-12-23,1,14,0,1,1,23,177,200,springer
2011-12-23,1,15,0,1,1,12,191,203,springer
2011-12-23,1,16,0,1,1,15,166,181,springer
2011-12-23,1,17,0,1,1,11,129,140,springer
2011-12-23,1,18,0,1,1,4,91,95,springer
2011-12-23,1,19,0,1,1,1,75,76,springer
2011-12-23,1,20,0,1,1,3,47,50,springer
2011-12-23,1,21,0,1,1,0,32,32,springer
2011-12-23,1,22,0,1,1,4,43,47,springer
2011-12-23,1,23,0,1,1,4,21,25,springer
2011-12-24,1,0,0,0,2,3,20,23,springer
2011-12-24,1,1,0,0,2,1,15,16,springer
2011-12-24,1,2,0,0,2,4,22,26,springer
2011-12-24,1,3,0,0,2,0,5,5,springer
2011-12-24,1,4,0,0,2,0,3,3,springer
2011-12-24,1,5,0,0,2,1,3,4,springer
2011-12-24,1,6,0,0,2,0,10,10,springer
2011-12-24,1,7,0,0,1,0,10,10,springer
2011-12-24,1,8,0,0,1,0,27,27,springer
2011-12-24,1,9,0,0,1,3,53,56,springer
2011-12-24,1,10,0,0,1,4,52,56,springer
2011-12-24,1,11,0,0,1,9,62,71,springer
2011-12-24,1,12,0,0,1,15,79,94,springer
2011-12-24,1,13,0,0,1,24,97,121,springer
2011-12-24,1,14,0,0,1,15,70,85,springer
2011-12-24,1,15,0,0,1,15,82,97,springer
2011-12-24,1,16,0,0,1,25,74,99,springer
2011-12-24,1,17,0,0,1,15,53,68,springer
2011-12-24,1,18,0,0,1,2,33,35,springer
2011-12-24,1,19,0,0,1,1,24,25,springer
2011-12-24,1,20,0,0,1,5,19,24,springer
2011-12-24,1,21,0,0,1,4,15,19,springer
2011-12-24,1,22,0,0,1,8,12,20,springer
2011-12-24,1,23,0,0,1,1,16,17,springer
2011-12-25,1,0,0,0,1,2,4,6,springer
2011-12-25,1,1,0,0,1,2,2,4,springer
2011-12-25,1,2,0,0,1,0,2,2,springer
2011-12-25,1,3,0,0,1,1,3,4,springer
2011-12-25,1,5,0,0,1,0,1,1,springer
2011-12-25,1,6,0,0,1,0,1,1,springer
2011-12-25,1,7,0,0,1,0,4,4,springer
2011-12-25,1,8,0,0,1,1,4,5,springer
2011-12-25,1,9,0,0,1,3,20,23,springer
2011-12-25,1,10,0,0,1,31,12,43,springer
2011-12-25,1,11,0,0,1,43,42,85,springer
2011-12-25,1,12,0,0,1,25,41,66,springer
2011-12-25,1,13,0,0,1,40,39,79,springer
2011-12-25,1,14,0,0,1,41,45,86,springer
2011-12-25,1,15,0,0,1,43,48,91,springer
2011-12-25,1,16,0,0,1,35,51,86,springer
2011-12-25,1,17,0,0,1,11,33,44,springer
2011-12-25,1,18,0,0,1,7,23,30,springer
2011-12-25,1,19,0,0,1,2,14,16,springer
2011-12-25,1,20,0,0,1,8,18,26,springer
2011-12-25,1,21,0,0,1,4,15,19,springer
2011-12-25,1,22,0,0,1,2,15,17,springer
2011-12-25,1,23,0,0,1,2,14,16,springer
2011-12-26,1,0,1,0,1,5,6,11,springer
2011-12-26,1,1,1,0,1,3,7,10,springer
2011-12-26,1,2,1,0,1,2,5,7,springer
2011-12-26,1,4,1,0,1,0,2,2,springer
2011-12-26,1,5,1,0,1,0,4,4,springer
2011-12-26,1,6,1,0,1,0,4,4,springer
2011-12-26,1,7,1,0,1,2,17,19,springer
2011-12-26,1,8,1,0,1,5,13,18,springer
2011-12-26,1,9,1,0,1,24,38,62,springer
2011-12-26,1,10,1,0,1,31,39,70,springer
2011-12-26,1,11,1,0,1,40,51,91,springer
2011-12-26,1,12,1,0,1,34,66,100,springer
2011-12-26,1,13,1,0,1,57,83,140,springer
2011-12-26,1,14,1,0,1,73,80,153,springer
2011-12-26,1,15,1,0,1,26,105,131,springer
2011-12-26,1,16,1,0,1,28,69,97,springer
2011-12-26,1,17,1,0,1,30,67,97,springer
2011-12-26,1,18,1,0,1,21,54,75,springer
2011-12-26,1,19,1,0,1,16,49,65,springer
2011-12-26,1,20,1,0,1,14,42,56,springer
2011-12-26,1,21,1,0,1,10,39,49,springer
2011-12-26,1,22,1,0,1,5,22,27,springer
2011-12-26,1,23,1,0,1,4,25,29,springer
2011-12-27,1,0,0,1,1,3,9,12,springer
2011-12-27,1,1,0,1,1,0,6,6,springer
2011-12-27,1,2,0,1,1,2,2,4,springer
2011-12-27,1,3,0,1,2,0,3,3,springer
2011-12-27,1,4,0,1,2,0,3,3,springer
2011-12-27,1,5,0,1,2,0,8,8,springer
2011-12-27,1,6,0,1,2,0,35,35,springer
2011-12-27,1,7,0,1,2,1,79,80,springer
2011-12-27,1,8,0,1,2,9,155,164,springer
2011-12-27,1,9,0,1,3,19,85,104,springer
2011-12-27,1,10,0,1,2,13,47,60,springer
2011-12-27,1,11,0,1,3,6,24,30,springer
2011-12-27,1,12,0,1,3,8,16,24,springer
2011-12-27,1,13,0,1,3,1,19,20,springer
2011-12-27,1,14,0,1,3,0,14,14,springer
2011-12-27,1,15,0,1,3,2,17,19,springer
2011-12-27,1,16,0,1,3,2,44,46,springer
2011-12-27,1,17,0,1,3,6,109,115,springer
2011-12-27,1,18,0,1,1,9,126,135,springer
2011-12-27,1,19,0,1,1,3,87,90,springer
2011-12-27,1,20,0,1,1,3,66,69,springer
2011-12-27,1,21,0,1,1,11,52,63,springer
2011-12-27,1,22,0,1,1,3,29,32,springer
2011-12-27,1,23,0,1,1,2,24,26,springer
2011-12-28,1,0,0,1,1,0,10,10,springer
2011-12-28,1,1,0,1,1,0,12,12,springer
2011-12-28,1,2,0,1,1,0,7,7,springer
2011-12-28,1,3,0,1,1,0,4,4,springer
2011-12-28,1,5,0,1,1,0,9,9,springer
2011-12-28,1,6,0,1,1,1,42,43,springer
2011-12-28,1,7,0,1,1,4,106,110,springer
2011-12-28,1,8,0,1,1,11,206,217,springer
2011-12-28,1,9,0,1,1,18,171,189,springer
2011-12-28,1,10,0,1,1,12,84,96,springer
2011-12-28,1,11,0,1,1,18,93,111,springer
2011-12-28,1,12,0,1,1,32,108,140,springer
2011-12-28,1,13,0,1,1,24,135,159,springer
2011-12-28,1,14,0,1,1,24,96,120,springer
2011-12-28,1,15,0,1,1,16,101,117,springer
2011-12-28,1,16,0,1,1,23,144,167,springer
2011-12-28,1,17,0,1,1,25,225,250,springer
2011-12-28,1,18,0,1,1,10,159,169,springer
2011-12-28,1,19,0,1,1,16,135,151,springer
2011-12-28,1,20,0,1,1,9,70,79,springer
2011-12-28,1,21,0,1,1,7,63,70,springer
2011-12-28,1,22,0,1,1,2,31,33,springer
2011-12-28,1,23,0,1,1,3,36,39,springer
2011-12-29,1,0,0,1,2,4,24,28,springer
2011-12-29,1,1,0,1,1,0,15,15,springer
2011-12-29,1,2,0,1,1,0,3,3,springer
2011-12-29,1,3,0,1,1,0,2,2,springer
2011-12-29,1,4,0,1,1,1,2,3,springer
2011-12-29,1,5,0,1,1,0,10,10,springer
2011-12-29,1,6,0,1,1,2,39,41,springer
2011-12-29,1,7,0,1,1,2,104,106,springer
2011-12-29,1,8,0,1,2,3,207,210,springer
2011-12-29,1,9,0,1,2,15,155,170,springer
2011-12-29,1,10,0,1,2,13,97,110,springer
2011-12-29,1,11,0,1,2,23,99,122,springer
2011-12-29,1,12,0,1,2,12,118,130,springer
2011-12-29,1,13,0,1,2,36,95,131,springer
2011-12-29,1,14,0,1,2,30,112,142,springer
2011-12-29,1,15,0,1,2,27,150,177,springer
2011-12-29,1,16,0,1,1,22,155,177,springer
2011-12-29,1,17,0,1,1,14,226,240,springer
2011-12-29,1,18,0,1,1,15,192,207,springer
2011-12-29,1,19,0,1,1,11,124,135,springer
2011-12-29,1,20,0,1,1,8,88,96,springer
2011-12-29,1,21,0,1,2,8,60,68,springer
2011-12-29,1,22,0,1,1,7,48,55,springer
2011-12-29,1,23,0,1,1,1,44,45,springer
2011-12-30,1,0,0,1,1,4,26,30,springer
2011-12-30,1,1,0,1,1,9,11,20,springer
2011-12-30,1,2,0,1,1,2,10,12,springer
2011-12-30,1,3,0,1,1,0,6,6,springer
2011-12-30,1,4,0,1,1,0,2,2,springer
2011-12-30,1,5,0,1,1,0,10,10,springer
2011-12-30,1,6,0,1,1,1,31,32,springer
2011-12-30,1,7,0,1,1,3,92,95,springer
2011-12-30,1,8,0,1,2,12,193,205,springer
2011-12-30,1,9,0,1,1,19,175,194,springer
2011-12-30,1,10,0,1,1,10,108,118,springer
2011-12-30,1,11,0,1,1,45,126,171,springer
2011-12-30,1,12,0,1,1,38,159,197,springer
2011-12-30,1,13,0,1,2,53,154,207,springer
2011-12-30,1,14,0,1,2,67,178,245,springer
2011-12-30,1,15,0,1,1,56,236,292,springer
2011-12-30,1,16,0,1,1,36,247,283,springer
2011-12-30,1,17,0,1,1,54,188,242,springer
2011-12-30,1,18,0,1,1,19,163,182,springer
2011-12-30,1,19,0,1,2,16,96,112,springer
2011-12-30,1,20,0,1,2,16,75,91,springer
2011-12-30,1,21,0,1,2,11,84,95,springer
2011-12-30,1,22,0,1,2,7,78,85,springer
2011-12-30,1,23,0,1,2,13,60,73,springer
2011-12-31,1,0,0,0,2,7,37,44,springer
2011-12-31,1,1,0,0,2,4,31,35,springer
2011-12-31,1,2,0,0,2,1,27,28,springer
2011-12-31,1,3,0,0,2,1,17,18,springer
2011-12-31,1,4,0,0,1,1,9,10,springer
2011-12-31,1,5,0,0,2,1,0,1,springer
2011-12-31,1,6,0,0,2,1,5,6,springer
2011-12-31,1,7,0,0,3,6,13,19,springer
2011-12-31,1,8,0,0,1,7,42,49,springer
2011-12-31,1,9,0,0,1,18,72,90,springer
2011-12-31,1,10,0,0,1,20,108,128,springer
2011-12-31,1,11,0,0,1,65,152,217,springer
2011-12-31,1,12,0,0,1,93,180,273,springer
2011-12-31,1,13,0,0,1,108,205,313,springer
2011-12-31,1,14,0,0,1,115,185,300,springer
2011-12-31,1,15,0,0,1,89,164,253,springer
2011-12-31,1,16,0,0,1,52,143,195,springer
2011-12-31,1,17,0,0,1,28,101,129,springer
2011-12-31,1,18,0,0,1,13,80,93,springer
2011-12-31,1,19,0,0,1,19,73,92,springer
2011-12-31,1,20,0,0,1,8,63,71,springer
2011-12-31,1,21,0,0,1,2,50,52,springer
2011-12-31,1,22,0,0,1,2,36,38,springer
2011-12-31,1,23,0,0,1,4,27,31,springer
2012-01-01,1,0,0,0,1,5,43,48,springer
2012-01-01,1,1,0,0,1,15,78,93,springer
2012-01-01,1,2,0,0,1,16,59,75,springer
2012-01-01,1,3,0,0,1,11,41,52,springer
2012-01-01,1,4,0,0,1,0,8,8,springer
2012-01-01,1,5,0,0,1,0,5,5,springer
2012-01-01,1,6,0,0,1,1,1,2,springer
2012-01-01,1,7,0,0,1,1,6,7,springer
2012-01-01,1,8,0,0,1,4,10,14,springer
2012-01-01,1,9,0,0,1,13,27,40,springer
2012-01-01,1,10,0,0,1,18,52,70,springer
2012-01-01,1,11,0,0,1,40,98,138,springer
2012-01-01,1,12,0,0,1,58,143,201,springer
2012-01-01,1,13,0,0,1,82,141,223,springer
2012-01-01,1,14,0,0,1,120,147,267,springer
2012-01-01,1,15,0,0,1,101,164,265,springer
2012-01-01,1,16,0,0,2,68,147,215,springer
2012-01-01,1,17,0,0,2,36,75,111,springer
2012-01-01,1,18,0,0,3,25,81,106,springer
2012-01-01,1,19,0,0,3,20,85,105,springer
2012-01-01,1,20,0,0,2,25,58,83,springer
2012-01-01,1,21,0,0,2,10,61,71,springer
2012-01-01,1,22,0,0,1,13,53,66,springer
2012-01-01,1,23,0,0,1,4,25,29,springer
2012-01-02,1,0,1,0,1,8,31,39,springer
2012-01-02,1,1,1,0,1,1,11,12,springer
2012-01-02,1,2,1,0,1,1,6,7,springer
2012-01-02,1,4,1,0,1,0,4,4,springer
2012-01-02,1,5,1,0,1,1,3,4,springer
2012-01-02,1,6,1,0,1,0,14,14,springer
2012-01-02,1,7,1,0,1,0,16,16,springer
2012-01-02,1,8,1,0,1,2,51,53,springer
2012-01-02,1,9,1,0,1,15,53,68,springer
2012-01-02,1,10,1,0,1,20,89,109,springer
2012-01-02,1,11,1,0,1,33,142,175,springer
2012-01-02,1,12,1,0,1,41,161,202,springer
2012-01-02,1,13,1,0,1,26,150,176,springer
2012-01-02,1,14,1,0,1,10,141,151,springer
2012-01-02,1,15,1,0,1,29,139,168,springer
2012-01-02,1,16,1,0,1,10,144,154,springer
2012-01-02,1,17,1,0,1,17,136,153,springer
2012-01-02,1,18,1,0,1,13,113,126,springer
2012-01-02,1,19,1,0,1,4,89,93,springer
2012-01-02,1,20,1,0,1,5,83,88,springer
2012-01-02,1,21,1,0,2,3,63,66,springer
2012-01-02,1,22,1,0,2,3,36,39,springer
2012-01-02,1,23,1,0,1,2,32,34,springer
2012-01-03,1,0,0,1,1,0,13,13,springer
2012-01-03,1,1,0,1,1,1,5,6,springer
2012-01-03,1,2,0,1,1,0,3,3,springer
2012-01-03,1,3,0,1,1,0,2,2,springer
2012-01-03,1,4,0,1,1,0,5,5,springer
2012-01-03,1,5,0,1,1,0,12,12,springer
2012-01-03,1,6,0,1,1,4,81,85,springer
2012-01-03,1,7,0,1,1,2,168,170,springer
2012-01-03,1,8,0,1,1,5,349,354,springer
2012-01-03,1,9,0,1,1,8,145,153,springer
2012-01-03,1,10,0,1,1,5,55,60,springer
2012-01-03,1,11,0,1,1,12,63,75,springer
2012-01-03,1,12,0,1,1,4,70,74,springer
2012-01-03,1,13,0,1,1,5,68,73,springer
2012-01-03,1,14,0,1,1,7,72,79,springer
2012-01-03,1,15,0,1,1,9,68,77,springer
2012-01-03,1,16,0,1,1,7,129,136,springer
2012-01-03,1,17,0,1,1,4,241,245,springer
2012-01-03,1,18,0,1,1,10,214,224,springer
2012-01-03,1,19,0,1,1,4,152,156,springer
2012-01-03,1,20,0,1,1,0,115,115,springer
2012-01-03,1,21,0,1,1,2,66,68,springer
2012-01-03,1,22,0,1,1,0,33,33,springer
2012-01-03,1,23,0,1,1,0,18,18,springer
2012-01-04,1,0,0,1,1,0,9,9,springer
2012-01-04,1,1,0,1,1,0,3,3,springer
2012-01-04,1,2,0,1,1,0,1,1,springer
2012-01-04,1,3,0,1,1,0,1,1,springer
2012-01-04,1,4,0,1,1,0,2,2,springer
2012-01-04,1,5,0,1,1,0,14,14,springer
2012-01-04,1,6,0,1,1,0,59,59,springer
2012-01-04,1,7,0,1,1,1,151,152,springer
2012-01-04,1,8,0,1,1,5,310,315,springer
2012-01-04,1,9,0,1,1,7,173,180,springer
2012-01-04,1,10,0,1,1,7,57,64,springer
2012-01-04,1,11,0,1,2,6,40,46,springer
2012-01-04,1,12,0,1,2,9,75,84,springer
2012-01-04,1,13,0,1,2,9,82,91,springer
2012-01-04,1,14,0,1,2,6,69,75,springer
2012-01-04,1,15,0,1,2,9,81,90,springer
2012-01-04,1,16,0,1,2,8,123,131,springer
2012-01-04,1,17,0,1,2,9,272,281,springer
2012-01-04,1,18,0,1,2,9,280,289,springer
2012-01-04,1,19,0,1,2,2,182,184,springer
2012-01-04,1,20,0,1,2,2,121,123,springer
2012-01-04,1,21,0,1,2,2,88,90,springer
2012-01-04,1,22,0,1,2,4,48,52,springer
2012-01-04,1,23,0,1,2,0,32,32,springer
2012-01-05,1,0,0,1,2,1,13,14,springer
2012-01-05,1,1,0,1,1,0,5,5,springer
2012-01-05,1,2,0,1,1,0,4,4,springer
2012-01-05,1,3,0,1,1,0,4,4,springer
2012-01-05,1,4,0,1,2,0,5,5,springer
2012-01-05,1,5,0,1,2,0,26,26,springer
2012-01-05,1,6,0,1,2,0,78,78,springer
2012-01-05,1,7,0,1,2,3,212,215,springer
2012-01-05,1,8,0,1,2,11,377,388,springer
2012-01-05,1,9,0,1,2,7,220,227,springer
2012-01-05,1,10,0,1,2,5,81,86,springer
2012-01-05,1,11,0,1,1,6,78,84,springer
2012-01-05,1,12,0,1,1,6,114,120,springer
2012-01-05,1,13,0,1,1,6,112,118,springer
2012-01-05,1,14,0,1,1,13,104,117,springer
2012-01-05,1,15,0,1,1,6,113,119,springer
2012-01-05,1,16,0,1,1,19,178,197,springer
2012-01-05,1,17,0,1,2,19,393,412,springer
2012-01-05,1,18,0,1,1,9,374,383,springer
2012-01-05,1,19,0,1,1,10,255,265,springer
2012-01-05,1,20,0,1,1,5,172,177,springer
2012-01-05,1,21,0,1,1,9,88,97,springer
2012-01-05,1,22,0,1,1,1,70,71,springer
2012-01-05,1,23,0,1,1,4,56,60,springer
2012-01-06,1,0,0,1,1,1,24,25,springer
2012-01-06,1,1,0,1,1,2,6,8,springer
2012-01-06,1,2,0,1,1,2,3,5,springer
2012-01-06,1,3,0,1,1,1,3,4,springer
2012-01-06,1,4,0,1,1,0,3,3,springer
2012-01-06,1,5,0,1,2,0,13,13,springer
2012-01-06,1,6,0,1,2,1,69,70,springer
2012-01-06,1,7,0,1,2,4,201,205,springer
2012-01-06,1,8,0,1,1,11,436,447,springer
2012-01-06,1,9,0,1,1,4,237,241,springer
2012-01-06,1,10,0,1,1,14,102,116,springer
2012-01-06,1,11,0,1,1,8,130,138,springer
2012-01-06,1,12,0,1,1,23,168,191,springer
2012-01-06,1,13,0,1,1,16,188,204,springer
2012-01-06,1,14,0,1,1,26,152,178,springer
2012-01-06,1,15,0,1,1,44,178,222,springer
2012-01-06,1,16,0,1,1,35,259,294,springer
2012-01-06,1,17,0,1,1,20,456,476,springer
2012-01-06,1,18,0,1,1,28,391,419,springer
2012-01-06,1,19,0,1,1,11,261,272,springer
2012-01-06,1,20,0,1,1,14,163,177,springer
2012-01-06,1,21,0,1,1,17,137,154,springer
2012-01-06,1,22,0,1,1,12,123,135,springer
2012-01-06,1,23,0,1,1,13,88,101,springer
2012-01-07,1,0,0,0,1,2,77,79,springer
2012-01-07,1,1,0,0,1,6,56,62,springer
2012-01-07,1,2,0,0,1,2,36,38,springer
2012-01-07,1,3,0,0,1,1,19,20,springer
2012-01-07,1,4,0,0,1,1,9,10,springer
2012-01-07,1,5,0,0,1,2,7,9,springer
2012-01-07,1,6,0,0,1,0,7,7,springer
2012-01-07,1,7,0,0,1,0,20,20,springer
2012-01-07,1,8,0,0,1,0,64,64,springer
2012-01-07,1,9,0,0,1,14,116,130,springer
2012-01-07,1,10,0,0,1,43,160,203,springer
2012-01-07,1,11,0,0,1,74,250,324,springer
2012-01-07,1,12,0,0,1,100,276,376,springer
2012-01-07,1,13,0,0,1,149,296,445,springer
2012-01-07,1,14,0,0,1,156,356,512,springer
2012-01-07,1,15,0,0,1,132,317,449,springer
2012-01-07,1,16,0,0,2,133,268,401,springer
2012-01-07,1,17,0,0,2,87,235,322,springer
2012-01-07,1,18,0,0,1,49,248,297,springer
2012-01-07,1,19,0,0,1,44,171,215,springer
2012-01-07,1,20,0,0,1,21,149,170,springer
2012-01-07,1,21,0,0,1,22,118,140,springer
2012-01-07,1,22,0,0,1,16,93,109,springer
2012-01-07,1,23,0,0,1,16,103,119,springer
2012-01-08,1,0,0,0,1,14,77,91,springer
2012-01-08,1,1,0,0,1,10,62,72,springer
2012-01-08,1,2,0,0,1,10,57,67,springer
2012-01-08,1,3,0,0,1,6,26,32,springer
2012-01-08,1,4,0,0,1,2,4,6,springer
2012-01-08,1,5,0,0,2,0,2,2,springer
2012-01-08,1,6,0,0,2,0,2,2,springer
2012-01-08,1,7,0,0,2,1,23,24,springer
2012-01-08,1,8,0,0,1,4,53,57,springer
2012-01-08,1,9,0,0,1,23,102,125,springer
2012-01-08,1,10,0,0,1,27,181,208,springer
2012-01-08,1,11,0,0,1,55,201,256,springer
2012-01-08,1,12,0,0,1,78,273,351,springer
2012-01-08,1,13,0,0,1,77,266,343,springer
2012-01-08,1,14,0,0,1,75,253,328,springer
2012-01-08,1,15,0,0,1,89,241,330,springer
2012-01-08,1,16,0,0,1,58,256,314,springer
2012-01-08,1,17,0,0,1,22,197,219,springer
2012-01-08,1,18,0,0,1,19,162,181,springer
2012-01-08,1,19,0,0,1,8,104,112,springer
2012-01-08,1,20,0,0,1,7,119,126,springer
2012-01-08,1,21,0,0,1,10,81,91,springer
2012-01-08,1,22,0,0,1,4,54,58,springer
2012-01-08,1,23,0,0,1,0,30,30,springer
2012-01-09,1,0,0,1,1,3,12,15,springer
2012-01-09,1,1,0,1,1,1,4,5,springer
2012-01-09,1,2,0,1,1,2,3,5,springer
2012-01-09,1,3,0,1,1,0,3,3,springer
2012-01-09,1,4,0,1,1,0,4,4,springer
2012-01-09,1,5,0,1,2,0,21,21,springer
2012-01-09,1,6,0,1,2,3,85,88,springer
2012-01-09,1,7,0,1,2,1,239,240,springer
2012-01-09,1,8,0,1,2,13,407,420,springer
2012-01-09,1,9,0,1,2,9,188,197,springer
2012-01-09,1,10,0,1,1,13,95,108,springer
2012-01-09,1,11,0,1,2,6,82,88,springer
2012-01-09,1,12,0,1,2,10,93,103,springer
2012-01-09,1,13,0,1,2,3,77,80,springer
2012-01-09,1,14,0,1,3,5,45,50,springer
2012-01-09,1,15,0,1,3,5,64,69,springer
2012-01-09,1,16,0,1,3,3,46,49,springer
2012-01-09,1,17,0,1,3,5,147,152,springer
2012-01-09,1,18,0,1,4,6,158,164,springer
2012-01-09,1,19,0,1,3,3,187,190,springer
2012-01-09,1,20,0,1,2,5,127,132,springer
2012-01-09,1,21,0,1,2,1,78,79,springer
2012-01-09,1,22,0,1,2,8,54,62,springer
2012-01-09,1,23,0,1,2,1,51,52,springer
2012-01-10,1,0,0,1,2,0,14,14,springer
2012-01-10,1,1,0,1,2,2,3,5,springer
2012-01-10,1,2,0,1,2,2,2,4,springer
2012-01-10,1,4,0,1,2,0,4,4,springer
2012-01-10,1,5,0,1,1,0,23,23,springer
2012-01-10,1,6,0,1,2,0,79,79,springer
2012-01-10,1,7,0,1,2,3,219,222,springer
2012-01-10,1,8,0,1,2,6,465,471,springer
2012-01-10,1,9,0,1,2,11,184,195,springer
2012-01-10,1,10,0,1,2,3,80,83,springer
2012-01-10,1,11,0,1,1,8,93,101,springer
2012-01-10,1,12,0,1,1,13,127,140,springer
2012-01-10,1,13,0,1,1,15,163,178,springer
2012-01-10,1,14,0,1,1,10,96,106,springer
2012-01-10,1,15,0,1,1,17,119,136,springer
2012-01-10,1,16,0,1,1,15,225,240,springer
2012-01-10,1,17,0,1,1,14,446,460,springer
2012-01-10,1,18,0,1,1,13,372,385,springer
2012-01-10,1,19,0,1,1,11,270,281,springer
2012-01-10,1,20,0,1,1,10,190,200,springer
2012-01-10,1,21,0,1,1,7,109,116,springer
2012-01-10,1,22,0,1,1,10,104,114,springer
2012-01-10,1,23,0,1,1,3,38,41,springer
2012-01-11,1,0,0,1,1,2,26,28,springer
2012-01-11,1,1,0,1,1,1,6,7,springer
2012-01-11,1,2,0,1,1,0,5,5,springer
2012-01-11,1,3,0,1,1,0,4,4,springer
2012-01-11,1,4,0,1,1,0,2,2,springer
2012-01-11,1,5,0,1,1,0,22,22,springer
2012-01-11,1,6,0,1,1,2,72,74,springer
2012-01-11,1,7,0,1,1,9,247,256,springer
2012-01-11,1,8,0,1,1,11,488,499,springer
2012-01-11,1,9,0,1,2,7,218,225,springer
2012-01-11,1,10,0,1,2,13,84,97,springer
2012-01-11,1,11,0,1,2,9,90,99,springer
2012-01-11,1,12,0,1,3,4,51,55,springer
2012-01-11,1,13,0,1,3,8,57,65,springer
2012-01-11,1,14,0,1,3,3,70,73,springer
2012-01-11,1,15,0,1,2,6,73,79,springer
2012-01-11,1,16,0,1,2,6,112,118,springer
2012-01-11,1,17,0,1,3,6,128,134,springer
2012-01-11,1,18,0,1,3,2,96,98,springer
2012-01-11,1,19,0,1,3,1,92,93,springer
2012-01-11,1,20,0,1,3,2,55,57,springer
2012-01-11,1,21,0,1,3,0,29,29,springer
2012-01-11,1,22,0,1,3,0,49,49,springer
2012-01-11,1,23,0,1,3,0,9,9,springer
2012-01-12,1,0,0,1,3,0,3,3,springer
2012-01-12,1,1,0,1,3,0,3,3,springer
2012-01-12,1,2,0,1,3,1,1,2,springer
2012-01-12,1,3,0,1,3,0,3,3,springer
2012-01-12,1,4,0,1,3,0,2,2,springer
2012-01-12,1,5,0,1,3,0,16,16,springer
2012-01-12,1,6,0,1,3,1,88,89,springer
2012-01-12,1,7,0,1,2,2,218,220,springer
2012-01-12,1,8,0,1,1,11,497,508,springer
2012-01-12,1,9,0,1,1,10,220,230,springer
2012-01-12,1,10,0,1,1,6,84,90,springer
2012-01-12,1,11,0,1,2,18,101,119,springer
2012-01-12,1,12,0,1,2,14,130,144,springer
2012-01-12,1,13,0,1,1,13,170,183,springer
2012-01-12,1,14,0,1,1,24,132,156,springer
2012-01-12,1,15,0,1,1,32,156,188,springer
2012-01-12,1,16,0,1,1,33,248,281,springer
2012-01-12,1,17,0,1,1,23,472,495,springer
2012-01-12,1,18,0,1,1,22,399,421,springer
2012-01-12,1,19,0,1,2,17,313,330,springer
2012-01-12,1,20,0,1,2,11,229,240,springer
2012-01-12,1,21,0,1,1,12,162,174,springer
2012-01-12,1,22,0,1,1,12,121,133,springer
2012-01-12,1,23,0,1,1,7,60,67,springer
2012-01-13,1,0,0,1,2,4,38,42,springer
2012-01-13,1,1,0,1,2,0,12,12,springer
2012-01-13,1,2,0,1,1,1,13,14,springer
2012-01-13,1,3,0,1,1,3,4,7,springer
2012-01-13,1,4,0,1,3,1,2,3,springer
2012-01-13,1,5,0,1,2,0,21,21,springer
2012-01-13,1,6,0,1,2,2,71,73,springer
2012-01-13,1,7,0,1,1,3,174,177,springer
2012-01-13,1,8,0,1,1,11,408,419,springer
2012-01-13,1,9,0,1,1,10,204,214,springer
2012-01-13,1,10,0,1,1,2,101,103,springer
2012-01-13,1,11,0,1,1,12,102,114,springer
2012-01-13,1,12,0,1,1,14,140,154,springer
2012-01-13,1,13,0,1,1,14,140,154,springer
2012-01-13,1,14,0,1,1,10,119,129,springer
2012-01-13,1,15,0,1,1,15,123,138,springer
2012-01-13,1,16,0,1,1,18,215,233,springer
2012-01-13,1,17,0,1,1,15,317,332,springer
2012-01-13,1,18,0,1,1,7,294,301,springer
2012-01-13,1,19,0,1,1,7,199,206,springer
2012-01-13,1,20,0,1,1,6,130,136,springer
2012-01-13,1,21,0,1,1,7,95,102,springer
2012-01-13,1,22,0,1,1,7,58,65,springer
2012-01-13,1,23,0,1,1,5,60,65,springer
2012-01-14,1,0,0,0,1,2,42,44,springer
2012-01-14,1,1,0,0,1,6,44,50,springer
2012-01-14,1,2,0,0,1,6,32,38,springer
2012-01-14,1,3,0,0,1,6,14,20,springer
2012-01-14,1,4,0,0,1,0,3,3,springer
2012-01-14,1,5,0,0,1,0,4,4,springer
2012-01-14,1,6,0,0,1,0,5,5,springer
2012-01-14,1,7,0,0,1,0,24,24,springer
2012-01-14,1,8,0,0,1,3,89,92,springer
2012-01-14,1,9,0,0,1,3,78,81,springer
2012-01-14,1,10,0,0,1,14,135,149,springer
2012-01-14,1,11,0,0,1,28,150,178,springer
2012-01-14,1,12,0,0,1,30,189,219,springer
2012-01-14,1,13,0,0,1,38,182,220,springer
2012-01-14,1,14,0,0,1,52,179,231,springer
2012-01-14,1,15,0,0,1,49,177,226,springer
2012-01-14,1,16,0,0,1,28,178,206,springer
2012-01-14,1,17,0,0,1,15,129,144,springer
2012-01-14,1,18,0,0,1,21,122,143,springer
2012-01-14,1,19,0,0,1,12,90,102,springer
2012-01-14,1,20,0,0,1,8,95,103,springer
2012-01-14,1,21,0,0,1,3,66,69,springer
2012-01-14,1,22,0,0,1,4,62,66,springer
2012-01-14,1,23,0,0,1,5,71,76,springer
2012-01-15,1,0,0,0,1,9,50,59,springer
2012-01-15,1,1,0,0,2,2,40,42,springer
2012-01-15,1,2,0,0,2,5,38,43,springer
2012-01-15,1,3,0,0,2,1,24,25,springer
2012-01-15,1,4,0,0,2,1,5,6,springer
2012-01-15,1,5,0,0,2,0,5,5,springer
2012-01-15,1,6,0,0,2,1,7,8,springer
2012-01-15,1,7,0,0,1,3,14,17,springer
2012-01-15,1,8,0,0,1,2,34,36,springer
2012-01-15,1,9,0,0,1,10,80,90,springer
2012-01-15,1,10,0,0,1,11,115,126,springer
2012-01-15,1,11,0,0,1,21,144,165,springer
2012-01-15,1,12,0,0,1,42,192,234,springer
2012-01-15,1,13,0,0,1,40,184,224,springer
2012-01-15,1,14,0,0,1,25,163,188,springer
2012-01-15,1,15,0,0,1,33,173,206,springer
2012-01-15,1,16,0,0,1,31,174,205,springer
2012-01-15,1,17,0,0,1,15,131,146,springer
2012-01-15,1,18,0,0,1,7,113,120,springer
2012-01-15,1,19,0,0,1,9,101,110,springer
2012-01-15,1,20,0,0,1,10,85,95,springer
2012-01-15,1,21,0,0,1,1,71,72,springer
2012-01-15,1,22,0,0,1,2,58,60,springer
2012-01-15,1,23,0,0,1,3,26,29,springer
2012-01-16,1,0,1,0,1,2,23,25,springer
2012-01-16,1,1,1,0,1,2,18,20,springer
2012-01-16,1,2,1,0,1,3,14,17,springer
2012-01-16,1,3,1,0,1,0,3,3,springer
2012-01-16,1,4,1,0,1,2,6,8,springer
2012-01-16,1,5,1,0,1,1,5,6,springer
2012-01-16,1,6,1,0,1,0,13,13,springer
2012-01-16,1,7,1,0,1,5,28,33,springer
2012-01-16,1,8,1,0,1,3,75,78,springer
2012-01-16,1,9,1,0,1,7,89,96,springer
2012-01-16,1,10,1,0,2,19,107,126,springer
2012-01-16,1,11,1,0,1,21,158,179,springer
2012-01-16,1,12,1,0,1,20,165,185,springer
2012-01-16,1,13,1,0,2,26,202,228,springer
2012-01-16,1,14,1,0,1,23,158,181,springer
2012-01-16,1,15,1,0,1,17,175,192,springer
2012-01-16,1,16,1,0,1,22,158,180,springer
2012-01-16,1,17,1,0,1,19,174,193,springer
2012-01-16,1,18,1,0,1,6,175,181,springer
2012-01-16,1,19,1,0,1,10,134,144,springer
2012-01-16,1,20,1,0,1,2,88,90,springer
2012-01-16,1,21,1,0,1,3,46,49,springer
2012-01-16,1,22,1,0,2,4,39,43,springer
2012-01-16,1,23,1,0,3,0,28,28,springer
2012-01-17,1,0,0,1,2,0,12,12,springer
2012-01-17,1,1,0,1,2,0,2,2,springer
2012-01-17,1,2,0,1,3,0,12,12,springer
2012-01-17,1,4,0,1,3,0,2,2,springer
2012-01-17,1,5,0,1,3,0,13,13,springer
2012-01-17,1,6,0,1,3,0,57,57,springer
2012-01-17,1,7,0,1,3,5,121,126,springer
2012-01-17,1,8,0,1,3,3,90,93,springer
2012-01-17,1,9,0,1,3,7,61,68,springer
2012-01-17,1,10,0,1,3,1,61,62,springer
2012-01-17,1,11,0,1,2,2,73,75,springer
2012-01-17,1,12,0,1,2,3,83,86,springer
2012-01-17,1,13,0,1,2,8,95,103,springer
2012-01-17,1,14,0,1,1,12,120,132,springer
2012-01-17,1,15,0,1,1,6,123,129,springer
2012-01-17,1,16,0,1,1,14,205,219,springer
2012-01-17,1,17,0,1,1,20,442,462,springer
2012-01-17,1,18,0,1,1,12,451,463,springer
2012-01-17,1,19,0,1,1,11,297,308,springer
2012-01-17,1,20,0,1,1,11,169,180,springer
2012-01-17,1,21,0,1,1,6,174,180,springer
2012-01-17,1,22,0,1,1,5,85,90,springer
2012-01-17,1,23,0,1,1,1,60,61,springer
2012-01-18,1,0,0,1,2,3,14,17,springer
2012-01-18,1,1,0,1,2,0,10,10,springer
2012-01-18,1,2,0,1,2,1,1,2,springer
2012-01-18,1,3,0,1,2,1,3,4,springer
2012-01-18,1,4,0,1,1,0,1,1,springer
2012-01-18,1,5,0,1,1,0,29,29,springer
2012-01-18,1,6,0,1,1,0,88,88,springer
2012-01-18,1,7,0,1,1,1,262,263,springer
2012-01-18,1,8,0,1,1,15,474,489,springer
2012-01-18,1,9,0,1,1,6,196,202,springer
2012-01-18,1,10,0,1,1,5,88,93,springer
2012-01-18,1,11,0,1,1,4,110,114,springer
2012-01-18,1,12,0,1,1,6,155,161,springer
2012-01-18,1,13,0,1,1,6,124,130,springer
2012-01-18,1,14,0,1,1,7,98,105,springer
2012-01-18,1,15,0,1,1,8,122,130,springer
2012-01-18,1,16,0,1,1,13,163,176,springer
2012-01-18,1,17,0,1,1,8,338,346,springer
2012-01-18,1,18,0,1,1,8,347,355,springer
2012-01-18,1,19,0,1,1,5,251,256,springer
2012-01-18,1,20,0,1,1,1,164,165,springer
2012-01-18,1,21,0,1,1,5,119,124,springer
2012-01-18,1,22,0,1,1,4,74,78,springer
2012-01-18,1,23,0,1,1,2,36,38,springer
2012-01-19,1,0,0,1,1,0,16,16,springer
2012-01-19,1,1,0,1,1,0,5,5,springer
2012-01-19,1,2,0,1,1,0,3,3,springer
2012-01-19,1,3,0,1,1,0,4,4,springer
2012-01-19,1,4,0,1,1,0,1,1,springer
2012-01-19,1,5,0,1,1,0,19,19,springer
2012-01-19,1,6,0,1,1,0,86,86,springer
2012-01-19,1,7,0,1,1,2,204,206,springer
2012-01-19,1,8,0,1,1,9,414,423,springer
2012-01-19,1,9,0,1,1,6,204,210,springer
2012-01-19,1,10,0,1,1,10,98,108,springer
2012-01-19,1,11,0,1,1,6,93,99,springer
2012-01-19,1,12,0,1,1,5,106,111,springer
2012-01-19,1,13,0,1,1,6,118,124,springer
2012-01-19,1,14,0,1,1,15,104,119,springer
2012-01-19,1,15,0,1,1,9,118,127,springer
2012-01-19,1,16,0,1,1,8,185,193,springer
2012-01-19,1,17,0,1,2,21,364,385,springer
2012-01-19,1,18,0,1,2,16,345,361,springer
2012-01-19,1,19,0,1,2,5,229,234,springer
2012-01-19,1,20,0,1,1,7,184,191,springer
2012-01-19,1,21,0,1,1,4,117,121,springer
2012-01-19,1,22,0,1,2,0,90,90,springer
2012-01-19,1,23,0,1,1,1,55,56,springer
2012-01-20,1,0,0,1,2,3,24,27,springer
2012-01-20,1,1,0,1,1,0,15,15,springer
2012-01-20,1,2,0,1,1,0,11,11,springer
2012-01-20,1,3,0,1,1,0,4,4,springer
2012-01-20,1,4,0,1,1,0,3,3,springer
2012-01-20,1,5,0,1,1,0,19,19,springer
2012-01-20,1,6,0,1,1,0,68,68,springer
2012-01-20,1,7,0,1,1,2,183,185,springer
2012-01-20,1,8,0,1,1,4,421,425,springer
2012-01-20,1,9,0,1,1,21,242,263,springer
2012-01-20,1,10,0,1,2,1,96,97,springer
2012-01-20,1,11,0,1,2,6,117,123,springer
2012-01-20,1,12,0,1,2,5,119,124,springer
2012-01-20,1,13,0,1,1,12,144,156,springer
2012-01-20,1,14,0,1,2,8,107,115,springer
2012-01-20,1,15,0,1,2,12,144,156,springer
2012-01-20,1,16,0,1,2,11,163,174,springer
2012-01-20,1,17,0,1,2,9,340,349,springer
2012-01-20,1,18,0,1,2,5,296,301,springer
2012-01-20,1,19,0,1,2,6,186,192,springer
2012-01-20,1,20,0,1,2,1,141,142,springer
2012-01-20,1,21,0,1,2,5,99,104,springer
2012-01-20,1,22,0,1,2,1,71,72,springer
2012-01-20,1,23,0,1,3,3,35,38,springer
2012-01-21,1,0,0,0,3,0,24,24,springer
2012-01-21,1,1,0,0,4,1,22,23,springer
2012-01-21,1,2,0,0,3,1,25,26,springer
2012-01-21,1,3,0,0,3,0,13,13,springer
2012-01-21,1,4,0,0,3,0,1,1,springer
2012-01-21,1,5,0,0,3,0,2,2,springer
2012-01-21,1,6,0,0,3,0,1,1,springer
2012-01-21,1,7,0,0,3,3,10,13,springer
2012-01-21,1,8,0,0,2,3,22,25,springer
2012-01-21,1,9,0,0,2,2,40,42,springer
2012-01-21,1,10,0,0,3,0,45,45,springer
2012-01-21,1,11,0,0,2,1,62,63,springer
2012-01-21,1,12,0,0,2,5,62,67,springer
2012-01-21,1,13,0,0,2,10,66,76,springer
2012-01-21,1,14,0,0,3,6,89,95,springer
2012-01-21,1,15,0,0,3,6,113,119,springer
2012-01-21,1,16,0,0,2,5,113,118,springer
2012-01-21,1,17,0,0,2,7,99,106,springer
2012-01-21,1,18,0,0,2,3,107,110,springer
2012-01-21,1,19,0,0,2,0,85,85,springer
2012-01-21,1,20,0,0,2,5,62,67,springer
2012-01-21,1,21,0,0,1,5,64,69,springer
2012-01-21,1,22,0,0,2,3,56,59,springer
2012-01-21,1,23,0,0,2,1,51,52,springer
2012-01-22,1,0,0,0,1,1,51,52,springer
2012-01-22,1,1,0,0,2,1,49,50,springer
2012-01-22,1,2,0,0,2,1,46,47,springer
2012-01-22,1,3,0,0,2,1,20,21,springer
2012-01-22,1,4,0,0,3,1,1,2,springer
2012-01-22,1,5,0,0,3,1,2,3,springer
2012-01-22,1,6,0,0,2,0,4,4,springer
2012-01-22,1,7,0,0,2,2,11,13,springer
2012-01-22,1,8,0,0,2,3,29,32,springer
2012-01-22,1,9,0,0,2,9,54,63,springer
2012-01-22,1,10,0,0,2,9,120,129,springer
2012-01-22,1,11,0,0,3,18,115,133,springer
2012-01-22,1,12,0,0,2,24,161,185,springer
2012-01-22,1,13,0,0,2,24,175,199,springer
2012-01-22,1,14,0,0,2,19,163,182,springer
2012-01-22,1,15,0,0,2,27,149,176,springer
2012-01-22,1,16,0,0,2,12,143,155,springer
2012-01-22,1,17,0,0,2,8,100,108,springer
2012-01-22,1,18,0,0,3,11,110,121,springer
2012-01-22,1,19,0,0,3,9,80,89,springer
2012-01-22,1,20,0,0,3,5,69,74,springer
2012-01-22,1,21,0,0,3,8,36,44,springer
2012-01-22,1,22,0,0,2,0,58,58,springer
2012-01-22,1,23,0,0,2,2,35,37,springer
2012-01-23,1,0,0,1,2,2,17,19,springer
2012-01-23,1,1,0,1,2,0,4,4,springer
2012-01-23,1,2,0,1,2,0,2,2,springer
2012-01-23,1,3,0,1,2,0,1,1,springer
2012-01-23,1,4,0,1,2,0,1,1,springer
2012-01-23,1,5,0,1,2,0,19,19,springer
2012-01-23,1,6,0,1,2,6,36,42,springer
2012-01-23,1,7,0,1,3,8,114,122,springer
2012-01-23,1,8,0,1,3,5,267,272,springer
2012-01-23,1,9,0,1,2,13,198,211,springer
2012-01-23,1,10,0,1,2,10,139,149,springer
2012-01-23,1,11,0,1,2,5,57,62,springer
2012-01-23,1,12,0,1,2,10,52,62,springer
2012-01-23,1,13,0,1,3,5,32,37,springer
2012-01-23,1,14,0,1,3,13,48,61,springer
2012-01-23,1,15,0,1,2,10,64,74,springer
2012-01-23,1,16,0,1,2,14,108,122,springer
2012-01-23,1,17,0,1,2,6,270,276,springer
2012-01-23,1,18,0,1,2,7,275,282,springer
2012-01-23,1,19,0,1,2,9,211,220,springer
2012-01-23,1,20,0,1,2,8,161,169,springer
2012-01-23,1,21,0,1,2,8,112,120,springer
2012-01-23,1,22,0,1,2,4,64,68,springer
2012-01-23,1,23,0,1,2,2,35,37,springer
2012-01-24,1,0,0,1,2,6,19,25,springer
2012-01-24,1,1,0,1,2,2,7,9,springer
2012-01-24,1,2,0,1,2,2,6,8,springer
2012-01-24,1,3,0,1,2,0,3,3,springer
2012-01-24,1,4,0,1,2,0,2,2,springer
2012-01-24,1,5,0,1,2,0,26,26,springer
2012-01-24,1,6,0,1,2,1,88,89,springer
2012-01-24,1,7,0,1,2,11,221,232,springer
2012-01-24,1,8,0,1,2,11,479,490,springer
2012-01-24,1,9,0,1,2,11,244,255,springer
2012-01-24,1,10,0,1,1,23,93,116,springer
2012-01-24,1,11,0,1,1,30,123,153,springer
2012-01-24,1,12,0,1,1,25,150,175,springer
2012-01-24,1,13,0,1,1,33,170,203,springer
2012-01-24,1,14,0,1,1,35,138,173,springer
2012-01-24,1,15,0,1,2,52,156,208,springer
2012-01-24,1,16,0,1,1,35,243,278,springer
2012-01-24,1,17,0,1,1,41,474,515,springer
2012-01-24,1,18,0,1,1,32,391,423,springer
2012-01-24,1,19,0,1,1,20,311,331,springer
2012-01-24,1,20,0,1,1,18,211,229,springer
2012-01-24,1,21,0,1,1,18,154,172,springer
2012-01-24,1,22,0,1,1,14,111,125,springer
2012-01-24,1,23,0,1,1,19,80,99,springer
2012-01-25,1,0,0,1,1,6,25,31,springer
2012-01-25,1,1,0,1,1,4,9,13,springer
2012-01-25,1,2,0,1,1,3,3,6,springer
2012-01-25,1,3,0,1,1,0,1,1,springer
2012-01-25,1,4,0,1,1,0,4,4,springer
2012-01-25,1,5,0,1,1,0,33,33,springer
2012-01-25,1,6,0,1,1,1,87,88,springer
2012-01-25,1,7,0,1,1,14,243,257,springer
2012-01-25,1,8,0,1,1,18,495,513,springer
2012-01-25,1,9,0,1,1,18,218,236,springer
2012-01-25,1,10,0,1,2,30,111,141,springer
2012-01-25,1,11,0,1,2,52,105,157,springer
2012-01-25,1,12,0,1,1,46,147,193,springer
2012-01-25,1,13,0,1,1,63,149,212,springer
2012-01-25,1,14,0,1,1,53,107,160,springer
2012-01-25,1,15,0,1,1,30,125,155,springer
2012-01-25,1,16,0,1,1,29,217,246,springer
2012-01-25,1,17,0,1,1,27,443,470,springer
2012-01-25,1,18,0,1,1,24,415,439,springer
2012-01-25,1,19,0,1,2,5,311,316,springer
2012-01-25,1,20,0,1,1,10,225,235,springer
2012-01-25,1,21,0,1,1,19,166,185,springer
2012-01-25,1,22,0,1,1,12,101,113,springer
2012-01-25,1,23,0,1,2,3,63,66,springer
2012-01-26,1,0,0,1,2,3,22,25,springer
2012-01-26,1,1,0,1,2,5,16,21,springer
2012-01-26,1,2,0,1,2,1,6,7,springer
2012-01-26,1,3,0,1,2,1,5,6,springer
2012-01-26,1,4,0,1,1,0,3,3,springer
2012-01-26,1,5,0,1,2,0,28,28,springer
2012-01-26,1,6,0,1,2,0,88,88,springer
2012-01-26,1,7,0,1,2,11,228,239,springer
2012-01-26,1,8,0,1,2,16,514,530,springer
2012-01-26,1,9,0,1,2,18,256,274,springer
2012-01-26,1,10,0,1,2,16,92,108,springer
2012-01-26,1,11,0,1,2,11,100,111,springer
2012-01-26,1,12,0,1,2,29,136,165,springer
2012-01-26,1,13,0,1,2,17,156,173,springer
2012-01-26,1,14,0,1,2,16,112,128,springer
2012-01-26,1,15,0,1,2,22,142,164,springer
2012-01-26,1,16,0,1,2,15,209,224,springer
2012-01-26,1,17,0,1,2,16,397,413,springer
2012-01-26,1,18,0,1,2,12,394,406,springer
2012-01-26,1,19,0,1,2,11,302,313,springer
2012-01-26,1,20,0,1,2,8,216,224,springer
2012-01-26,1,21,0,1,2,8,184,192,springer
2012-01-26,1,22,0,1,1,3,139,142,springer
2012-01-26,1,23,0,1,2,5,86,91,springer
2012-01-27,1,0,0,1,2,6,32,38,springer
2012-01-27,1,1,0,1,2,6,23,29,springer
2012-01-27,1,2,0,1,1,2,11,13,springer
2012-01-27,1,3,0,1,2,3,5,8,springer
2012-01-27,1,4,0,1,2,1,3,4,springer
2012-01-27,1,5,0,1,2,0,24,24,springer
2012-01-27,1,6,0,1,2,0,72,72,springer
2012-01-27,1,7,0,1,2,6,128,134,springer
2012-01-27,1,8,0,1,3,14,206,220,springer
2012-01-27,1,9,0,1,3,6,101,107,springer
2012-01-27,1,10,0,1,3,9,117,126,springer
2012-01-27,1,11,0,1,2,10,95,105,springer
2012-01-27,1,12,0,1,2,25,155,180,springer
2012-01-27,1,13,0,1,1,26,175,201,springer
2012-01-27,1,14,0,1,1,23,153,176,springer
2012-01-27,1,15,0,1,1,27,170,197,springer
2012-01-27,1,16,0,1,1,26,241,267,springer
2012-01-27,1,17,0,1,1,16,406,422,springer
2012-01-27,1,18,0,1,1,20,363,383,springer
2012-01-27,1,19,0,1,1,10,241,251,springer
2012-01-27,1,20,0,1,1,6,153,159,springer
2012-01-27,1,21,0,1,1,8,127,135,springer
2012-01-27,1,22,0,1,1,11,108,119,springer
2012-01-27,1,23,0,1,1,8,78,86,springer
2012-01-28,1,0,0,0,1,1,68,69,springer
2012-01-28,1,1,0,0,1,1,57,58,springer
2012-01-28,1,2,0,0,1,3,38,41,springer
2012-01-28,1,3,0,0,1,1,16,17,springer
2012-01-28,1,4,0,0,1,0,8,8,springer
2012-01-28,1,5,0,0,1,0,10,10,springer
2012-01-28,1,6,0,0,1,3,12,15,springer
2012-01-28,1,7,0,0,1,3,28,31,springer
2012-01-28,1,8,0,0,1,9,82,91,springer
2012-01-28,1,9,0,0,1,13,145,158,springer
2012-01-28,1,10,0,0,1,27,164,191,springer
2012-01-28,1,11,0,0,1,55,241,296,springer
2012-01-28,1,12,0,0,1,70,244,314,springer
2012-01-28,1,13,0,0,1,80,293,373,springer
2012-01-28,1,14,0,0,1,123,239,362,springer
2012-01-28,1,15,0,0,1,90,320,410,springer
2012-01-28,1,16,0,0,1,131,276,407,springer
2012-01-28,1,17,0,0,1,57,233,290,springer
2012-01-28,1,18,0,0,1,40,201,241,springer
2012-01-28,1,19,0,0,2,33,173,206,springer
2012-01-28,1,20,0,0,1,5,115,120,springer
2012-01-28,1,21,0,0,1,18,109,127,springer
2012-01-28,1,22,0,0,1,6,97,103,springer
2012-01-28,1,23,0,0,1,6,79,85,springer
2012-01-29,1,0,0,0,1,15,81,96,springer
2012-01-29,1,1,0,0,1,5,68,73,springer
2012-01-29,1,2,0,0,1,3,48,51,springer
2012-01-29,1,3,0,0,1,4,17,21,springer
2012-01-29,1,4,0,0,1,0,5,5,springer
2012-01-29,1,5,0,0,1,1,6,7,springer
2012-01-29,1,6,0,0,1,1,4,5,springer
2012-01-29,1,7,0,0,1,0,12,12,springer
2012-01-29,1,8,0,0,1,9,61,70,springer
2012-01-29,1,9,0,0,1,13,98,111,springer
2012-01-29,1,10,0,0,1,38,153,191,springer
2012-01-29,1,11,0,0,1,57,198,255,springer
2012-01-29,1,12,0,0,1,73,215,288,springer
2012-01-29,1,13,0,0,1,78,238,316,springer
2012-01-29,1,14,0,0,1,51,229,280,springer
2012-01-29,1,15,0,0,1,68,242,310,springer
2012-01-29,1,16,0,0,1,54,268,322,springer
2012-01-29,1,17,0,0,1,33,201,234,springer
2012-01-29,1,18,0,0,1,17,151,168,springer
2012-01-29,1,19,0,0,1,14,145,159,springer
2012-01-29,1,20,0,0,1,13,98,111,springer
2012-01-29,1,21,0,0,1,0,69,69,springer
2012-01-29,1,22,0,0,1,7,57,64,springer
2012-01-29,1,23,0,0,1,4,21,25,springer
2012-01-30,1,0,0,1,2,0,10,10,springer
2012-01-30,1,1,0,1,1,0,9,9,springer
2012-01-30,1,2,0,1,1,1,6,7,springer
2012-01-30,1,3,0,1,1,0,4,4,springer
2012-01-30,1,4,0,1,1,0,5,5,springer
2012-01-30,1,5,0,1,1,0,26,26,springer
2012-01-30,1,6,0,1,1,0,80,80,springer
2012-01-30,1,7,0,1,1,4,221,225,springer
2012-01-30,1,8,0,1,1,12,481,493,springer
2012-01-30,1,9,0,1,1,5,193,198,springer
2012-01-30,1,10,0,1,1,3,82,85,springer
2012-01-30,1,11,0,1,1,6,93,99,springer
2012-01-30,1,12,0,1,1,5,129,134,springer
2012-01-30,1,13,0,1,1,15,117,132,springer
2012-01-30,1,14,0,1,1,15,100,115,springer
2012-01-30,1,15,0,1,1,7,131,138,springer
2012-01-30,1,16,0,1,1,11,210,221,springer
2012-01-30,1,17,0,1,1,16,422,438,springer
2012-01-30,1,18,0,1,1,11,399,410,springer
2012-01-30,1,19,0,1,1,8,298,306,springer
2012-01-30,1,20,0,1,1,2,179,181,springer
2012-01-30,1,21,0,1,1,3,159,162,springer
2012-01-30,1,22,0,1,1,2,92,94,springer
2012-01-30,1,23,0,1,1,0,52,52,springer
2012-01-31,1,0,0,1,1,0,15,15,springer
2012-01-31,1,1,0,1,1,1,7,8,springer
2012-01-31,1,2,0,1,1,0,2,2,springer
2012-01-31,1,3,0,1,1,0,2,2,springer
2012-01-31,1,4,0,1,1,0,1,1,springer
2012-01-31,1,5,0,1,1,0,22,22,springer
2012-01-31,1,6,0,1,1,0,104,104,springer
2012-01-31,1,7,0,1,1,6,273,279,springer
2012-01-31,1,8,0,1,1,14,498,512,springer
2012-01-31,1,9,0,1,1,30,231,261,springer
2012-01-31,1,10,0,1,2,34,110,144,springer
2012-01-31,1,11,0,1,1,14,125,139,springer
2012-01-31,1,12,0,1,1,13,181,194,springer
2012-01-31,1,13,0,1,1,27,171,198,springer
2012-01-31,1,14,0,1,1,18,142,160,springer
2012-01-31,1,15,0,1,1,27,150,177,springer
2012-01-31,1,16,0,1,1,30,277,307,springer
2012-01-31,1,17,0,1,1,41,518,559,springer
2012-01-31,1,18,0,1,1,16,486,502,springer
2012-01-31,1,19,0,1,1,22,306,328,springer
2012-01-31,1,20,0,1,1,15,223,238,springer
2012-01-31,1,21,0,1,1,3,162,165,springer
2012-01-31,1,22,0,1,1,11,118,129,springer
2012-01-31,1,23,0,1,1,2,61,63,springer
2012-02-01,1,0,0,1,1,0,31,31,springer
2012-02-01,1,1,0,1,1,0,4,4,springer
2012-02-01,1,2,0,1,1,1,6,7,springer
2012-02-01,1,3,0,1,1,0,3,3,springer
2012-02-01,1,4,0,1,1,0,1,1,springer
2012-02-01,1,5,0,1,1,0,18,18,springer
2012-02-01,1,6,0,1,3,0,67,67,springer
2012-02-01,1,7,0,1,3,7,201,208,springer
2012-02-01,1,8,0,1,3,15,505,520,springer
2012-02-01,1,9,0,1,2,9,267,276,springer
2012-02-01,1,10,0,1,1,9,124,133,springer
2012-02-01,1,11,0,1,1,27,116,143,springer
2012-02-01,1,12,0,1,1,26,153,179,springer
2012-02-01,1,13,0,1,1,12,174,186,springer
2012-02-01,1,14,0,1,1,33,159,192,springer
2012-02-01,1,15,0,1,1,25,169,194,springer
2012-02-01,1,16,0,1,1,22,261,283,springer
2012-02-01,1,17,0,1,1,31,508,539,springer
2012-02-01,1,18,0,1,1,12,514,526,springer
2012-02-01,1,19,0,1,1,20,315,335,springer
2012-02-01,1,20,0,1,1,10,254,264,springer
2012-02-01,1,21,0,1,1,16,217,233,springer
2012-02-01,1,22,0,1,1,7,133,140,springer
2012-02-01,1,23,0,1,1,22,75,97,springer
2012-02-02,1,0,0,1,1,7,24,31,springer
2012-02-02,1,1,0,1,2,3,14,17,springer
2012-02-02,1,2,0,1,2,2,7,9,springer
2012-02-02,1,3,0,1,2,0,2,2,springer
2012-02-02,1,4,0,1,3,0,1,1,springer
2012-02-02,1,5,0,1,3,0,19,19,springer
2012-02-02,1,6,0,1,3,1,73,74,springer
2012-02-02,1,7,0,1,3,4,201,205,springer
2012-02-02,1,8,0,1,3,9,436,445,springer
2012-02-02,1,9,0,1,3,15,213,228,springer
2012-02-02,1,10,0,1,3,6,72,78,springer
2012-02-02,1,11,0,1,3,6,99,105,springer
2012-02-02,1,12,0,1,1,8,140,148,springer
2012-02-02,1,13,0,1,2,13,124,137,springer
2012-02-02,1,14,0,1,1,12,129,141,springer
2012-02-02,1,15,0,1,1,24,150,174,springer
2012-02-02,1,16,0,1,1,18,211,229,springer
2012-02-02,1,17,0,1,1,13,437,450,springer
2012-02-02,1,18,0,1,1,17,393,410,springer
2012-02-02,1,19,0,1,1,16,311,327,springer
2012-02-02,1,20,0,1,1,9,204,213,springer
2012-02-02,1,21,0,1,1,4,144,148,springer
2012-02-02,1,22,0,1,1,3,106,109,springer
2012-02-02,1,23,0,1,1,0,61,61,springer
2012-02-03,1,0,0,1,1,1,37,38,springer
2012-02-03,1,1,0,1,1,3,19,22,springer
2012-02-03,1,2,0,1,1,0,6,6,springer
2012-02-03,1,3,0,1,1,0,4,4,springer
2012-02-03,1,4,0,1,1,0,2,2,springer
2012-02-03,1,5,0,1,1,0,17,17,springer
2012-02-03,1,6,0,1,1,0,88,88,springer
2012-02-03,1,7,0,1,1,10,216,226,springer
2012-02-03,1,8,0,1,1,12,429,441,springer
2012-02-03,1,9,0,1,1,18,252,270,springer
2012-02-03,1,10,0,1,1,15,114,129,springer
2012-02-03,1,11,0,1,1,15,149,164,springer
2012-02-03,1,12,0,1,1,25,191,216,springer
2012-02-03,1,13,0,1,1,25,173,198,springer
2012-02-03,1,14,0,1,1,22,148,170,springer
2012-02-03,1,15,0,1,1,48,168,216,springer
2012-02-03,1,16,0,1,1,36,275,311,springer
2012-02-03,1,17,0,1,1,30,458,488,springer
2012-02-03,1,18,0,1,1,17,368,385,springer
2012-02-03,1,19,0,1,1,11,256,267,springer
2012-02-03,1,20,0,1,1,8,155,163,springer
2012-02-03,1,21,0,1,1,8,126,134,springer
2012-02-03,1,22,0,1,1,3,116,119,springer
2012-02-03,1,23,0,1,1,3,74,77,springer
2012-02-04,1,0,0,0,1,10,76,86,springer
2012-02-04,1,1,0,0,1,0,43,43,springer
2012-02-04,1,2,0,0,1,6,38,44,springer
2012-02-04,1,3,0,0,1,1,17,18,springer
2012-02-04,1,4,0,0,1,1,5,6,springer
2012-02-04,1,5,0,0,1,1,3,4,springer
2012-02-04,1,6,0,0,1,1,4,5,springer
2012-02-04,1,7,0,0,2,1,27,28,springer
2012-02-04,1,8,0,0,1,4,86,90,springer
2012-02-04,1,9,0,0,1,16,141,157,springer
2012-02-04,1,10,0,0,1,31,193,224,springer
2012-02-04,1,11,0,0,1,46,224,270,springer
2012-02-04,1,12,0,0,2,40,260,300,springer
2012-02-04,1,13,0,0,2,58,244,302,springer
2012-02-04,1,14,0,0,2,47,229,276,springer
2012-02-04,1,15,0,0,2,61,244,305,springer
2012-02-04,1,16,0,0,2,20,123,143,springer
2012-02-04,1,17,0,0,3,13,54,67,springer
2012-02-04,1,18,0,0,3,6,58,64,springer
2012-02-04,1,19,0,0,3,5,75,80,springer
2012-02-04,1,20,0,0,3,4,73,77,springer
2012-02-04,1,21,0,0,3,4,74,78,springer
2012-02-04,1,22,0,0,2,4,91,95,springer
2012-02-04,1,23,0,0,2,4,66,70,springer
2012-02-05,1,0,0,0,2,3,58,61,springer
2012-02-05,1,1,0,0,2,5,46,51,springer
2012-02-05,1,2,0,0,2,4,59,63,springer
2012-02-05,1,3,0,0,3,4,13,17,springer
2012-02-05,1,4,0,0,2,0,9,9,springer
2012-02-05,1,5,0,0,3,0,4,4,springer
2012-02-05,1,6,0,0,2,0,4,4,springer
2012-02-05,1,7,0,0,2,0,16,16,springer
2012-02-05,1,8,0,0,2,4,58,62,springer
2012-02-05,1,9,0,0,2,9,83,92,springer
2012-02-05,1,10,0,0,2,10,138,148,springer
2012-02-05,1,11,0,0,2,22,160,182,springer
2012-02-05,1,12,0,0,2,25,223,248,springer
2012-02-05,1,13,0,0,2,33,241,274,springer
2012-02-05,1,14,0,0,1,40,203,243,springer
2012-02-05,1,15,0,0,2,55,217,272,springer
2012-02-05,1,16,0,0,1,35,261,296,springer
2012-02-05,1,17,0,0,1,31,275,306,springer
2012-02-05,1,18,0,0,1,10,171,181,springer
2012-02-05,1,19,0,0,1,6,63,69,springer
2012-02-05,1,20,0,0,1,3,47,50,springer
2012-02-05,1,21,0,0,1,6,60,66,springer
2012-02-05,1,22,0,0,1,9,182,191,springer
2012-02-05,1,23,0,0,1,4,38,42,springer
2012-02-06,1,0,0,1,1,7,14,21,springer
2012-02-06,1,1,0,1,1,0,6,6,springer
2012-02-06,1,2,0,1,1,0,3,3,springer
2012-02-06,1,4,0,1,1,0,2,2,springer
2012-02-06,1,5,0,1,1,0,17,17,springer
2012-02-06,1,6,0,1,1,0,72,72,springer
2012-02-06,1,7,0,1,1,5,229,234,springer
2012-02-06,1,8,0,1,1,10,434,444,springer
2012-02-06,1,9,0,1,1,8,269,277,springer
2012-02-06,1,10,0,1,1,20,96,116,springer
2012-02-06,1,11,0,1,1,12,104,116,springer
2012-02-06,1,12,0,1,1,19,131,150,springer
2012-02-06,1,13,0,1,1,17,124,141,springer
2012-02-06,1,14,0,1,1,14,126,140,springer
2012-02-06,1,15,0,1,1,25,146,171,springer
2012-02-06,1,16,0,1,1,13,215,228,springer
2012-02-06,1,17,0,1,1,13,417,430,springer
2012-02-06,1,18,0,1,1,11,426,437,springer
2012-02-06,1,19,0,1,1,7,284,291,springer
2012-02-06,1,20,0,1,1,7,194,201,springer
2012-02-06,1,21,0,1,1,11,143,154,springer
2012-02-06,1,22,0,1,1,4,83,87,springer
2012-02-06,1,23,0,1,1,3,43,46,springer
2012-02-07,1,0,0,1,1,1,22,23,springer
2012-02-07,1,1,0,1,1,8,6,14,springer
2012-02-07,1,2,0,1,1,0,4,4,springer
2012-02-07,1,3,0,1,2,1,1,2,springer
2012-02-07,1,4,0,1,2,0,3,3,springer
2012-02-07,1,5,0,1,1,0,15,15,springer
2012-02-07,1,6,0,1,1,2,98,100,springer
2012-02-07,1,7,0,1,1,6,293,299,springer
2012-02-07,1,8,0,1,1,7,522,529,springer
2012-02-07,1,9,0,1,1,11,278,289,springer
2012-02-07,1,10,0,1,1,12,104,116,springer
2012-02-07,1,11,0,1,1,9,120,129,springer
2012-02-07,1,12,0,1,1,9,163,172,springer
2012-02-07,1,13,0,1,1,15,169,184,springer
2012-02-07,1,14,0,1,1,11,127,138,springer
2012-02-07,1,15,0,1,1,13,133,146,springer
2012-02-07,1,16,0,1,1,19,257,276,springer
2012-02-07,1,17,0,1,1,15,494,509,springer
2012-02-07,1,18,0,1,1,10,508,518,springer
2012-02-07,1,19,0,1,1,11,327,338,springer
2012-02-07,1,20,0,1,1,6,206,212,springer
2012-02-07,1,21,0,1,1,20,170,190,springer
2012-02-07,1,22,0,1,1,11,107,118,springer
2012-02-07,1,23,0,1,1,2,49,51,springer
2012-02-08,1,0,0,1,1,2,21,23,springer
2012-02-08,1,1,0,1,1,1,9,10,springer
2012-02-08,1,2,0,1,1,0,1,1,springer
2012-02-08,1,3,0,1,1,0,1,1,springer
2012-02-08,1,4,0,1,1,0,1,1,springer
2012-02-08,1,5,0,1,1,0,20,20,springer
2012-02-08,1,6,0,1,2,3,95,98,springer
2012-02-08,1,7,0,1,2,5,276,281,springer
2012-02-08,1,8,0,1,2,13,495,508,springer
2012-02-08,1,9,0,1,2,8,245,253,springer
2012-02-08,1,10,0,1,2,1,107,108,springer
2012-02-08,1,11,0,1,2,5,97,102,springer
2012-02-08,1,12,0,1,2,14,124,138,springer
2012-02-08,1,13,0,1,2,15,111,126,springer
2012-02-08,1,14,0,1,2,8,100,108,springer
2012-02-08,1,15,0,1,3,5,49,54,springer
2012-02-08,1,16,0,1,3,2,73,75,springer
2012-02-08,1,17,0,1,3,8,147,155,springer
2012-02-08,1,18,0,1,3,4,163,167,springer
2012-02-08,1,19,0,1,3,3,158,161,springer
2012-02-08,1,20,0,1,3,3,122,125,springer
2012-02-08,1,21,0,1,3,3,126,129,springer
2012-02-08,1,22,0,1,2,3,95,98,springer
2012-02-08,1,23,0,1,2,3,57,60,springer
2012-02-09,1,0,0,1,2,3,23,26,springer
2012-02-09,1,1,0,1,2,2,10,12,springer
2012-02-09,1,2,0,1,1,0,2,2,springer
2012-02-09,1,3,0,1,1,0,4,4,springer
2012-02-09,1,4,0,1,2,0,1,1,springer
2012-02-09,1,5,0,1,1,0,18,18,springer
2012-02-09,1,6,0,1,1,1,75,76,springer
2012-02-09,1,7,0,1,1,4,263,267,springer
2012-02-09,1,8,0,1,1,11,473,484,springer
2012-02-09,1,9,0,1,1,9,229,238,springer
2012-02-09,1,10,0,1,1,7,90,97,springer
2012-02-09,1,11,0,1,1,4,95,99,springer
2012-02-09,1,12,0,1,1,10,148,158,springer
2012-02-09,1,13,0,1,1,10,144,154,springer
2012-02-09,1,14,0,1,1,18,126,144,springer
2012-02-09,1,15,0,1,1,14,120,134,springer
2012-02-09,1,16,0,1,1,15,223,238,springer
2012-02-09,1,17,0,1,1,12,387,399,springer
2012-02-09,1,18,0,1,1,13,404,417,springer
2012-02-09,1,19,0,1,1,8,287,295,springer
2012-02-09,1,20,0,1,1,2,197,199,springer
2012-02-09,1,21,0,1,1,8,169,177,springer
2012-02-09,1,22,0,1,2,3,104,107,springer
2012-02-09,1,23,0,1,2,9,75,84,springer
2012-02-10,1,0,0,1,2,4,39,43,springer
2012-02-10,1,1,0,1,2,2,11,13,springer
2012-02-10,1,2,0,1,1,7,9,16,springer
2012-02-10,1,3,0,1,1,0,5,5,springer
2012-02-10,1,4,0,1,1,0,2,2,springer
2012-02-10,1,5,0,1,1,0,17,17,springer
2012-02-10,1,6,0,1,1,3,61,64,springer
2012-02-10,1,7,0,1,1,5,225,230,springer
2012-02-10,1,8,0,1,1,1,447,448,springer
2012-02-10,1,9,0,1,1,10,265,275,springer
2012-02-10,1,10,0,1,2,5,119,124,springer
2012-02-10,1,11,0,1,2,19,134,153,springer
2012-02-10,1,12,0,1,2,8,168,176,springer
2012-02-10,1,13,0,1,2,22,170,192,springer
2012-02-10,1,14,0,1,2,8,138,146,springer
2012-02-10,1,15,0,1,2,27,164,191,springer
2012-02-10,1,16,0,1,2,28,240,268,springer
2012-02-10,1,17,0,1,2,15,381,396,springer
2012-02-10,1,18,0,1,3,14,345,359,springer
2012-02-10,1,19,0,1,2,16,246,262,springer
2012-02-10,1,20,0,1,2,7,144,151,springer
2012-02-10,1,21,0,1,2,14,108,122,springer
2012-02-10,1,22,0,1,2,11,102,113,springer
2012-02-10,1,23,0,1,2,1,64,65,springer
2012-02-11,1,0,0,0,2,3,50,53,springer
2012-02-11,1,1,0,0,3,2,43,45,springer
2012-02-11,1,2,0,0,3,2,24,26,springer
2012-02-11,1,3,0,0,3,0,9,9,springer
2012-02-11,1,4,0,0,3,0,4,4,springer
2012-02-11,1,5,0,0,3,0,2,2,springer
2012-02-11,1,6,0,0,3,1,8,9,springer
2012-02-11,1,7,0,0,3,0,19,19,springer
2012-02-11,1,8,0,0,3,1,77,78,springer
2012-02-11,1,9,0,0,3,5,85,90,springer
2012-02-11,1,10,0,0,3,23,143,166,springer
2012-02-11,1,11,0,0,2,26,157,183,springer
2012-02-11,1,12,0,0,2,25,196,221,springer
2012-02-11,1,13,0,0,2,18,217,235,springer
2012-02-11,1,14,0,0,2,38,205,243,springer
2012-02-11,1,15,0,0,2,12,112,124,springer
2012-02-11,1,16,0,0,3,12,134,146,springer
2012-02-11,1,17,0,0,3,13,131,144,springer
2012-02-11,1,18,0,0,2,3,105,108,springer
2012-02-11,1,19,0,0,2,2,85,87,springer
2012-02-11,1,20,0,0,2,1,62,63,springer
2012-02-11,1,21,0,0,1,5,43,48,springer
2012-02-11,1,22,0,0,2,0,46,46,springer
2012-02-11,1,23,0,0,3,0,20,20,springer
2012-02-12,1,0,0,0,3,0,21,21,springer
2012-02-12,1,1,0,0,3,0,24,24,springer
2012-02-12,1,2,0,0,2,1,26,27,springer
2012-02-12,1,3,0,0,2,0,14,14,springer
2012-02-12,1,4,0,0,2,0,1,1,springer
2012-02-12,1,5,0,0,1,0,3,3,springer
2012-02-12,1,6,0,0,1,0,2,2,springer
2012-02-12,1,7,0,0,1,0,18,18,springer
2012-02-12,1,8,0,0,1,0,26,26,springer
2012-02-12,1,9,0,0,1,3,60,63,springer
2012-02-12,1,10,0,0,1,8,83,91,springer
2012-02-12,1,11,0,0,1,3,121,124,springer
2012-02-12,1,12,0,0,1,7,133,140,springer
2012-02-12,1,13,0,0,1,10,128,138,springer
2012-02-12,1,14,0,0,1,9,102,111,springer
2012-02-12,1,15,0,0,1,5,150,155,springer
2012-02-12,1,16,0,0,1,16,148,164,springer
2012-02-12,1,17,0,0,1,4,83,87,springer
2012-02-12,1,18,0,0,1,4,92,96,springer
2012-02-12,1,19,0,0,1,2,78,80,springer
2012-02-12,1,20,0,0,1,1,56,57,springer
2012-02-12,1,21,0,0,1,0,36,36,springer
2012-02-12,1,22,0,0,1,0,28,28,springer
2012-02-12,1,23,0,0,1,0,23,23,springer
2012-02-13,1,0,0,1,1,0,9,9,springer
2012-02-13,1,1,0,1,1,0,6,6,springer
2012-02-13,1,2,0,1,1,0,4,4,springer
2012-02-13,1,3,0,1,1,0,1,1,springer
2012-02-13,1,4,0,1,1,0,2,2,springer
2012-02-13,1,5,0,1,1,0,17,17,springer
2012-02-13,1,6,0,1,1,1,71,72,springer
2012-02-13,1,7,0,1,1,1,194,195,springer
2012-02-13,1,8,0,1,1,4,413,417,springer
2012-02-13,1,9,0,1,1,7,198,205,springer
2012-02-13,1,10,0,1,1,1,70,71,springer
2012-02-13,1,11,0,1,1,5,85,90,springer
2012-02-13,1,12,0,1,1,7,111,118,springer
2012-02-13,1,13,0,1,1,11,129,140,springer
2012-02-13,1,14,0,1,1,10,125,135,springer
2012-02-13,1,15,0,1,1,10,145,155,springer
2012-02-13,1,16,0,1,1,5,206,211,springer
2012-02-13,1,17,0,1,1,8,399,407,springer
2012-02-13,1,18,0,1,1,6,399,405,springer
2012-02-13,1,19,0,1,1,7,256,263,springer
2012-02-13,1,20,0,1,1,4,210,214,springer
2012-02-13,1,21,0,1,1,2,145,147,springer
2012-02-13,1,22,0,1,1,3,99,102,springer
2012-02-13,1,23,0,1,1,2,34,36,springer
2012-02-14,1,0,0,1,2,0,14,14,springer
2012-02-14,1,1,0,1,2,0,6,6,springer
2012-02-14,1,2,0,1,2,0,3,3,springer
2012-02-14,1,3,0,1,2,0,3,3,springer
2012-02-14,1,4,0,1,2,0,2,2,springer
2012-02-14,1,5,0,1,2,2,20,22,springer
2012-02-14,1,6,0,1,2,1,89,90,springer
2012-02-14,1,7,0,1,2,4,276,280,springer
2012-02-14,1,8,0,1,2,3,510,513,springer
2012-02-14,1,9,0,1,2,6,256,262,springer
2012-02-14,1,10,0,1,2,8,90,98,springer
2012-02-14,1,11,0,1,2,5,107,112,springer
2012-02-14,1,12,0,1,2,10,162,172,springer
2012-02-14,1,13,0,1,2,6,167,173,springer
2012-02-14,1,14,0,1,1,13,111,124,springer
2012-02-14,1,15,0,1,2,7,138,145,springer
2012-02-14,1,16,0,1,1,15,251,266,springer
2012-02-14,1,17,0,1,1,19,504,523,springer
2012-02-14,1,18,0,1,2,8,398,406,springer
2012-02-14,1,19,0,1,2,11,270,281,springer
2012-02-14,1,20,0,1,2,6,178,184,springer
2012-02-14,1,21,0,1,2,4,105,109,springer
2012-02-14,1,22,0,1,2,5,72,77,springer
2012-02-14,1,23,0,1,2,2,55,57,springer
2012-02-15,1,0,0,1,1,0,22,22,springer
2012-02-15,1,1,0,1,1,0,5,5,springer
2012-02-15,1,2,0,1,1,0,4,4,springer
2012-02-15,1,3,0,1,1,0,3,3,springer
2012-02-15,1,4,0,1,1,0,1,1,springer
2012-02-15,1,5,0,1,1,0,25,25,springer
2012-02-15,1,6,0,1,1,3,92,95,springer
2012-02-15,1,7,0,1,2,3,318,321,springer
2012-02-15,1,8,0,1,1,7,508,515,springer
2012-02-15,1,9,0,1,1,5,226,231,springer
2012-02-15,1,10,0,1,1,12,108,120,springer
2012-02-15,1,11,0,1,1,13,125,138,springer
2012-02-15,1,12,0,1,1,11,152,163,springer
2012-02-15,1,13,0,1,1,11,159,170,springer
2012-02-15,1,14,0,1,1,6,128,134,springer
2012-02-15,1,15,0,1,1,7,164,171,springer
2012-02-15,1,16,0,1,1,9,222,231,springer
2012-02-15,1,17,0,1,1,17,470,487,springer
2012-02-15,1,18,0,1,1,9,459,468,springer
2012-02-15,1,19,0,1,1,9,302,311,springer
2012-02-15,1,20,0,1,1,4,207,211,springer
2012-02-15,1,21,0,1,1,8,170,178,springer
2012-02-15,1,22,0,1,1,3,104,107,springer
2012-02-15,1,23,0,1,1,4,54,58,springer
2012-02-16,1,0,0,1,2,1,22,23,springer
2012-02-16,1,1,0,1,2,0,5,5,springer
2012-02-16,1,2,0,1,2,1,6,7,springer
2012-02-16,1,3,0,1,2,0,1,1,springer
2012-02-16,1,4,0,1,3,0,3,3,springer
2012-02-16,1,5,0,1,2,0,20,20,springer
2012-02-16,1,6,0,1,2,4,83,87,springer
2012-02-16,1,7,0,1,2,3,285,288,springer
2012-02-16,1,8,0,1,2,9,489,498,springer
2012-02-16,1,9,0,1,2,3,199,202,springer
2012-02-16,1,10,0,1,3,2,42,44,springer
2012-02-16,1,11,0,1,3,2,69,71,springer
2012-02-16,1,12,0,1,3,1,44,45,springer
2012-02-16,1,13,0,1,3,2,62,64,springer
2012-02-16,1,14,0,1,3,1,30,31,springer
2012-02-16,1,15,0,1,3,3,50,53,springer
2012-02-16,1,16,0,1,3,8,110,118,springer
2012-02-16,1,17,0,1,3,8,281,289,springer
2012-02-16,1,18,0,1,3,8,345,353,springer
2012-02-16,1,19,0,1,2,4,254,258,springer
2012-02-16,1,20,0,1,2,5,211,216,springer
2012-02-16,1,21,0,1,2,3,142,145,springer
2012-02-16,1,22,0,1,2,3,108,111,springer
2012-02-16,1,23,0,1,1,3,70,73,springer
2012-02-17,1,0,0,1,2,2,32,34,springer
2012-02-17,1,1,0,1,2,2,16,18,springer
2012-02-17,1,2,0,1,2,1,11,12,springer
2012-02-17,1,3,0,1,2,0,1,1,springer
2012-02-17,1,4,0,1,2,0,1,1,springer
2012-02-17,1,5,0,1,2,0,16,16,springer
2012-02-17,1,6,0,1,2,1,70,71,springer
2012-02-17,1,7,0,1,2,4,222,226,springer
2012-02-17,1,8,0,1,2,4,516,520,springer
2012-02-17,1,9,0,1,2,8,275,283,springer
2012-02-17,1,10,0,1,1,13,103,116,springer
2012-02-17,1,11,0,1,1,9,133,142,springer
2012-02-17,1,12,0,1,1,21,177,198,springer
2012-02-17,1,13,0,1,1,34,171,205,springer
2012-02-17,1,14,0,1,1,33,137,170,springer
2012-02-17,1,15,0,1,1,41,180,221,springer
2012-02-17,1,16,0,1,1,56,251,307,springer
2012-02-17,1,17,0,1,1,36,429,465,springer
2012-02-17,1,18,0,1,1,15,362,377,springer
2012-02-17,1,19,0,1,1,16,266,282,springer
2012-02-17,1,20,0,1,1,13,158,171,springer
2012-02-17,1,21,0,1,1,15,114,129,springer
2012-02-17,1,22,0,1,1,15,92,107,springer
2012-02-17,1,23,0,1,1,10,72,82,springer
2012-02-18,1,0,0,0,1,5,81,86,springer
2012-02-18,1,1,0,0,1,7,38,45,springer
2012-02-18,1,2,0,0,1,6,39,45,springer
2012-02-18,1,3,0,0,1,3,15,18,springer
2012-02-18,1,4,0,0,1,3,4,7,springer
2012-02-18,1,5,0,0,1,0,1,1,springer
2012-02-18,1,6,0,0,1,1,8,9,springer
2012-02-18,1,7,0,0,1,8,33,41,springer
2012-02-18,1,8,0,0,1,10,92,102,springer
2012-02-18,1,9,0,0,1,22,116,138,springer
2012-02-18,1,10,0,0,1,48,157,205,springer
2012-02-18,1,11,0,0,1,102,184,286,springer
2012-02-18,1,12,0,0,1,128,241,369,springer
2012-02-18,1,13,0,0,1,165,219,384,springer
2012-02-18,1,14,0,0,1,183,244,427,springer
2012-02-18,1,15,0,0,1,229,270,499,springer
2012-02-18,1,16,0,0,1,186,218,404,springer
2012-02-18,1,17,0,0,1,142,222,364,springer
2012-02-18,1,18,0,0,1,70,176,246,springer
2012-02-18,1,19,0,0,1,38,150,188,springer
2012-02-18,1,20,0,0,1,25,123,148,springer
2012-02-18,1,21,0,0,1,25,89,114,springer
2012-02-18,1,22,0,0,1,17,101,118,springer
2012-02-18,1,23,0,0,2,12,62,74,springer
2012-02-19,1,0,0,0,2,9,65,74,springer
2012-02-19,1,1,0,0,2,10,62,72,springer
2012-02-19,1,2,0,0,2,3,45,48,springer
2012-02-19,1,3,0,0,2,3,12,15,springer
2012-02-19,1,4,0,0,2,0,3,3,springer
2012-02-19,1,5,0,0,2,1,1,2,springer
2012-02-19,1,6,0,0,1,0,5,5,springer
2012-02-19,1,7,0,0,2,2,12,14,springer
2012-02-19,1,8,0,0,2,8,48,56,springer
2012-02-19,1,9,0,0,2,20,73,93,springer
2012-02-19,1,10,0,0,2,49,142,191,springer
2012-02-19,1,11,0,0,2,82,144,226,springer
2012-02-19,1,12,0,0,2,71,184,255,springer
2012-02-19,1,13,0,0,1,64,197,261,springer
2012-02-19,1,14,0,0,2,48,189,237,springer
2012-02-19,1,15,0,0,2,85,168,253,springer
2012-02-19,1,16,0,0,2,62,150,212,springer
2012-02-19,1,17,0,0,2,22,135,157,springer
2012-02-19,1,18,0,0,2,23,144,167,springer
2012-02-19,1,19,0,0,2,18,101,119,springer
2012-02-19,1,20,0,0,2,22,81,103,springer
2012-02-19,1,21,0,0,3,3,33,36,springer
2012-02-19,1,22,0,0,3,8,47,55,springer
2012-02-19,1,23,0,0,2,5,30,35,springer
2012-02-20,1,0,1,0,2,5,36,41,springer
2012-02-20,1,1,1,0,2,3,12,15,springer
2012-02-20,1,2,1,0,2,1,19,20,springer
2012-02-20,1,3,1,0,2,0,8,8,springer
2012-02-20,1,5,1,0,2,0,6,6,springer
2012-02-20,1,6,1,0,1,1,9,10,springer
2012-02-20,1,7,1,0,2,2,42,44,springer
2012-02-20,1,8,1,0,1,9,111,120,springer
2012-02-20,1,9,1,0,1,12,98,110,springer
2012-02-20,1,10,1,0,1,30,113,143,springer
2012-02-20,1,11,1,0,1,45,163,208,springer
2012-02-20,1,12,1,0,1,65,216,281,springer
2012-02-20,1,13,1,0,1,66,246,312,springer
2012-02-20,1,14,1,0,1,57,206,263,springer
2012-02-20,1,15,1,0,1,54,235,289,springer
2012-02-20,1,16,1,0,1,64,216,280,springer
2012-02-20,1,17,1,0,1,27,226,253,springer
2012-02-20,1,18,1,0,1,27,215,242,springer
2012-02-20,1,19,1,0,1,8,164,172,springer
2012-02-20,1,20,1,0,1,9,117,126,springer
2012-02-20,1,21,1,0,1,8,90,98,springer
2012-02-20,1,22,1,0,1,9,53,62,springer
2012-02-20,1,23,1,0,1,0,26,26,springer
2012-02-21,1,0,0,1,1,1,11,12,springer
2012-02-21,1,1,0,1,1,0,7,7,springer
2012-02-21,1,2,0,1,1,0,3,3,springer
2012-02-21,1,4,0,1,1,0,2,2,springer
2012-02-21,1,5,0,1,1,0,15,15,springer
2012-02-21,1,6,0,1,1,3,83,86,springer
2012-02-21,1,7,0,1,1,6,273,279,springer
2012-02-21,1,8,0,1,1,5,459,464,springer
2012-02-21,1,9,0,1,1,6,211,217,springer
2012-02-21,1,10,0,1,1,8,77,85,springer
2012-02-21,1,11,0,1,2,5,81,86,springer
2012-02-21,1,12,0,1,2,16,147,163,springer
2012-02-21,1,13,0,1,1,8,123,131,springer
2012-02-21,1,14,0,1,2,16,108,124,springer
2012-02-21,1,15,0,1,1,23,137,160,springer
2012-02-21,1,16,0,1,1,14,240,254,springer
2012-02-21,1,17,0,1,1,21,411,432,springer
2012-02-21,1,18,0,1,1,11,414,425,springer
2012-02-21,1,19,0,1,1,5,299,304,springer
2012-02-21,1,20,0,1,1,4,223,227,springer
2012-02-21,1,21,0,1,1,7,147,154,springer
2012-02-21,1,22,0,1,2,3,97,100,springer
2012-02-21,1,23,0,1,1,1,46,47,springer
2012-02-22,1,0,0,1,1,5,19,24,springer
2012-02-22,1,1,0,1,1,3,4,7,springer
2012-02-22,1,2,0,1,1,1,5,6,springer
2012-02-22,1,3,0,1,2,1,3,4,springer
2012-02-22,1,4,0,1,1,0,2,2,springer
2012-02-22,1,5,0,1,1,1,29,30,springer
2012-02-22,1,6,0,1,1,5,85,90,springer
2012-02-22,1,7,0,1,1,10,292,302,springer
2012-02-22,1,8,0,1,1,9,567,576,springer
2012-02-22,1,9,0,1,1,11,241,252,springer
2012-02-22,1,10,0,1,1,17,122,139,springer
2012-02-22,1,11,0,1,1,22,149,171,springer
2012-02-22,1,12,0,1,1,21,186,207,springer
2012-02-22,1,13,0,1,1,15,175,190,springer
2012-02-22,1,14,0,1,1,35,142,177,springer
2012-02-22,1,15,0,1,1,34,161,195,springer
2012-02-22,1,16,0,1,1,30,268,298,springer
2012-02-22,1,17,0,1,1,43,486,529,springer
2012-02-22,1,18,0,1,2,42,483,525,springer
2012-02-22,1,19,0,1,2,22,305,327,springer
2012-02-22,1,20,0,1,2,25,249,274,springer
2012-02-22,1,21,0,1,2,19,220,239,springer
2012-02-22,1,22,0,1,2,18,129,147,springer
2012-02-22,1,23,0,1,2,5,57,62,springer
2012-02-23,1,0,0,1,2,12,30,42,springer
2012-02-23,1,1,0,1,2,3,12,15,springer
2012-02-23,1,2,0,1,2,5,4,9,springer
2012-02-23,1,3,0,1,3,2,4,6,springer
2012-02-23,1,4,0,1,1,0,1,1,springer
2012-02-23,1,5,0,1,1,2,30,32,springer
2012-02-23,1,6,0,1,1,3,88,91,springer
2012-02-23,1,7,0,1,1,9,317,326,springer
2012-02-23,1,8,0,1,1,11,549,560,springer
2012-02-23,1,9,0,1,1,14,228,242,springer
2012-02-23,1,10,0,1,1,41,107,148,springer
2012-02-23,1,11,0,1,1,54,128,182,springer
2012-02-23,1,12,0,1,1,25,199,224,springer
2012-02-23,1,13,0,1,1,30,188,218,springer
2012-02-23,1,14,0,1,1,36,156,192,springer
2012-02-23,1,15,0,1,1,46,171,217,springer
2012-02-23,1,16,0,1,1,45,298,343,springer
2012-02-23,1,17,0,1,1,49,561,610,springer
2012-02-23,1,18,0,1,1,36,486,522,springer
2012-02-23,1,19,0,1,1,20,349,369,springer
2012-02-23,1,20,0,1,1,23,246,269,springer
2012-02-23,1,21,0,1,1,17,205,222,springer
2012-02-23,1,22,0,1,1,19,118,137,springer
2012-02-23,1,23,0,1,1,14,71,85,springer
2012-02-24,1,0,0,1,2,12,34,46,springer
2012-02-24,1,1,0,1,1,3,15,18,springer
2012-02-24,1,2,0,1,3,1,4,5,springer
2012-02-24,1,3,0,1,1,0,5,5,springer
2012-02-24,1,4,0,1,1,0,2,2,springer
2012-02-24,1,5,0,1,2,1,25,26,springer
2012-02-24,1,6,0,1,2,2,80,82,springer
2012-02-24,1,7,0,1,2,7,265,272,springer
2012-02-24,1,8,0,1,2,17,452,469,springer
2012-02-24,1,9,0,1,3,15,229,244,springer
2012-02-24,1,10,0,1,3,22,119,141,springer
2012-02-24,1,11,0,1,2,27,136,163,springer
2012-02-24,1,12,0,1,2,27,201,228,springer
2012-02-24,1,13,0,1,2,30,153,183,springer
2012-02-24,1,14,0,1,2,5,26,31,springer
2012-02-24,1,15,0,1,3,11,83,94,springer
2012-02-24,1,16,0,1,3,12,166,178,springer
2012-02-24,1,17,0,1,3,14,242,256,springer
2012-02-24,1,18,0,1,2,11,289,300,springer
2012-02-24,1,19,0,1,2,6,227,233,springer
2012-02-24,1,20,0,1,1,8,159,167,springer
2012-02-24,1,21,0,1,1,1,151,152,springer
2012-02-24,1,22,0,1,1,4,102,106,springer
2012-02-24,1,23,0,1,1,10,76,86,springer
2012-02-25,1,0,0,0,1,5,56,61,springer
2012-02-25,1,1,0,0,1,4,42,46,springer
2012-02-25,1,2,0,0,1,1,37,38,springer
2012-02-25,1,3,0,0,1,0,7,7,springer
2012-02-25,1,4,0,0,1,0,2,2,springer
2012-02-25,1,5,0,0,2,0,3,3,springer
2012-02-25,1,6,0,0,2,1,12,13,springer
2012-02-25,1,7,0,0,1,3,20,23,springer
2012-02-25,1,8,0,0,1,3,90,93,springer
2012-02-25,1,9,0,0,3,15,107,122,springer
2012-02-25,1,10,0,0,1,24,159,183,springer
2012-02-25,1,11,0,0,1,23,187,210,springer
2012-02-25,1,12,0,0,1,41,217,258,springer
2012-02-25,1,13,0,0,1,48,178,226,springer
2012-02-25,1,14,0,0,1,35,181,216,springer
2012-02-25,1,15,0,0,1,21,211,232,springer
2012-02-25,1,16,0,0,1,32,163,195,springer
2012-02-25,1,17,0,0,1,16,143,159,springer
2012-02-25,1,18,0,0,1,7,126,133,springer
2012-02-25,1,19,0,0,1,12,137,149,springer
2012-02-25,1,20,0,0,1,10,95,105,springer
2012-02-25,1,21,0,0,1,5,80,85,springer
2012-02-25,1,22,0,0,1,4,78,82,springer
2012-02-25,1,23,0,0,1,7,84,91,springer
2012-02-26,1,0,0,0,1,7,63,70,springer
2012-02-26,1,1,0,0,1,5,50,55,springer
2012-02-26,1,2,0,0,1,5,37,42,springer
2012-02-26,1,3,0,0,1,0,21,21,springer
2012-02-26,1,4,0,0,1,1,5,6,springer
2012-02-26,1,5,0,0,1,0,5,5,springer
2012-02-26,1,6,0,0,1,0,2,2,springer
2012-02-26,1,7,0,0,1,2,20,22,springer
2012-02-26,1,8,0,0,1,2,57,59,springer
2012-02-26,1,9,0,0,1,11,76,87,springer
2012-02-26,1,10,0,0,1,27,161,188,springer
2012-02-26,1,11,0,0,1,43,184,227,springer
2012-02-26,1,12,0,0,1,49,256,305,springer
2012-02-26,1,13,0,0,1,58,267,325,springer
2012-02-26,1,14,0,0,1,68,263,331,springer
2012-02-26,1,15,0,0,1,72,281,353,springer
2012-02-26,1,16,0,0,1,64,275,339,springer
2012-02-26,1,17,0,0,1,46,241,287,springer
2012-02-26,1,18,0,0,1,17,199,216,springer
2012-02-26,1,19,0,0,1,13,130,143,springer
2012-02-26,1,20,0,0,1,9,79,88,springer
2012-02-26,1,21,0,0,1,8,75,83,springer
2012-02-26,1,22,0,0,1,3,68,71,springer
2012-02-26,1,23,0,0,1,5,59,64,springer
2012-02-27,1,0,0,1,1,2,27,29,springer
2012-02-27,1,1,0,1,1,0,6,6,springer
2012-02-27,1,2,0,1,1,0,4,4,springer
2012-02-27,1,3,0,1,1,0,2,2,springer
2012-02-27,1,4,0,1,1,0,1,1,springer
2012-02-27,1,5,0,1,1,0,16,16,springer
2012-02-27,1,6,0,1,1,1,89,90,springer
2012-02-27,1,7,0,1,1,2,278,280,springer
2012-02-27,1,8,0,1,1,14,514,528,springer
2012-02-27,1,9,0,1,1,11,219,230,springer
2012-02-27,1,10,0,1,1,16,88,104,springer
2012-02-27,1,11,0,1,1,11,92,103,springer
2012-02-27,1,12,0,1,1,13,164,177,springer
2012-02-27,1,13,0,1,1,23,159,182,springer
2012-02-27,1,14,0,1,1,24,134,158,springer
2012-02-27,1,15,0,1,1,24,150,174,springer
2012-02-27,1,16,0,1,1,20,266,286,springer
2012-02-27,1,17,0,1,1,26,503,529,springer
2012-02-27,1,18,0,1,1,10,517,527,springer
2012-02-27,1,19,0,1,1,16,318,334,springer
2012-02-27,1,20,0,1,1,11,208,219,springer
2012-02-27,1,21,0,1,1,14,181,195,springer
2012-02-27,1,22,0,1,1,9,83,92,springer
2012-02-27,1,23,0,1,1,6,50,56,springer
2012-02-28,1,0,0,1,1,0,10,10,springer
2012-02-28,1,1,0,1,1,0,6,6,springer
2012-02-28,1,2,0,1,1,1,2,3,springer
2012-02-28,1,3,0,1,1,0,6,6,springer
2012-02-28,1,4,0,1,1,0,2,2,springer
2012-02-28,1,5,0,1,1,1,20,21,springer
2012-02-28,1,6,0,1,1,1,100,101,springer
2012-02-28,1,7,0,1,1,12,313,325,springer
2012-02-28,1,8,0,1,1,16,543,559,springer
2012-02-28,1,9,0,1,1,7,225,232,springer
2012-02-28,1,10,0,1,1,14,118,132,springer
2012-02-28,1,11,0,1,1,8,155,163,springer
2012-02-28,1,12,0,1,1,19,164,183,springer
2012-02-28,1,13,0,1,1,16,174,190,springer
2012-02-28,1,14,0,1,1,13,121,134,springer
2012-02-28,1,15,0,1,1,17,149,166,springer
2012-02-28,1,16,0,1,1,17,270,287,springer
2012-02-28,1,17,0,1,1,33,497,530,springer
2012-02-28,1,18,0,1,1,17,432,449,springer
2012-02-28,1,19,0,1,1,15,291,306,springer
2012-02-28,1,20,0,1,1,2,202,204,springer
2012-02-28,1,21,0,1,1,10,178,188,springer
2012-02-28,1,22,0,1,1,6,95,101,springer
2012-02-28,1,23,0,1,1,4,61,65,springer
2012-02-29,1,0,0,1,1,2,30,32,springer
2012-02-29,1,1,0,1,1,0,6,6,springer
2012-02-29,1,2,0,1,1,0,4,4,springer
2012-02-29,1,3,0,1,1,0,2,2,springer
2012-02-29,1,5,0,1,1,0,29,29,springer
2012-02-29,1,6,0,1,2,4,100,104,springer
2012-02-29,1,7,0,1,2,11,242,253,springer
2012-02-29,1,8,0,1,2,2,114,116,springer
2012-02-29,1,9,0,1,3,5,33,38,springer
2012-02-29,1,10,0,1,3,0,10,10,springer
2012-02-29,1,11,0,1,3,1,9,10,springer
2012-02-29,1,12,0,1,3,1,69,70,springer
2012-02-29,1,13,0,1,2,4,72,76,springer
2012-02-29,1,14,0,1,2,2,54,56,springer
2012-02-29,1,15,0,1,2,3,87,90,springer
2012-02-29,1,16,0,1,3,5,162,167,springer
2012-02-29,1,17,0,1,2,7,246,253,springer
2012-02-29,1,18,0,1,3,11,181,192,springer
2012-02-29,1,19,0,1,2,0,102,102,springer
2012-02-29,1,20,0,1,3,2,95,97,springer
2012-02-29,1,21,0,1,3,0,39,39,springer
2012-02-29,1,22,0,1,3,2,53,55,springer
2012-02-29,1,23,0,1,3,3,30,33,springer
2012-03-01,1,0,0,1,2,1,10,11,springer
2012-03-01,1,1,0,1,3,0,12,12,springer
2012-03-01,1,2,0,1,2,0,6,6,springer
2012-03-01,1,3,0,1,1,0,3,3,springer
2012-03-01,1,4,0,1,1,0,5,5,springer
2012-03-01,1,5,0,1,1,0,18,18,springer
2012-03-01,1,6,0,1,2,2,107,109,springer
2012-03-01,1,7,0,1,2,8,296,304,springer
2012-03-01,1,8,0,1,1,15,579,594,springer
2012-03-01,1,9,0,1,1,5,281,286,springer
2012-03-01,1,10,0,1,1,11,122,133,springer
2012-03-01,1,11,0,1,1,19,149,168,springer
2012-03-01,1,12,0,1,1,16,204,220,springer
2012-03-01,1,13,0,1,1,24,187,211,springer
2012-03-01,1,14,0,1,1,37,174,211,springer
2012-03-01,1,15,0,1,1,31,192,223,springer
2012-03-01,1,16,0,1,1,38,323,361,springer
2012-03-01,1,17,0,1,1,49,551,600,springer
2012-03-01,1,18,0,1,1,27,498,525,springer
2012-03-01,1,19,0,1,1,11,317,328,springer
2012-03-01,1,20,0,1,1,12,242,254,springer
2012-03-01,1,21,0,1,1,7,190,197,springer
2012-03-01,1,22,0,1,1,3,123,126,springer
2012-03-01,1,23,0,1,1,9,76,85,springer
2012-03-02,1,0,0,1,1,1,45,46,springer
2012-03-02,1,1,0,1,1,2,18,20,springer
2012-03-02,1,2,0,1,1,2,4,6,springer
2012-03-02,1,3,0,1,1,0,3,3,springer
2012-03-02,1,4,0,1,1,0,2,2,springer
2012-03-02,1,5,0,1,1,0,24,24,springer
2012-03-02,1,6,0,1,1,4,88,92,springer
2012-03-02,1,7,0,1,1,4,258,262,springer
2012-03-02,1,8,0,1,1,16,533,549,springer
2012-03-02,1,9,0,1,1,15,299,314,springer
2012-03-02,1,10,0,1,1,14,118,132,springer
2012-03-02,1,11,0,1,1,40,154,194,springer
2012-03-02,1,12,0,1,1,40,194,234,springer
2012-03-02,1,13,0,1,1,31,191,222,springer
2012-03-02,1,14,0,1,2,29,176,205,springer
2012-03-02,1,15,0,1,2,5,73,78,springer
2012-03-02,1,16,0,1,3,1,49,50,springer
2012-03-02,1,17,0,1,3,5,123,128,springer
2012-03-02,1,18,0,1,3,6,154,160,springer
2012-03-02,1,19,0,1,3,12,162,174,springer
2012-03-02,1,20,0,1,2,7,93,100,springer
2012-03-02,1,21,0,1,3,2,99,101,springer
2012-03-02,1,22,0,1,2,6,69,75,springer
2012-03-02,1,23,0,1,2,4,19,23,springer
2012-03-03,1,0,0,0,3,1,21,22,springer
2012-03-03,1,1,0,0,3,0,44,44,springer
2012-03-03,1,2,0,0,3,4,34,38,springer
2012-03-03,1,3,0,0,2,1,20,21,springer
2012-03-03,1,4,0,0,2,0,2,2,springer
2012-03-03,1,5,0,0,2,1,1,2,springer
2012-03-03,1,6,0,0,2,1,6,7,springer
2012-03-03,1,7,0,0,2,2,14,16,springer
2012-03-03,1,8,0,0,3,2,46,48,springer
2012-03-03,1,9,0,0,3,7,87,94,springer
2012-03-03,1,10,0,0,2,31,137,168,springer
2012-03-03,1,11,0,0,2,33,181,214,springer
2012-03-03,1,12,0,0,2,47,252,299,springer
2012-03-03,1,13,0,0,1,87,252,339,springer
2012-03-03,1,14,0,0,2,151,279,430,springer
2012-03-03,1,15,0,0,1,145,254,399,springer
2012-03-03,1,16,0,0,1,167,300,467,springer
2012-03-03,1,17,0,0,1,106,279,385,springer
2012-03-03,1,18,0,0,1,53,250,303,springer
2012-03-03,1,19,0,0,1,34,191,225,springer
2012-03-03,1,20,0,0,1,28,121,149,springer
2012-03-03,1,21,0,0,1,24,130,154,springer
2012-03-03,1,22,0,0,1,19,115,134,springer
2012-03-03,1,23,0,0,1,12,94,106,springer
2012-03-04,1,0,0,0,2,5,67,72,springer
2012-03-04,1,1,0,0,2,16,60,76,springer
2012-03-04,1,2,0,0,2,14,66,80,springer
2012-03-04,1,3,0,0,2,5,21,26,springer
2012-03-04,1,4,0,0,2,3,11,14,springer
2012-03-04,1,5,0,0,2,0,5,5,springer
2012-03-04,1,6,0,0,2,0,5,5,springer
2012-03-04,1,7,0,0,2,2,21,23,springer
2012-03-04,1,8,0,0,1,12,54,66,springer
2012-03-04,1,9,0,0,1,14,104,118,springer
2012-03-04,1,10,0,0,1,31,161,192,springer
2012-03-04,1,11,0,0,1,64,192,256,springer
2012-03-04,1,12,0,0,1,71,256,327,springer
2012-03-04,1,13,0,0,1,108,256,364,springer
2012-03-04,1,14,0,0,1,106,226,332,springer
2012-03-04,1,15,0,0,1,82,252,334,springer
2012-03-04,1,16,0,0,1,68,231,299,springer
2012-03-04,1,17,0,0,1,49,214,263,springer
2012-03-04,1,18,0,0,1,20,164,184,springer
2012-03-04,1,19,0,0,1,12,120,132,springer
2012-03-04,1,20,0,0,1,8,80,88,springer
2012-03-04,1,21,0,0,1,9,70,79,springer
2012-03-04,1,22,0,0,1,9,53,62,springer
2012-03-04,1,23,0,0,1,2,24,26,springer
2012-03-05,1,0,0,1,1,2,15,17,springer
2012-03-05,1,1,0,1,1,3,3,6,springer
2012-03-05,1,2,0,1,1,1,3,4,springer
2012-03-05,1,3,0,1,1,0,1,1,springer
2012-03-05,1,4,0,1,1,0,1,1,springer
2012-03-05,1,5,0,1,1,1,17,18,springer
2012-03-05,1,6,0,1,1,2,89,91,springer
2012-03-05,1,7,0,1,1,7,253,260,springer
2012-03-05,1,8,0,1,1,13,415,428,springer
2012-03-05,1,9,0,1,2,11,186,197,springer
2012-03-05,1,10,0,1,2,12,74,86,springer
2012-03-05,1,11,0,1,2,17,86,103,springer
2012-03-05,1,12,0,1,2,15,122,137,springer
2012-03-05,1,13,0,1,2,11,109,120,springer
2012-03-05,1,14,0,1,2,13,115,128,springer
2012-03-05,1,15,0,1,2,20,110,130,springer
2012-03-05,1,16,0,1,1,30,180,210,springer
2012-03-05,1,17,0,1,3,11,376,387,springer
2012-03-05,1,18,0,1,3,12,363,375,springer
2012-03-05,1,19,0,1,1,6,220,226,springer
2012-03-05,1,20,0,1,1,8,171,179,springer
2012-03-05,1,21,0,1,1,4,116,120,springer
2012-03-05,1,22,0,1,1,2,76,78,springer
2012-03-05,1,23,0,1,1,2,29,31,springer
2012-03-06,1,0,0,1,1,0,8,8,springer
2012-03-06,1,1,0,1,1,0,6,6,springer
2012-03-06,1,2,0,1,1,0,4,4,springer
2012-03-06,1,3,0,1,1,0,1,1,springer
2012-03-06,1,4,0,1,1,0,3,3,springer
2012-03-06,1,5,0,1,1,0,25,25,springer
2012-03-06,1,6,0,1,1,3,99,102,springer
2012-03-06,1,7,0,1,1,5,270,275,springer
2012-03-06,1,8,0,1,1,14,487,501,springer
2012-03-06,1,9,0,1,1,11,222,233,springer
2012-03-06,1,10,0,1,1,16,113,129,springer
2012-03-06,1,11,0,1,1,20,110,130,springer
2012-03-06,1,12,0,1,1,9,129,138,springer
2012-03-06,1,13,0,1,1,16,148,164,springer
2012-03-06,1,14,0,1,1,20,116,136,springer
2012-03-06,1,15,0,1,1,24,142,166,springer
2012-03-06,1,16,0,1,1,22,228,250,springer
2012-03-06,1,17,0,1,1,21,425,446,springer
2012-03-06,1,18,0,1,1,15,442,457,springer
2012-03-06,1,19,0,1,1,9,278,287,springer
2012-03-06,1,20,0,1,1,3,184,187,springer
2012-03-06,1,21,0,1,1,5,143,148,springer
2012-03-06,1,22,0,1,1,5,101,106,springer
2012-03-06,1,23,0,1,1,3,51,54,springer
2012-03-07,1,0,0,1,1,3,12,15,springer
2012-03-07,1,1,0,1,1,1,4,5,springer
2012-03-07,1,2,0,1,1,0,4,4,springer
2012-03-07,1,3,0,1,1,1,2,3,springer
2012-03-07,1,4,0,1,1,0,3,3,springer
2012-03-07,1,5,0,1,1,0,18,18,springer
2012-03-07,1,6,0,1,1,4,104,108,springer
2012-03-07,1,7,0,1,1,12,332,344,springer
2012-03-07,1,8,0,1,1,12,554,566,springer
2012-03-07,1,9,0,1,1,12,252,264,springer
2012-03-07,1,10,0,1,1,20,127,147,springer
2012-03-07,1,11,0,1,1,33,128,161,springer
2012-03-07,1,12,0,1,1,40,175,215,springer
2012-03-07,1,13,0,1,1,26,179,205,springer
2012-03-07,1,14,0,1,1,38,137,175,springer
2012-03-07,1,15,0,1,1,44,165,209,springer
2012-03-07,1,16,0,1,1,34,254,288,springer
2012-03-07,1,17,0,1,1,58,554,612,springer
2012-03-07,1,18,0,1,1,35,509,544,springer
2012-03-07,1,19,0,1,1,16,345,361,springer
2012-03-07,1,20,0,1,1,18,242,260,springer
2012-03-07,1,21,0,1,1,11,177,188,springer
2012-03-07,1,22,0,1,1,10,149,159,springer
2012-03-07,1,23,0,1,1,4,58,62,springer
2012-03-08,1,0,0,1,1,11,35,46,springer
2012-03-08,1,1,0,1,1,4,17,21,springer
2012-03-08,1,2,0,1,1,6,5,11,springer
2012-03-08,1,3,0,1,1,0,3,3,springer
2012-03-08,1,4,0,1,1,0,2,2,springer
2012-03-08,1,5,0,1,1,1,28,29,springer
2012-03-08,1,6,0,1,1,4,105,109,springer
2012-03-08,1,7,0,1,1,8,326,334,springer
2012-03-08,1,8,0,1,1,12,573,585,springer
2012-03-08,1,9,0,1,1,19,282,301,springer
2012-03-08,1,10,0,1,1,19,119,138,springer
2012-03-08,1,11,0,1,2,48,156,204,springer
2012-03-08,1,12,0,1,2,27,224,251,springer
2012-03-08,1,13,0,1,2,35,198,233,springer
2012-03-08,1,14,0,1,2,48,155,203,springer
2012-03-08,1,15,0,1,1,24,161,185,springer
2012-03-08,1,16,0,1,2,37,305,342,springer
2012-03-08,1,17,0,1,1,52,545,597,springer
2012-03-08,1,18,0,1,2,45,545,590,springer
2012-03-08,1,19,0,1,2,21,395,416,springer
2012-03-08,1,20,0,1,2,20,282,302,springer
2012-03-08,1,21,0,1,1,27,206,233,springer
2012-03-08,1,22,0,1,1,12,141,153,springer
2012-03-08,1,23,0,1,2,6,88,94,springer
2012-03-09,1,0,0,1,2,3,51,54,springer
2012-03-09,1,1,0,1,3,4,22,26,springer
2012-03-09,1,2,0,1,3,2,9,11,springer
2012-03-09,1,3,0,1,1,0,7,7,springer
2012-03-09,1,4,0,1,3,0,1,1,springer
2012-03-09,1,5,0,1,3,2,27,29,springer
2012-03-09,1,6,0,1,2,2,83,85,springer
2012-03-09,1,7,0,1,2,6,262,268,springer
2012-03-09,1,8,0,1,2,17,484,501,springer
2012-03-09,1,9,0,1,2,17,267,284,springer
2012-03-09,1,10,0,1,2,14,145,159,springer
2012-03-09,1,11,0,1,2,17,170,187,springer
2012-03-09,1,12,0,1,1,27,174,201,springer
2012-03-09,1,13,0,1,2,49,175,224,springer
2012-03-09,1,14,0,1,1,49,129,178,springer
2012-03-09,1,15,0,1,1,50,188,238,springer
2012-03-09,1,16,0,1,1,51,292,343,springer
2012-03-09,1,17,0,1,1,68,498,566,springer
2012-03-09,1,18,0,1,1,30,440,470,springer
2012-03-09,1,19,0,1,1,12,232,244,springer
2012-03-09,1,20,0,1,1,3,156,159,springer
2012-03-09,1,21,0,1,1,8,133,141,springer
2012-03-09,1,22,0,1,1,7,100,107,springer
2012-03-09,1,23,0,1,1,9,77,86,springer
2012-03-10,1,0,0,0,1,9,68,77,springer
2012-03-10,1,1,0,0,1,1,50,51,springer
2012-03-10,1,2,0,0,1,12,30,42,springer
2012-03-10,1,3,0,0,1,0,16,16,springer
2012-03-10,1,4,0,0,1,1,3,4,springer
2012-03-10,1,5,0,0,1,3,7,10,springer
2012-03-10,1,6,0,0,1,1,11,12,springer
2012-03-10,1,7,0,0,1,4,36,40,springer
2012-03-10,1,8,0,0,1,15,96,111,springer
2012-03-10,1,9,0,0,1,21,127,148,springer
2012-03-10,1,10,0,0,1,47,176,223,springer
2012-03-10,1,11,0,0,1,56,218,274,springer
2012-03-10,1,12,0,0,1,88,241,329,springer
2012-03-10,1,13,0,0,1,89,268,357,springer
2012-03-10,1,14,0,0,1,117,262,379,springer
2012-03-10,1,15,0,0,1,132,274,406,springer
2012-03-10,1,16,0,0,1,115,275,390,springer
2012-03-10,1,17,0,0,1,104,250,354,springer
2012-03-10,1,18,0,0,1,67,230,297,springer
2012-03-10,1,19,0,0,1,25,159,184,springer
2012-03-10,1,20,0,0,1,20,101,121,springer
2012-03-10,1,21,0,0,1,16,94,110,springer
2012-03-10,1,22,0,0,1,19,81,100,springer
2012-03-10,1,23,0,0,1,6,77,83,springer
2012-03-11,1,0,0,0,1,7,62,69,springer
2012-03-11,1,1,0,0,1,4,57,61,springer
2012-03-11,1,3,0,0,1,15,51,66,springer
2012-03-11,1,4,0,0,1,7,15,22,springer
2012-03-11,1,5,0,0,1,2,5,7,springer
2012-03-11,1,6,0,0,1,2,8,10,springer
2012-03-11,1,7,0,0,1,2,15,17,springer
2012-03-11,1,8,0,0,1,4,68,72,springer
2012-03-11,1,9,0,0,1,20,70,90,springer
2012-03-11,1,10,0,0,1,71,147,218,springer
2012-03-11,1,11,0,0,1,90,209,299,springer
2012-03-11,1,12,0,0,1,146,264,410,springer
2012-03-11,1,13,0,0,1,176,288,464,springer
2012-03-11,1,14,0,0,1,212,289,501,springer
2012-03-11,1,15,0,0,1,201,286,487,springer
2012-03-11,1,16,0,0,1,208,301,509,springer
2012-03-11,1,17,0,0,1,199,299,498,springer
2012-03-11,1,18,0,0,1,133,256,389,springer
2012-03-11,1,19,0,0,1,55,203,258,springer
2012-03-11,1,20,0,0,1,42,129,171,springer
2012-03-11,1,21,0,0,1,37,110,147,springer
2012-03-11,1,22,0,0,1,13,81,94,springer
2012-03-11,1,23,0,0,1,12,40,52,springer
2012-03-12,1,0,0,1,1,4,20,24,springer
2012-03-12,1,1,0,1,1,1,9,10,springer
2012-03-12,1,2,0,1,1,4,5,9,springer
2012-03-12,1,3,0,1,1,0,2,2,springer
2012-03-12,1,4,0,1,1,0,3,3,springer
2012-03-12,1,5,0,1,1,1,15,16,springer
2012-03-12,1,6,0,1,1,2,86,88,springer
2012-03-12,1,7,0,1,1,9,259,268,springer
2012-03-12,1,8,0,1,1,17,547,564,springer
2012-03-12,1,9,0,1,1,21,260,281,springer
2012-03-12,1,10,0,1,1,39,98,137,springer
2012-03-12,1,11,0,1,1,39,111,150,springer
2012-03-12,1,12,0,1,1,59,162,221,springer
2012-03-12,1,13,0,1,2,74,176,250,springer
2012-03-12,1,14,0,1,2,76,145,221,springer
2012-03-12,1,15,0,1,1,74,159,233,springer
2012-03-12,1,16,0,1,1,77,255,332,springer
2012-03-12,1,17,0,1,2,87,557,644,springer
2012-03-12,1,18,0,1,2,89,623,712,springer
2012-03-12,1,19,0,1,2,67,379,446,springer
2012-03-12,1,20,0,1,2,49,237,286,springer
2012-03-12,1,21,0,1,2,22,183,205,springer
2012-03-12,1,22,0,1,2,17,116,133,springer
2012-03-12,1,23,0,1,1,10,53,63,springer
2012-03-13,1,0,0,1,2,5,21,26,springer
2012-03-13,1,1,0,1,2,2,14,16,springer
2012-03-13,1,2,0,1,3,0,1,1,springer
2012-03-13,1,3,0,1,3,0,2,2,springer
2012-03-13,1,4,0,1,2,0,1,1,springer
2012-03-13,1,5,0,1,2,0,24,24,springer
2012-03-13,1,6,0,1,3,5,108,113,springer
2012-03-13,1,7,0,1,2,16,292,308,springer
2012-03-13,1,8,0,1,1,22,571,593,springer
2012-03-13,1,9,0,1,1,18,324,342,springer
2012-03-13,1,10,0,1,1,28,115,143,springer
2012-03-13,1,11,0,1,1,64,155,219,springer
2012-03-13,1,12,0,1,1,47,197,244,springer
2012-03-13,1,13,0,1,1,53,180,233,springer
2012-03-13,1,14,0,1,1,52,160,212,springer
2012-03-13,1,15,0,1,1,68,196,264,springer
2012-03-13,1,16,0,1,1,53,312,365,springer
2012-03-13,1,17,0,1,1,62,614,676,springer
2012-03-13,1,18,0,1,1,96,638,734,springer
2012-03-13,1,19,0,1,1,50,429,479,springer
2012-03-13,1,20,0,1,1,45,306,351,springer
2012-03-13,1,21,0,1,1,44,200,244,springer
2012-03-13,1,22,0,1,1,24,146,170,springer
2012-03-13,1,23,0,1,1,8,79,87,springer
2012-03-14,1,0,0,1,1,5,34,39,springer
2012-03-14,1,1,0,1,1,2,25,27,springer
2012-03-14,1,2,0,1,1,0,2,2,springer
2012-03-14,1,3,0,1,1,1,3,4,springer
2012-03-14,1,4,0,1,1,1,4,5,springer
2012-03-14,1,5,0,1,1,2,25,27,springer
2012-03-14,1,6,0,1,1,1,120,121,springer
2012-03-14,1,7,0,1,1,20,348,368,springer
2012-03-14,1,8,0,1,1,34,628,662,springer
2012-03-14,1,9,0,1,1,26,325,351,springer
2012-03-14,1,10,0,1,1,38,150,188,springer
2012-03-14,1,11,0,1,2,65,155,220,springer
2012-03-14,1,12,0,1,2,55,212,267,springer
2012-03-14,1,13,0,1,1,57,197,254,springer
2012-03-14,1,14,0,1,1,61,163,224,springer
2012-03-14,1,15,0,1,1,86,197,283,springer
2012-03-14,1,16,0,1,1,78,278,356,springer
2012-03-14,1,17,0,1,1,140,642,782,springer
2012-03-14,1,18,0,1,1,102,647,749,springer
2012-03-14,1,19,0,1,1,70,402,472,springer
2012-03-14,1,20,0,1,1,44,286,330,springer
2012-03-14,1,21,0,1,1,47,241,288,springer
2012-03-14,1,22,0,1,1,43,159,202,springer
2012-03-14,1,23,0,1,1,19,72,91,springer
2012-03-15,1,0,0,1,1,14,46,60,springer
2012-03-15,1,1,0,1,1,15,8,23,springer
2012-03-15,1,2,0,1,1,14,5,19,springer
2012-03-15,1,3,0,1,1,0,7,7,springer
2012-03-15,1,4,0,1,1,11,3,14,springer
2012-03-15,1,5,0,1,1,2,24,26,springer
2012-03-15,1,6,0,1,1,4,113,117,springer
2012-03-15,1,7,0,1,1,14,367,381,springer
2012-03-15,1,8,0,1,1,21,602,623,springer
2012-03-15,1,9,0,1,1,30,285,315,springer
2012-03-15,1,10,0,1,1,34,130,164,springer
2012-03-15,1,11,0,1,1,60,151,211,springer
2012-03-15,1,12,0,1,2,59,206,265,springer
2012-03-15,1,13,0,1,2,62,211,273,springer
2012-03-15,1,14,0,1,2,81,177,258,springer
2012-03-15,1,15,0,1,1,100,187,287,springer
2012-03-15,1,16,0,1,1,95,331,426,springer
2012-03-15,1,17,0,1,1,79,634,713,springer
2012-03-15,1,18,0,1,1,98,648,746,springer
2012-03-15,1,19,0,1,2,72,353,425,springer
2012-03-15,1,20,0,1,2,60,270,330,springer
2012-03-15,1,21,0,1,1,36,207,243,springer
2012-03-15,1,22,0,1,1,32,137,169,springer
2012-03-15,1,23,0,1,1,12,85,97,springer
2012-03-16,1,0,0,1,1,8,49,57,springer
2012-03-16,1,1,0,1,2,4,22,26,springer
2012-03-16,1,2,0,1,2,0,4,4,springer
2012-03-16,1,3,0,1,2,0,3,3,springer
2012-03-16,1,4,0,1,2,0,3,3,springer
2012-03-16,1,5,0,1,2,2,30,32,springer
2012-03-16,1,6,0,1,2,3,96,99,springer
2012-03-16,1,7,0,1,2,13,265,278,springer
2012-03-16,1,8,0,1,2,28,534,562,springer
2012-03-16,1,9,0,1,2,35,277,312,springer
2012-03-16,1,10,0,1,2,44,136,180,springer
2012-03-16,1,11,0,1,2,40,167,207,springer
2012-03-16,1,12,0,1,2,72,222,294,springer
2012-03-16,1,13,0,1,2,52,208,260,springer
2012-03-16,1,14,0,1,2,56,146,202,springer
2012-03-16,1,15,0,1,3,19,88,107,springer
2012-03-16,1,16,0,1,3,18,111,129,springer
2012-03-16,1,17,0,1,3,23,235,258,springer
2012-03-16,1,18,0,1,3,31,377,408,springer
2012-03-16,1,19,0,1,2,23,273,296,springer
2012-03-16,1,20,0,1,1,31,204,235,springer
2012-03-16,1,21,0,1,2,8,144,152,springer
2012-03-16,1,22,0,1,2,16,132,148,springer
2012-03-16,1,23,0,1,2,22,104,126,springer
2012-03-17,1,0,0,0,2,13,87,100,springer
2012-03-17,1,1,0,0,2,12,57,69,springer
2012-03-17,1,2,0,0,2,10,32,42,springer
2012-03-17,1,3,0,0,2,2,24,26,springer
2012-03-17,1,4,0,0,2,0,2,2,springer
2012-03-17,1,5,0,0,2,5,3,8,springer
2012-03-17,1,6,0,0,2,1,29,30,springer
2012-03-17,1,7,0,0,2,29,57,86,springer
2012-03-17,1,8,0,0,2,63,155,218,springer
2012-03-17,1,9,0,0,2,104,217,321,springer
2012-03-17,1,10,0,0,2,140,303,443,springer
2012-03-17,1,11,0,0,2,226,359,585,springer
2012-03-17,1,12,0,0,1,286,365,651,springer
2012-03-17,1,13,0,0,1,286,400,686,springer
2012-03-17,1,14,0,0,1,352,338,690,springer
2012-03-17,1,15,0,0,1,357,322,679,springer
2012-03-17,1,16,0,0,1,367,318,685,springer
2012-03-17,1,17,0,0,1,291,357,648,springer
2012-03-17,1,18,0,0,1,221,339,560,springer
2012-03-17,1,19,0,0,1,155,262,417,springer
2012-03-17,1,20,0,0,1,89,182,271,springer
2012-03-17,1,21,0,0,1,54,169,223,springer
2012-03-17,1,22,0,0,1,58,153,211,springer
2012-03-17,1,23,0,0,1,34,151,185,springer
2012-03-18,1,0,0,0,1,27,80,107,springer
2012-03-18,1,1,0,0,1,25,88,113,springer
2012-03-18,1,2,0,0,2,15,41,56,springer
2012-03-18,1,3,0,0,2,3,15,18,springer
2012-03-18,1,4,0,0,2,6,8,14,springer
2012-03-18,1,5,0,0,2,0,6,6,springer
2012-03-18,1,6,0,0,2,2,9,11,springer
2012-03-18,1,7,0,0,3,17,25,42,springer
2012-03-18,1,8,0,0,2,25,71,96,springer
2012-03-18,1,9,0,0,2,65,113,178,springer
2012-03-18,1,10,0,0,2,139,212,351,springer
2012-03-18,1,11,0,0,2,129,239,368,springer
2012-03-18,1,12,0,0,2,222,281,503,springer
2012-03-18,1,13,0,0,2,198,346,544,springer
2012-03-18,1,14,0,0,2,218,303,521,springer
2012-03-18,1,15,0,0,1,240,314,554,springer
2012-03-18,1,16,0,0,1,229,312,541,springer
2012-03-18,1,17,0,0,1,233,308,541,springer
2012-03-18,1,18,0,0,1,165,294,459,springer
2012-03-18,1,19,0,0,1,118,234,352,springer
2012-03-18,1,20,0,0,1,59,139,198,springer
2012-03-18,1,21,0,0,1,44,129,173,springer
2012-03-18,1,22,0,0,1,21,79,100,springer
2012-03-18,1,23,0,0,1,7,39,46,springer
2012-03-19,1,0,0,1,1,4,19,23,springer
2012-03-19,1,1,0,1,1,0,15,15,springer
2012-03-19,1,2,0,1,1,1,7,8,springer
2012-03-19,1,3,0,1,1,0,2,2,springer
2012-03-19,1,4,0,1,1,0,3,3,springer
2012-03-19,1,5,0,1,1,0,31,31,springer
2012-03-19,1,6,0,1,1,2,118,120,springer
2012-03-19,1,7,0,1,1,25,329,354,springer
2012-03-19,1,8,0,1,1,16,563,579,springer
2012-03-19,1,9,0,1,1,55,276,331,springer
2012-03-19,1,10,0,1,1,56,128,184,springer
2012-03-19,1,11,0,1,1,56,145,201,springer
2012-03-19,1,12,0,1,1,71,211,282,springer
2012-03-19,1,13,0,1,1,69,194,263,springer
2012-03-19,1,14,0,1,2,60,200,260,springer
2012-03-19,1,15,0,1,1,97,189,286,springer
2012-03-19,1,16,0,1,1,65,320,385,springer
2012-03-19,1,17,0,1,1,106,615,721,springer
2012-03-19,1,18,0,1,1,120,681,801,springer
2012-03-19,1,19,0,1,1,86,463,549,springer
2012-03-19,1,20,0,1,1,34,296,330,springer
2012-03-19,1,21,0,1,1,33,190,223,springer
2012-03-19,1,22,0,1,2,17,131,148,springer
2012-03-19,1,23,0,1,2,9,45,54,springer
2012-03-20,1,0,0,1,2,5,24,29,springer
2012-03-20,1,1,0,1,1,6,9,15,springer
2012-03-20,1,2,0,1,1,2,8,10,springer
2012-03-20,1,3,0,1,2,0,3,3,springer
2012-03-20,1,4,0,1,2,0,6,6,springer
2012-03-20,1,5,0,1,2,0,20,20,springer
2012-03-20,1,6,0,1,2,6,94,100,springer
2012-03-20,1,7,0,1,3,3,167,170,springer
2012-03-20,1,8,0,1,2,28,488,516,springer
2012-03-20,1,9,0,1,2,41,284,325,springer
2012-03-20,1,10,0,1,1,44,119,163,springer
2012-03-20,1,11,0,1,1,74,156,230,springer
2012-03-20,1,12,0,1,1,56,205,261,springer
2012-03-20,1,13,0,1,1,77,207,284,springer
2012-03-20,1,14,0,1,2,66,182,248,springer
2012-03-20,1,15,0,1,2,67,177,244,springer
2012-03-20,1,16,0,1,1,99,332,431,springer
2012-03-20,1,17,0,1,1,108,642,750,springer
2012-03-20,1,18,0,1,1,136,665,801,springer
2012-03-20,1,19,0,1,1,75,480,555,springer
2012-03-20,1,20,0,1,1,78,299,377,springer
2012-03-20,1,21,0,1,1,38,239,277,springer
2012-03-20,1,22,0,1,1,32,156,188,springer
2012-03-20,1,23,0,1,1,10,80,90,springer
2012-03-21,2,0,0,1,1,4,29,33,summer
2012-03-21,2,1,0,1,1,4,22,26,summer
2012-03-21,2,2,0,1,1,2,8,10,summer
2012-03-21,2,3,0,1,2,1,7,8,summer
2012-03-21,2,4,0,1,2,0,4,4,summer
2012-03-21,2,5,0,1,2,4,35,39,summer
2012-03-21,2,6,0,1,2,10,139,149,summer
2012-03-21,2,7,0,1,3,34,338,372,summer
2012-03-21,2,8,0,1,3,33,502,535,summer
2012-03-21,2,9,0,1,2,38,255,293,summer
2012-03-21,2,10,0,1,2,30,124,154,summer
2012-03-21,2,11,0,1,2,38,154,192,summer
2012-03-21,2,12,0,1,2,58,171,229,summer
2012-03-21,2,13,0,1,2,81,222,303,summer
2012-03-21,2,14,0,1,2,74,151,225,summer
2012-03-21,2,15,0,1,2,68,175,243,summer
2012-03-21,2,16,0,1,1,91,287,378,summer
2012-03-21,2,17,0,1,1,113,616,729,summer
2012-03-21,2,18,0,1,1,152,627,779,summer
2012-03-21,2,19,0,1,1,86,496,582,summer
2012-03-21,2,20,0,1,1,76,298,374,summer
2012-03-21,2,21,0,1,1,47,204,251,summer
2012-03-21,2,22,0,1,1,41,156,197,summer
2012-03-21,2,23,0,1,1,37,88,125,summer
2012-03-22,2,0,0,1,1,9,32,41,summer
2012-03-22,2,1,0,1,1,14,16,30,summer
2012-03-22,2,2,0,1,1,1,5,6,summer
2012-03-22,2,3,0,1,1,0,7,7,summer
2012-03-22,2,4,0,1,2,0,6,6,summer
2012-03-22,2,5,0,1,2,2,32,34,summer
2012-03-22,2,6,0,1,2,10,126,136,summer
2012-03-22,2,7,0,1,2,29,332,361,summer
2012-03-22,2,8,0,1,2,51,598,649,summer
2012-03-22,2,9,0,1,2,41,277,318,summer
2012-03-22,2,10,0,1,2,32,110,142,summer
2012-03-22,2,11,0,1,2,53,166,219,summer
2012-03-22,2,12,0,1,2,48,224,272,summer
2012-03-22,2,13,0,1,1,83,215,298,summer
2012-03-22,2,14,0,1,1,96,161,257,summer
2012-03-22,2,15,0,1,1,102,202,304,summer
2012-03-22,2,16,0,1,1,125,300,425,summer
2012-03-22,2,17,0,1,1,154,656,810,summer
2012-03-22,2,18,0,1,1,147,654,801,summer
2012-03-22,2,19,0,1,1,117,469,586,summer
2012-03-22,2,20,0,1,1,64,360,424,summer
2012-03-22,2,21,0,1,1,66,308,374,summer
2012-03-22,2,22,0,1,1,56,164,220,summer
2012-03-22,2,23,0,1,1,34,117,151,summer
2012-03-23,2,0,0,1,1,30,65,95,summer
2012-03-23,2,1,0,1,1,18,32,50,summer
2012-03-23,2,2,0,1,1,12,20,32,summer
2012-03-23,2,3,0,1,1,4,6,10,summer
2012-03-23,2,4,0,1,2,0,3,3,summer
2012-03-23,2,5,0,1,2,5,29,34,summer
2012-03-23,2,6,0,1,2,6,110,116,summer
2012-03-23,2,7,0,1,2,28,318,346,summer
2012-03-23,2,8,0,1,2,47,615,662,summer
2012-03-23,2,9,0,1,2,75,305,380,summer
2012-03-23,2,10,0,1,2,125,150,275,summer
2012-03-23,2,11,0,1,2,131,187,318,summer
2012-03-23,2,12,0,1,2,199,272,471,summer
2012-03-23,2,13,0,1,2,172,256,428,summer
2012-03-23,2,14,0,1,2,208,224,432,summer
2012-03-23,2,15,0,1,2,191,281,472,summer
2012-03-23,2,16,0,1,2,219,370,589,summer
2012-03-23,2,17,0,1,2,264,693,957,summer
2012-03-23,2,18,0,1,1,237,593,830,summer
2012-03-23,2,19,0,1,1,213,473,686,summer
2012-03-23,2,20,0,1,1,117,328,445,summer
2012-03-23,2,21,0,1,1,64,220,284,summer
2012-03-23,2,22,0,1,1,53,218,271,summer
2012-03-23,2,23,0,1,1,51,125,176,summer
2012-03-24,2,0,0,0,1,45,111,156,summer
2012-03-24,2,1,0,0,1,20,108,128,summer
2012-03-24,2,2,0,0,1,14,55,69,summer
2012-03-24,2,3,0,0,1,10,22,32,summer
2012-03-24,2,4,0,0,1,1,6,7,summer
2012-03-24,2,5,0,0,2,0,4,4,summer
2012-03-24,2,6,0,0,2,4,24,28,summer
2012-03-24,2,7,0,0,2,25,45,70,summer
2012-03-24,2,8,0,0,2,41,113,154,summer
2012-03-24,2,9,0,0,2,96,153,249,summer
2012-03-24,2,10,0,0,2,148,197,345,summer
2012-03-24,2,11,0,0,2,98,175,273,summer
2012-03-24,2,12,0,0,3,61,122,183,summer
2012-03-24,2,13,0,0,3,62,134,196,summer
2012-03-24,2,14,0,0,3,63,160,223,summer
2012-03-24,2,15,0,0,3,118,172,290,summer
2012-03-24,2,16,0,0,3,49,128,177,summer
2012-03-24,2,17,0,0,3,47,68,115,summer
2012-03-24,2,18,0,0,3,27,110,137,summer
2012-03-24,2,19,0,0,3,28,105,133,summer
2012-03-24,2,20,0,0,3,31,80,111,summer
2012-03-24,2,21,0,0,3,16,88,104,summer
2012-03-24,2,22,0,0,3,12,71,83,summer
2012-03-24,2,23,0,0,2,17,88,105,summer
2012-03-25,2,0,0,0,2,18,62,80,summer
2012-03-25,2,1,0,0,2,24,65,89,summer
2012-03-25,2,2,0,0,3,6,29,35,summer
2012-03-25,2,3,0,0,3,8,10,18,summer
2012-03-25,2,4,0,0,2,1,7,8,summer
2012-03-25,2,5,0,0,2,0,6,6,summer
2012-03-25,2,6,0,0,2,5,13,18,summer
2012-03-25,2,7,0,0,2,14,25,39,summer
2012-03-25,2,8,0,0,2,21,68,89,summer
2012-03-25,2,9,0,0,2,26,92,118,summer
2012-03-25,2,10,0,0,2,78,172,250,summer
2012-03-25,2,11,0,0,2,106,217,323,summer
2012-03-25,2,12,0,0,2,122,238,360,summer
2012-03-25,2,13,0,0,2,110,257,367,summer
2012-03-25,2,14,0,0,2,123,291,414,summer
2012-03-25,2,15,0,0,2,139,282,421,summer
2012-03-25,2,16,0,0,1,153,339,492,summer
2012-03-25,2,17,0,0,1,146,273,419,summer
2012-03-25,2,18,0,0,1,202,289,491,summer
2012-03-25,2,19,0,0,1,114,261,375,summer
2012-03-25,2,20,0,0,1,63,196,259,summer
2012-03-25,2,21,0,0,1,25,124,149,summer
2012-03-25,2,22,0,0,1,19,92,111,summer
2012-03-25,2,23,0,0,1,9,56,65,summer
2012-03-26,2,0,0,1,2,10,23,33,summer
2012-03-26,2,1,0,1,1,18,10,28,summer
2012-03-26,2,2,0,1,1,14,6,20,summer
2012-03-26,2,3,0,1,1,0,1,1,summer
2012-03-26,2,4,0,1,1,0,4,4,summer
2012-03-26,2,5,0,1,1,0,36,36,summer
2012-03-26,2,6,0,1,1,7,110,117,summer
2012-03-26,2,7,0,1,1,15,355,370,summer
2012-03-26,2,8,0,1,1,32,625,657,summer
2012-03-26,2,9,0,1,1,37,245,282,summer
2012-03-26,2,10,0,1,1,55,98,153,summer
2012-03-26,2,11,0,1,1,47,131,178,summer
2012-03-26,2,12,0,1,1,63,216,279,summer
2012-03-26,2,13,0,1,1,79,222,301,summer
2012-03-26,2,14,0,1,1,58,159,217,summer
2012-03-26,2,15,0,1,1,66,157,223,summer
2012-03-26,2,16,0,1,1,60,245,305,summer
2012-03-26,2,17,0,1,1,65,599,664,summer
2012-03-26,2,18,0,1,1,90,594,684,summer
2012-03-26,2,19,0,1,1,41,417,458,summer
2012-03-26,2,20,0,1,1,12,209,221,summer
2012-03-26,2,21,0,1,1,11,175,186,summer
2012-03-26,2,22,0,1,1,13,80,93,summer
2012-03-26,2,23,0,1,1,2,46,48,summer
2012-03-27,2,0,0,1,1,1,9,10,summer
2012-03-27,2,1,0,1,1,1,4,5,summer
2012-03-27,2,2,0,1,1,1,6,7,summer
2012-03-27,2,3,0,1,1,0,4,4,summer
2012-03-27,2,4,0,1,1,0,3,3,summer
2012-03-27,2,5,0,1,1,1,16,17,summer
2012-03-27,2,6,0,1,1,5,96,101,summer
2012-03-27,2,7,0,1,1,9,277,286,summer
2012-03-27,2,8,0,1,1,14,567,581,summer
2012-03-27,2,9,0,1,1,8,259,267,summer
2012-03-27,2,10,0,1,1,20,118,138,summer
2012-03-27,2,11,0,1,1,34,141,175,summer
2012-03-27,2,12,0,1,1,34,186,220,summer
2012-03-27,2,13,0,1,1,46,165,211,summer
2012-03-27,2,14,0,1,1,37,147,184,summer
2012-03-27,2,15,0,1,1,42,158,200,summer
2012-03-27,2,16,0,1,1,38,267,305,summer
2012-03-27,2,17,0,1,1,72,542,614,summer
2012-03-27,2,18,0,1,1,67,577,644,summer
2012-03-27,2,19,0,1,1,40,377,417,summer
2012-03-27,2,20,0,1,1,28,266,294,summer
2012-03-27,2,21,0,1,1,21,200,221,summer
2012-03-27,2,22,0,1,1,7,127,134,summer
2012-03-27,2,23,0,1,1,5,59,64,summer
2012-03-28,2,0,0,1,1,1,29,30,summer
2012-03-28,2,1,0,1,1,0,8,8,summer
2012-03-28,2,2,0,1,1,0,3,3,summer
2012-03-28,2,3,0,1,1,1,4,5,summer
2012-03-28,2,4,0,1,1,1,0,1,summer
2012-03-28,2,5,0,1,1,2,38,40,summer
2012-03-28,2,6,0,1,1,4,111,115,summer
2012-03-28,2,7,0,1,1,10,348,358,summer
2012-03-28,2,8,0,1,1,19,639,658,summer
2012-03-28,2,9,0,1,1,16,298,314,summer
2012-03-28,2,10,0,1,1,33,140,173,summer
2012-03-28,2,11,0,1,1,54,168,222,summer
2012-03-28,2,12,0,1,2,50,218,268,summer
2012-03-28,2,13,0,1,1,60,213,273,summer
2012-03-28,2,14,0,1,1,52,169,221,summer
2012-03-28,2,15,0,1,2,47,152,199,summer
2012-03-28,2,16,0,1,3,51,170,221,summer
2012-03-28,2,17,0,1,1,72,532,604,summer
2012-03-28,2,18,0,1,1,61,580,641,summer
2012-03-28,2,19,0,1,1,41,415,456,summer
2012-03-28,2,20,0,1,1,38,324,362,summer
2012-03-28,2,21,0,1,1,28,233,261,summer
2012-03-28,2,22,0,1,1,21,151,172,summer
2012-03-28,2,23,0,1,1,12,81,93,summer
2012-03-29,2,0,0,1,1,10,38,48,summer
2012-03-29,2,1,0,1,1,15,18,33,summer
2012-03-29,2,2,0,1,1,0,6,6,summer
2012-03-29,2,3,0,1,1,1,4,5,summer
2012-03-29,2,4,0,1,1,1,8,9,summer
2012-03-29,2,5,0,1,1,2,30,32,summer
2012-03-29,2,6,0,1,1,3,114,117,summer
2012-03-29,2,7,0,1,1,14,353,367,summer
2012-03-29,2,8,0,1,1,26,628,654,summer
2012-03-29,2,9,0,1,1,22,299,321,summer
2012-03-29,2,10,0,1,1,42,124,166,summer
2012-03-29,2,11,0,1,1,54,166,220,summer
2012-03-29,2,12,0,1,1,64,228,292,summer
2012-03-29,2,13,0,1,1,50,223,273,summer
2012-03-29,2,14,0,1,1,63,175,238,summer
2012-03-29,2,15,0,1,1,109,198,307,summer
2012-03-29,2,16,0,1,1,67,321,388,summer
2012-03-29,2,17,0,1,1,83,620,703,summer
2012-03-29,2,18,0,1,1,83,598,681,summer
2012-03-29,2,19,0,1,1,47,421,468,summer
2012-03-29,2,20,0,1,1,34,301,335,summer
2012-03-29,2,21,0,1,1,10,214,224,summer
2012-03-29,2,22,0,1,1,17,135,152,summer
2012-03-29,2,23,0,1,1,17,77,94,summer
2012-03-30,2,0,0,1,1,10,49,59,summer
2012-03-30,2,1,0,1,1,6,21,27,summer
2012-03-30,2,2,0,1,1,1,6,7,summer
2012-03-30,2,3,0,1,1,0,7,7,summer
2012-03-30,2,4,0,1,1,1,1,2,summer
2012-03-30,2,5,0,1,1,0,26,26,summer
2012-03-30,2,6,0,1,1,5,81,86,summer
2012-03-30,2,7,0,1,1,9,280,289,summer
2012-03-30,2,8,0,1,1,38,555,593,summer
2012-03-30,2,9,0,1,1,29,292,321,summer
2012-03-30,2,10,0,1,2,50,137,187,summer
2012-03-30,2,11,0,1,2,48,153,201,summer
2012-03-30,2,12,0,1,2,62,208,270,summer
2012-03-30,2,13,0,1,3,44,198,242,summer
2012-03-30,2,14,0,1,3,56,173,229,summer
2012-03-30,2,15,0,1,3,73,207,280,summer
2012-03-30,2,16,0,1,3,75,292,367,summer
2012-03-30,2,17,0,1,2,93,513,606,summer
2012-03-30,2,18,0,1,1,68,492,560,summer
2012-03-30,2,19,0,1,1,42,353,395,summer
2012-03-30,2,20,0,1,1,17,192,209,summer
2012-03-30,2,21,0,1,1,30,190,220,summer
2012-03-30,2,22,0,1,1,23,130,153,summer
2012-03-30,2,23,0,1,1,16,107,123,summer
2012-03-31,2,0,0,0,1,12,80,92,summer
2012-03-31,2,1,0,0,2,17,65,82,summer
2012-03-31,2,2,0,0,2,14,55,69,summer
2012-03-31,2,3,0,0,1,10,21,31,summer
2012-03-31,2,4,0,0,1,4,4,8,summer
2012-03-31,2,5,0,0,1,0,5,5,summer
2012-03-31,2,6,0,0,2,7,16,23,summer
2012-03-31,2,7,0,0,2,5,39,44,summer
2012-03-31,2,8,0,0,2,19,126,145,summer
2012-03-31,2,9,0,0,2,62,161,223,summer
2012-03-31,2,10,0,0,2,108,205,313,summer
2012-03-31,2,11,0,0,1,184,279,463,summer
2012-03-31,2,12,0,0,1,263,358,621,summer
2012-03-31,2,13,0,0,1,265,373,638,summer
2012-03-31,2,14,0,0,2,240,311,551,summer
2012-03-31,2,15,0,0,2,275,330,605,summer
2012-03-31,2,16,0,0,2,243,292,535,summer
2012-03-31,2,17,0,0,1,238,305,543,summer
2012-03-31,2,18,0,0,2,102,239,341,summer
2012-03-31,2,19,0,0,1,93,191,284,summer
2012-03-31,2,20,0,0,2,52,156,208,summer
2012-03-31,2,21,0,0,2,36,107,143,summer
2012-03-31,2,22,0,0,2,40,116,156,summer
2012-03-31,2,23,0,0,2,12,100,112,summer
2012-04-01,2,0,0,0,2,8,59,67,summer
2012-04-01,2,1,0,0,2,13,49,62,summer
2012-04-01,2,2,0,0,2,20,61,81,summer
2012-04-01,2,3,0,0,2,4,21,25,summer
2012-04-01,2,4,0,0,2,3,9,12,summer
2012-04-01,2,5,0,0,2,8,10,18,summer
2012-04-01,2,6,0,0,2,9,88,97,summer
2012-04-01,2,7,0,0,2,29,55,84,summer
2012-04-01,2,8,0,0,2,37,88,125,summer
2012-04-01,2,9,0,0,2,102,173,275,summer
2012-04-01,2,10,0,0,2,132,228,360,summer
2012-04-01,2,11,0,0,2,180,271,451,summer
2012-04-01,2,12,0,0,2,187,258,445,summer
2012-04-01,2,13,0,0,2,190,274,464,summer
2012-04-01,2,14,0,0,2,283,278,561,summer
2012-04-01,2,15,0,0,1,295,278,573,summer
2012-04-01,2,16,0,0,1,236,275,511,summer
2012-04-01,2,17,0,0,1,232,323,555,summer
2012-04-01,2,18,0,0,1,153,279,432,summer
2012-04-01,2,19,0,0,1,110,236,346,summer
2012-04-01,2,20,0,0,2,66,166,232,summer
2012-04-01,2,21,0,0,2,33,101,134,summer
2012-04-01,2,22,0,0,3,7,61,68,summer
2012-04-01,2,23,0,0,3,10,53,63,summer
2012-04-02,2,0,0,1,3,6,11,17,summer
2012-04-02,2,1,0,1,3,0,5,5,summer
2012-04-02,2,2,0,1,3,2,3,5,summer
2012-04-02,2,4,0,1,1,2,2,4,summer
2012-04-02,2,5,0,1,1,2,22,24,summer
2012-04-02,2,6,0,1,1,6,104,110,summer
2012-04-02,2,7,0,1,1,12,294,306,summer
2012-04-02,2,8,0,1,1,36,553,589,summer
2012-04-02,2,9,0,1,1,52,265,317,summer
2012-04-02,2,10,0,1,1,85,119,204,summer
2012-04-02,2,11,0,1,1,81,128,209,summer
2012-04-02,2,12,0,1,1,100,181,281,summer
2012-04-02,2,13,0,1,1,97,184,281,summer
2012-04-02,2,14,0,1,1,127,141,268,summer
2012-04-02,2,15,0,1,1,132,192,324,summer
2012-04-02,2,16,0,1,1,104,291,395,summer
2012-04-02,2,17,0,1,1,128,601,729,summer
2012-04-02,2,18,0,1,1,75,543,618,summer
2012-04-02,2,19,0,1,1,66,428,494,summer
2012-04-02,2,20,0,1,1,48,281,329,summer
2012-04-02,2,21,0,1,1,24,214,238,summer
2012-04-02,2,22,0,1,1,17,106,123,summer
2012-04-02,2,23,0,1,1,6,60,66,summer
2012-04-03,2,0,0,1,1,1,32,33,summer
2012-04-03,2,1,0,1,1,0,11,11,summer
2012-04-03,2,2,0,1,1,0,5,5,summer
2012-04-03,2,3,0,1,1,0,3,3,summer
2012-04-03,2,4,0,1,1,0,1,1,summer
2012-04-03,2,5,0,1,1,2,25,27,summer
2012-04-03,2,6,0,1,1,2,98,100,summer
2012-04-03,2,7,0,1,1,14,327,341,summer
2012-04-03,2,8,0,1,1,27,577,604,summer
2012-04-03,2,9,0,1,1,54,354,408,summer
2012-04-03,2,10,0,1,1,77,142,219,summer
2012-04-03,2,11,0,1,1,91,167,258,summer
2012-04-03,2,12,0,1,1,101,230,331,summer
2012-04-03,2,13,0,1,1,120,225,345,summer
2012-04-03,2,14,0,1,1,120,191,311,summer
2012-04-03,2,15,0,1,1,109,207,316,summer
2012-04-03,2,16,0,1,1,145,340,485,summer
2012-04-03,2,17,0,1,1,123,634,757,summer
2012-04-03,2,18,0,1,1,139,661,800,summer
2012-04-03,2,19,0,1,1,98,460,558,summer
2012-04-03,2,20,0,1,1,54,325,379,summer
2012-04-03,2,21,0,1,1,33,210,243,summer
2012-04-03,2,22,0,1,1,25,133,158,summer
2012-04-03,2,23,0,1,1,13,66,79,summer
2012-04-04,2,0,0,1,1,18,23,41,summer
2012-04-04,2,1,0,1,1,0,11,11,summer
2012-04-04,2,2,0,1,1,0,5,5,summer
2012-04-04,2,3,0,1,1,0,3,3,summer
2012-04-04,2,4,0,1,1,0,1,1,summer
2012-04-04,2,5,0,1,1,0,27,27,summer
2012-04-04,2,6,0,1,2,6,120,126,summer
2012-04-04,2,7,0,1,2,12,354,366,summer
2012-04-04,2,8,0,1,2,31,653,684,summer
2012-04-04,2,9,0,1,2,47,316,363,summer
2012-04-04,2,10,0,1,2,68,99,167,summer
2012-04-04,2,11,0,1,2,61,152,213,summer
2012-04-04,2,12,0,1,2,73,210,283,summer
2012-04-04,2,13,0,1,2,70,181,251,summer
2012-04-04,2,14,0,1,2,82,176,258,summer
2012-04-04,2,15,0,1,2,86,182,268,summer
2012-04-04,2,16,0,1,2,86,304,390,summer
2012-04-04,2,17,0,1,1,99,645,744,summer
2012-04-04,2,18,0,1,1,113,646,759,summer
2012-04-04,2,19,0,1,1,75,419,494,summer
2012-04-04,2,20,0,1,1,39,333,372,summer
2012-04-04,2,21,0,1,1,43,255,298,summer
2012-04-04,2,22,0,1,1,30,151,181,summer
2012-04-04,2,23,0,1,1,19,112,131,summer
2012-04-05,2,0,0,1,1,12,33,45,summer
2012-04-05,2,1,0,1,1,4,9,13,summer
2012-04-05,2,2,0,1,1,7,11,18,summer
2012-04-05,2,3,0,1,1,0,5,5,summer
2012-04-05,2,4,0,1,1,0,1,1,summer
2012-04-05,2,5,0,1,1,1,28,29,summer
2012-04-05,2,6,0,1,1,8,118,126,summer
2012-04-05,2,7,0,1,1,15,339,354,summer
2012-04-05,2,8,0,1,1,28,610,638,summer
2012-04-05,2,9,0,1,1,61,290,351,summer
2012-04-05,2,10,0,1,1,88,158,246,summer
2012-04-05,2,11,0,1,2,109,159,268,summer
2012-04-05,2,12,0,1,1,66,210,276,summer
2012-04-05,2,13,0,1,1,89,202,291,summer
2012-04-05,2,14,0,1,1,143,144,287,summer
2012-04-05,2,15,0,1,1,98,171,269,summer
2012-04-05,2,16,0,1,1,84,318,402,summer
2012-04-05,2,17,0,1,1,145,677,822,summer
2012-04-05,2,18,0,1,1,80,618,698,summer
2012-04-05,2,19,0,1,1,64,423,487,summer
2012-04-05,2,20,0,1,1,33,279,312,summer
2012-04-05,2,21,0,1,1,25,209,234,summer
2012-04-05,2,22,0,1,1,20,129,149,summer
2012-04-05,2,23,0,1,1,12,124,136,summer
2012-04-06,2,0,0,1,1,12,49,61,summer
2012-04-06,2,1,0,1,1,10,28,38,summer
2012-04-06,2,2,0,1,1,6,5,11,summer
2012-04-06,2,3,0,1,1,3,5,8,summer
2012-04-06,2,4,0,1,1,2,3,5,summer
2012-04-06,2,5,0,1,1,0,23,23,summer
2012-04-06,2,6,0,1,1,0,80,80,summer
2012-04-06,2,7,0,1,1,15,231,246,summer
2012-04-06,2,8,0,1,1,19,489,508,summer
2012-04-06,2,9,0,1,1,58,318,376,summer
2012-04-06,2,10,0,1,1,81,157,238,summer
2012-04-06,2,11,0,1,1,112,179,291,summer
2012-04-06,2,12,0,1,1,113,224,337,summer
2012-04-06,2,13,0,1,1,173,238,411,summer
2012-04-06,2,14,0,1,1,240,250,490,summer
2012-04-06,2,15,0,1,1,218,319,537,summer
2012-04-06,2,16,0,1,1,184,352,536,summer
2012-04-06,2,17,0,1,1,172,483,655,summer
2012-04-06,2,18,0,1,1,104,380,484,summer
2012-04-06,2,19,0,1,1,115,297,412,summer
2012-04-06,2,20,0,1,1,61,191,252,summer
2012-04-06,2,21,0,1,1,54,136,190,summer
2012-04-06,2,22,0,1,1,34,124,158,summer
2012-04-06,2,23,0,1,1,21,92,113,summer
2012-04-07,2,0,0,0,1,9,85,94,summer
2012-04-07,2,1,0,0,1,9,60,69,summer
2012-04-07,2,2,0,0,1,11,25,36,summer
2012-04-07,2,3,0,0,1,7,21,28,summer
2012-04-07,2,4,0,0,1,3,4,7,summer
2012-04-07,2,5,0,0,1,0,2,2,summer
2012-04-07,2,6,0,0,1,1,18,19,summer
2012-04-07,2,7,0,0,1,14,40,54,summer
2012-04-07,2,8,0,0,1,29,94,123,summer
2012-04-07,2,9,0,0,1,103,173,276,summer
2012-04-07,2,10,0,0,1,187,176,363,summer
2012-04-07,2,11,0,0,1,251,244,495,summer
2012-04-07,2,12,0,0,1,320,270,590,summer
2012-04-07,2,13,0,0,1,355,288,643,summer
2012-04-07,2,14,0,0,1,326,252,578,summer
2012-04-07,2,15,0,0,1,321,305,626,summer
2012-04-07,2,16,0,0,1,354,261,615,summer
2012-04-07,2,17,0,0,1,299,268,567,summer
2012-04-07,2,18,0,0,1,227,290,517,summer
2012-04-07,2,19,0,0,1,170,243,413,summer
2012-04-07,2,20,0,0,1,73,135,208,summer
2012-04-07,2,21,0,0,1,75,159,234,summer
2012-04-07,2,22,0,0,1,76,106,182,summer
2012-04-07,2,23,0,0,1,32,86,118,summer
2012-04-08,2,0,0,0,1,21,64,85,summer
2012-04-08,2,1,0,0,1,14,50,64,summer
2012-04-08,2,2,0,0,1,7,25,32,summer
2012-04-08,2,3,0,0,1,8,18,26,summer
2012-04-08,2,4,0,0,1,0,7,7,summer
2012-04-08,2,5,0,0,1,4,8,12,summer
2012-04-08,2,6,0,0,1,7,21,28,summer
2012-04-08,2,7,0,0,1,12,25,37,summer
2012-04-08,2,8,0,0,1,19,65,84,summer
2012-04-08,2,9,0,0,1,71,108,179,summer
2012-04-08,2,10,0,0,1,113,186,299,summer
2012-04-08,2,11,0,0,1,195,209,404,summer
2012-04-08,2,12,0,0,1,198,259,457,summer
2012-04-08,2,13,0,0,1,229,254,483,summer
2012-04-08,2,14,0,0,1,254,249,503,summer
2012-04-08,2,15,0,0,1,260,226,486,summer
2012-04-08,2,16,0,0,1,232,244,476,summer
2012-04-08,2,17,0,0,1,185,226,411,summer
2012-04-08,2,18,0,0,1,151,159,310,summer
2012-04-08,2,19,0,0,1,89,187,276,summer
2012-04-08,2,20,0,0,1,65,146,211,summer
2012-04-08,2,21,0,0,1,53,77,130,summer
2012-04-08,2,22,0,0,1,33,85,118,summer
2012-04-08,2,23,0,0,1,10,41,51,summer
2012-04-09,2,0,0,1,1,8,29,37,summer
2012-04-09,2,1,0,1,1,4,12,16,summer
2012-04-09,2,2,0,1,1,2,4,6,summer
2012-04-09,2,3,0,1,1,0,3,3,summer
2012-04-09,2,4,0,1,1,2,3,5,summer
2012-04-09,2,5,0,1,1,2,30,32,summer
2012-04-09,2,6,0,1,1,3,108,111,summer
2012-04-09,2,7,0,1,1,11,320,331,summer
2012-04-09,2,8,0,1,1,22,595,617,summer
2012-04-09,2,9,0,1,1,50,236,286,summer
2012-04-09,2,10,0,1,1,65,113,178,summer
2012-04-09,2,11,0,1,1,96,127,223,summer
2012-04-09,2,12,0,1,1,94,186,280,summer
2012-04-09,2,13,0,1,1,108,173,281,summer
2012-04-09,2,14,0,1,1,66,152,218,summer
2012-04-09,2,15,0,1,1,82,173,255,summer
2012-04-09,2,16,0,1,1,81,310,391,summer
2012-04-09,2,17,0,1,1,67,565,632,summer
2012-04-09,2,18,0,1,1,60,586,646,summer
2012-04-09,2,19,0,1,1,35,386,421,summer
2012-04-09,2,20,0,1,1,21,255,276,summer
2012-04-09,2,21,0,1,3,14,151,165,summer
2012-04-09,2,22,0,1,2,6,102,108,summer
2012-04-09,2,23,0,1,1,6,61,67,summer
2012-04-10,2,0,0,1,2,3,23,26,summer
2012-04-10,2,1,0,1,1,0,9,9,summer
2012-04-10,2,2,0,1,1,0,2,2,summer
2012-04-10,2,3,0,1,1,0,2,2,summer
2012-04-10,2,4,0,1,1,0,2,2,summer
2012-04-10,2,5,0,1,1,0,24,24,summer
2012-04-10,2,6,0,1,1,3,100,103,summer
2012-04-10,2,7,0,1,1,16,368,384,summer
2012-04-10,2,8,0,1,1,22,670,692,summer
2012-04-10,2,9,0,1,1,16,303,319,summer
2012-04-10,2,10,0,1,1,49,132,181,summer
2012-04-10,2,11,0,1,1,78,161,239,summer
2012-04-10,2,12,0,1,1,75,184,259,summer
2012-04-10,2,13,0,1,1,81,202,283,summer
2012-04-10,2,14,0,1,1,75,149,224,summer
2012-04-10,2,15,0,1,1,46,157,203,summer
2012-04-10,2,16,0,1,1,66,296,362,summer
2012-04-10,2,17,0,1,1,88,656,744,summer
2012-04-10,2,18,0,1,1,78,626,704,summer
2012-04-10,2,19,0,1,1,51,428,479,summer
2012-04-10,2,20,0,1,1,34,248,282,summer
2012-04-10,2,21,0,1,1,15,191,206,summer
2012-04-10,2,22,0,1,1,9,118,127,summer
2012-04-10,2,23,0,1,1,14,48,62,summer
2012-04-11,2,0,0,1,1,8,22,30,summer
2012-04-11,2,1,0,1,1,3,9,12,summer
2012-04-11,2,2,0,1,1,0,2,2,summer
2012-04-11,2,3,0,1,1,0,2,2,summer
2012-04-11,2,5,0,1,1,1,26,27,summer
2012-04-11,2,6,0,1,1,3,103,106,summer
2012-04-11,2,7,0,1,1,18,303,321,summer
2012-04-11,2,8,0,1,1,14,581,595,summer
2012-04-11,2,9,0,1,2,20,282,302,summer
2012-04-11,2,10,0,1,2,26,127,153,summer
2012-04-11,2,11,0,1,2,38,142,180,summer
2012-04-11,2,12,0,1,2,35,147,182,summer
2012-04-11,2,13,0,1,2,16,147,163,summer
2012-04-11,2,14,0,1,1,34,101,135,summer
2012-04-11,2,15,0,1,3,50,152,202,summer
2012-04-11,2,16,0,1,1,51,256,307,summer
2012-04-11,2,17,0,1,1,52,527,579,summer
2012-04-11,2,18,0,1,3,39,546,585,summer
2012-04-11,2,19,0,1,1,28,356,384,summer
2012-04-11,2,20,0,1,1,22,213,235,summer
2012-04-11,2,21,0,1,1,11,154,165,summer
2012-04-11,2,22,0,1,1,4,130,134,summer
2012-04-11,2,23,0,1,1,9,52,61,summer
2012-04-12,2,0,0,1,1,1,22,23,summer
2012-04-12,2,1,0,1,1,2,7,9,summer
2012-04-12,2,2,0,1,1,0,4,4,summer
2012-04-12,2,3,0,1,1,2,3,5,summer
2012-04-12,2,4,0,1,1,0,1,1,summer
2012-04-12,2,5,0,1,1,0,21,21,summer
2012-04-12,2,6,0,1,1,2,94,96,summer
2012-04-12,2,7,0,1,1,12,294,306,summer
2012-04-12,2,8,0,1,1,20,604,624,summer
2012-04-12,2,9,0,1,1,16,271,287,summer
2012-04-12,2,10,0,1,1,38,103,141,summer
2012-04-12,2,11,0,1,1,50,174,224,summer
2012-04-12,2,12,0,1,1,60,199,259,summer
2012-04-12,2,13,0,1,1,55,148,203,summer
2012-04-12,2,14,0,1,1,74,150,224,summer
2012-04-12,2,15,0,1,1,42,169,211,summer
2012-04-12,2,16,0,1,1,54,299,353,summer
2012-04-12,2,17,0,1,1,60,596,656,summer
2012-04-12,2,18,0,1,1,63,547,610,summer
2012-04-12,2,19,0,1,1,50,383,433,summer
2012-04-12,2,20,0,1,1,26,254,280,summer
2012-04-12,2,21,0,1,1,13,174,187,summer
2012-04-12,2,22,0,1,1,15,143,158,summer
2012-04-12,2,23,0,1,1,8,86,94,summer
2012-04-13,2,0,0,1,1,14,41,55,summer
2012-04-13,2,1,0,1,1,2,28,30,summer
2012-04-13,2,2,0,1,1,6,5,11,summer
2012-04-13,2,3,0,1,1,3,8,11,summer
2012-04-13,2,4,0,1,2,1,4,5,summer
2012-04-13,2,5,0,1,2,2,19,21,summer
2012-04-13,2,6,0,1,1,0,84,84,summer
2012-04-13,2,7,0,1,1,13,283,296,summer
2012-04-13,2,8,0,1,1,24,539,563,summer
2012-04-13,2,9,0,1,1,36,294,330,summer
2012-04-13,2,10,0,1,1,59,133,192,summer
2012-04-13,2,11,0,1,1,75,158,233,summer
2012-04-13,2,12,0,1,1,104,218,322,summer
2012-04-13,2,13,0,1,1,112,246,358,summer
2012-04-13,2,14,0,1,1,125,223,348,summer
2012-04-13,2,15,0,1,1,115,237,352,summer
2012-04-13,2,16,0,1,1,113,350,463,summer
2012-04-13,2,17,0,1,1,117,621,738,summer
2012-04-13,2,18,0,1,1,107,564,671,summer
2012-04-13,2,19,0,1,1,75,352,427,summer
2012-04-13,2,20,0,1,1,44,242,286,summer
2012-04-13,2,21,0,1,1,36,153,189,summer
2012-04-13,2,22,0,1,1,34,181,215,summer
2012-04-13,2,23,0,1,1,35,163,198,summer
2012-04-14,2,0,0,0,1,11,85,96,summer
2012-04-14,2,1,0,0,1,10,60,70,summer
2012-04-14,2,2,0,0,1,3,53,56,summer
2012-04-14,2,3,0,0,1,6,26,32,summer
2012-04-14,2,4,0,0,1,5,9,14,summer
2012-04-14,2,5,0,0,1,2,5,7,summer
2012-04-14,2,6,0,0,1,2,19,21,summer
2012-04-14,2,7,0,0,1,8,56,64,summer
2012-04-14,2,8,0,0,1,24,136,160,summer
2012-04-14,2,9,0,0,1,59,206,265,summer
2012-04-14,2,10,0,0,1,139,267,406,summer
2012-04-14,2,11,0,0,1,207,357,564,summer
2012-04-14,2,12,0,0,1,274,404,678,summer
2012-04-14,2,13,0,0,1,308,370,678,summer
2012-04-14,2,14,0,0,2,288,372,660,summer
2012-04-14,2,15,0,0,2,311,347,658,summer
2012-04-14,2,16,0,0,2,253,329,582,summer
2012-04-14,2,17,0,0,2,251,309,560,summer
2012-04-14,2,18,0,0,2,197,284,481,summer
2012-04-14,2,19,0,0,2,163,296,459,summer
2012-04-14,2,20,0,0,2,112,209,321,summer
2012-04-14,2,21,0,0,2,53,167,220,summer
2012-04-14,2,22,0,0,2,64,148,212,summer
2012-04-14,2,23,0,0,2,45,151,196,summer
2012-04-15,2,0,0,0,2,30,94,124,summer
2012-04-15,2,1,0,0,2,17,89,106,summer
2012-04-15,2,2,0,0,2,20,54,74,summer
2012-04-15,2,3,0,0,2,18,27,45,summer
2012-04-15,2,4,0,0,2,2,10,12,summer
2012-04-15,2,5,0,0,1,4,6,10,summer
2012-04-15,2,6,0,0,1,5,11,16,summer
2012-04-15,2,7,0,0,1,16,30,46,summer
2012-04-15,2,8,0,0,1,33,64,97,summer
2012-04-15,2,9,0,0,1,97,154,251,summer
2012-04-15,2,10,0,0,1,186,235,421,summer
2012-04-15,2,11,0,0,1,227,301,528,summer
2012-04-15,2,12,0,0,1,275,360,635,summer
2012-04-15,2,13,0,0,1,298,383,681,summer
2012-04-15,2,14,0,0,1,282,346,628,summer
2012-04-15,2,15,0,0,1,266,351,617,summer
2012-04-15,2,16,0,0,1,286,330,616,summer
2012-04-15,2,17,0,0,1,262,361,623,summer
2012-04-15,2,18,0,0,1,184,295,479,summer
2012-04-15,2,19,0,0,1,114,265,379,summer
2012-04-15,2,20,0,0,1,86,205,291,summer
2012-04-15,2,21,0,0,1,76,153,229,summer
2012-04-15,2,22,0,0,1,37,97,134,summer
2012-04-15,2,23,0,0,1,25,65,90,summer
2012-04-16,2,0,1,0,1,15,26,41,summer
2012-04-16,2,1,1,0,1,7,21,28,summer
2012-04-16,2,2,1,0,1,5,9,14,summer
2012-04-16,2,3,1,0,1,3,5,8,summer
2012-04-16,2,4,1,0,1,0,6,6,summer
2012-04-16,2,5,1,0,1,4,34,38,summer
2012-04-16,2,6,1,0,1,10,123,133,summer
2012-04-16,2,7,1,0,1,20,367,387,summer
2012-04-16,2,8,1,0,2,48,549,597,summer
2012-04-16,2,9,1,0,1,59,238,297,summer
2012-04-16,2,10,1,0,1,75,149,224,summer
2012-04-16,2,11,1,0,1,115,136,251,summer
2012-04-16,2,12,1,0,1,75,196,271,summer
2012-04-16,2,13,1,0,1,79,184,263,summer
2012-04-16,2,14,1,0,1,105,183,288,summer
2012-04-16,2,15,1,0,1,81,194,275,summer
2012-04-16,2,16,1,0,1,92,266,358,summer
2012-04-16,2,17,1,0,1,111,601,712,summer
2012-04-16,2,18,1,0,1,87,589,676,summer
2012-04-16,2,19,1,0,1,61,461,522,summer
2012-04-16,2,20,1,0,1,48,327,375,summer
2012-04-16,2,21,1,0,1,39,232,271,summer
2012-04-16,2,22,1,0,1,35,179,214,summer
2012-04-16,2,23,1,0,1,24,97,121,summer
2012-04-17,2,0,0,1,1,10,33,43,summer
2012-04-17,2,1,0,1,1,6,5,11,summer
2012-04-17,2,2,0,1,1,1,3,4,summer
2012-04-17,2,3,0,1,1,0,6,6,summer
2012-04-17,2,4,0,1,1,3,6,9,summer
2012-04-17,2,5,0,1,1,1,29,30,summer
2012-04-17,2,6,0,1,1,8,136,144,summer
2012-04-17,2,7,0,1,1,18,443,461,summer
2012-04-17,2,8,0,1,1,42,631,673,summer
2012-04-17,2,9,0,1,1,71,329,400,summer
2012-04-17,2,10,0,1,1,52,165,217,summer
2012-04-17,2,11,0,1,1,65,174,239,summer
2012-04-17,2,12,0,1,1,65,179,244,summer
2012-04-17,2,13,0,1,1,52,187,239,summer
2012-04-17,2,14,0,1,1,59,198,257,summer
2012-04-17,2,15,0,1,1,91,217,308,summer
2012-04-17,2,16,0,1,1,50,320,370,summer
2012-04-17,2,17,0,1,1,108,673,781,summer
2012-04-17,2,18,0,1,1,105,670,775,summer
2012-04-17,2,19,0,1,1,73,464,537,summer
2012-04-17,2,20,0,1,1,44,358,402,summer
2012-04-17,2,21,0,1,1,37,260,297,summer
2012-04-17,2,22,0,1,1,18,144,162,summer
2012-04-17,2,23,0,1,1,10,72,82,summer
2012-04-18,2,0,0,1,1,3,35,38,summer
2012-04-18,2,1,0,1,1,1,13,14,summer
2012-04-18,2,2,0,1,2,1,8,9,summer
2012-04-18,2,3,0,1,2,0,6,6,summer
2012-04-18,2,4,0,1,2,0,7,7,summer
2012-04-18,2,5,0,1,2,0,34,34,summer
2012-04-18,2,6,0,1,2,6,128,134,summer
2012-04-18,2,7,0,1,2,10,408,418,summer
2012-04-18,2,8,0,1,3,25,551,576,summer
2012-04-18,2,9,0,1,3,20,245,265,summer
2012-04-18,2,10,0,1,3,31,116,147,summer
2012-04-18,2,11,0,1,3,14,105,119,summer
2012-04-18,2,12,0,1,3,15,95,110,summer
2012-04-18,2,13,0,1,3,13,51,64,summer
2012-04-18,2,14,0,1,3,8,43,51,summer
2012-04-18,2,15,0,1,3,10,88,98,summer
2012-04-18,2,16,0,1,2,36,199,235,summer
2012-04-18,2,17,0,1,2,46,442,488,summer
2012-04-18,2,18,0,1,2,27,478,505,summer
2012-04-18,2,19,0,1,2,26,342,368,summer
2012-04-18,2,20,0,1,2,8,252,260,summer
2012-04-18,2,21,0,1,2,24,165,189,summer
2012-04-18,2,22,0,1,2,9,153,162,summer
2012-04-18,2,23,0,1,2,14,56,70,summer
2012-04-19,2,0,0,1,3,5,20,25,summer
2012-04-19,2,1,0,1,3,2,11,13,summer
2012-04-19,2,2,0,1,2,2,4,6,summer
2012-04-19,2,3,0,1,2,1,3,4,summer
2012-04-19,2,4,0,1,2,0,4,4,summer
2012-04-19,2,5,0,1,1,0,30,30,summer
2012-04-19,2,6,0,1,2,4,116,120,summer
2012-04-19,2,7,0,1,2,15,391,406,summer
2012-04-19,2,8,0,1,2,26,651,677,summer
2012-04-19,2,9,0,1,2,31,270,301,summer
2012-04-19,2,10,0,1,1,46,143,189,summer
2012-04-19,2,11,0,1,1,46,183,229,summer
2012-04-19,2,12,0,1,1,51,213,264,summer
2012-04-19,2,13,0,1,1,52,186,238,summer
2012-04-19,2,14,0,1,1,54,183,237,summer
2012-04-19,2,15,0,1,1,66,196,262,summer
2012-04-19,2,16,0,1,1,63,324,387,summer
2012-04-19,2,17,0,1,1,85,663,748,summer
2012-04-19,2,18,0,1,1,99,677,776,summer
2012-04-19,2,19,0,1,1,70,516,586,summer
2012-04-19,2,20,0,1,1,52,352,404,summer
2012-04-19,2,21,0,1,1,27,240,267,summer
2012-04-19,2,22,0,1,1,29,219,248,summer
2012-04-19,2,23,0,1,1,20,124,144,summer
2012-04-20,2,0,0,1,1,5,59,64,summer
2012-04-20,2,1,0,1,1,3,22,25,summer
2012-04-20,2,2,0,1,1,3,18,21,summer
2012-04-20,2,3,0,1,1,1,9,10,summer
2012-04-20,2,4,0,1,1,0,3,3,summer
2012-04-20,2,5,0,1,1,1,24,25,summer
2012-04-20,2,6,0,1,1,8,105,113,summer
2012-04-20,2,7,0,1,1,9,350,359,summer
2012-04-20,2,8,0,1,1,32,668,700,summer
2012-04-20,2,9,0,1,1,30,329,359,summer
2012-04-20,2,10,0,1,1,67,170,237,summer
2012-04-20,2,11,0,1,1,64,190,254,summer
2012-04-20,2,12,0,1,1,102,260,362,summer
2012-04-20,2,13,0,1,1,105,276,381,summer
2012-04-20,2,14,0,1,1,156,238,394,summer
2012-04-20,2,15,0,1,1,145,262,407,summer
2012-04-20,2,16,0,1,1,151,429,580,summer
2012-04-20,2,17,0,1,1,122,697,819,summer
2012-04-20,2,18,0,1,1,110,558,668,summer
2012-04-20,2,19,0,1,1,82,410,492,summer
2012-04-20,2,20,0,1,1,52,289,341,summer
2012-04-20,2,21,0,1,1,35,252,287,summer
2012-04-20,2,22,0,1,1,26,176,202,summer
2012-04-20,2,23,0,1,1,31,156,187,summer
2012-04-21,2,0,0,0,1,31,111,142,summer
2012-04-21,2,1,0,0,1,24,64,88,summer
2012-04-21,2,2,0,0,1,12,69,81,summer
2012-04-21,2,3,0,0,1,4,25,29,summer
2012-04-21,2,4,0,0,1,0,9,9,summer
2012-04-21,2,5,0,0,1,0,1,1,summer
2012-04-21,2,6,0,0,1,10,21,31,summer
2012-04-21,2,7,0,0,1,21,55,76,summer
2012-04-21,2,8,0,0,1,52,149,201,summer
2012-04-21,2,9,0,0,1,115,216,331,summer
2012-04-21,2,10,0,0,1,183,299,482,summer
2012-04-21,2,11,0,0,1,260,348,608,summer
2012-04-21,2,12,0,0,1,262,378,640,summer
2012-04-21,2,13,0,0,1,291,358,649,summer
2012-04-21,2,14,0,0,1,278,331,609,summer
2012-04-21,2,15,0,0,1,267,361,628,summer
2012-04-21,2,16,0,0,1,267,372,639,summer
2012-04-21,2,17,0,0,2,259,309,568,summer
2012-04-21,2,18,0,0,2,133,283,416,summer
2012-04-21,2,19,0,0,3,9,45,54,summer
2012-04-21,2,20,0,0,3,5,34,39,summer
2012-04-21,2,21,0,0,3,20,82,102,summer
2012-04-21,2,22,0,0,1,20,90,110,summer
2012-04-21,2,23,0,0,2,18,73,91,summer
2012-04-22,2,0,0,0,2,32,85,117,summer
2012-04-22,2,1,0,0,2,10,63,73,summer
2012-04-22,2,2,0,0,1,7,49,56,summer
2012-04-22,2,3,0,0,2,7,33,40,summer
2012-04-22,2,4,0,0,2,0,7,7,summer
2012-04-22,2,5,0,0,2,0,6,6,summer
2012-04-22,2,6,0,0,2,6,6,12,summer
2012-04-22,2,7,0,0,3,2,22,24,summer
2012-04-22,2,8,0,0,3,8,43,51,summer
2012-04-22,2,9,0,0,3,8,71,79,summer
2012-04-22,2,10,0,0,3,11,57,68,summer
2012-04-22,2,11,0,0,3,7,70,77,summer
2012-04-22,2,12,0,0,3,5,56,61,summer
2012-04-22,2,13,0,0,3,5,47,52,summer
2012-04-22,2,14,0,0,3,3,50,53,summer
2012-04-22,2,15,0,0,3,0,38,38,summer
2012-04-22,2,16,0,0,3,4,32,36,summer
2012-04-22,2,17,0,0,3,2,25,27,summer
2012-04-22,2,18,0,0,3,1,38,39,summer
2012-04-22,2,19,0,0,3,1,34,35,summer
2012-04-22,2,20,0,0,3,1,34,35,summer
2012-04-22,2,21,0,0,3,0,11,11,summer
2012-04-22,2,22,0,0,3,0,13,13,summer
2012-04-22,2,23,0,0,3,0,17,17,summer
2012-04-23,2,0,0,1,3,0,6,6,summer
2012-04-23,2,1,0,1,3,1,1,2,summer
2012-04-23,2,2,0,1,2,1,3,4,summer
2012-04-23,2,3,0,1,2,0,1,1,summer
2012-04-23,2,4,0,1,3,0,3,3,summer
2012-04-23,2,5,0,1,3,0,14,14,summer
2012-04-23,2,6,0,1,2,2,43,45,summer
2012-04-23,2,7,0,1,3,1,206,207,summer
2012-04-23,2,8,0,1,2,11,471,482,summer
2012-04-23,2,9,0,1,2,17,255,272,summer
2012-04-23,2,10,0,1,2,12,88,100,summer
2012-04-23,2,11,0,1,2,10,91,101,summer
2012-04-23,2,12,0,1,3,12,117,129,summer
2012-04-23,2,13,0,1,3,9,98,107,summer
2012-04-23,2,14,0,1,3,12,102,114,summer
2012-04-23,2,15,0,1,2,11,101,112,summer
2012-04-23,2,16,0,1,3,10,93,103,summer
2012-04-23,2,17,0,1,3,13,219,232,summer
2012-04-23,2,18,0,1,3,10,369,379,summer
2012-04-23,2,19,0,1,2,11,287,298,summer
2012-04-23,2,20,0,1,2,17,186,203,summer
2012-04-23,2,21,0,1,2,7,145,152,summer
2012-04-23,2,22,0,1,1,18,71,89,summer
2012-04-23,2,23,0,1,1,10,49,59,summer
2012-04-24,2,0,0,1,2,0,13,13,summer
2012-04-24,2,1,0,1,2,1,6,7,summer
2012-04-24,2,2,0,1,1,0,3,3,summer
2012-04-24,2,3,0,1,1,0,2,2,summer
2012-04-24,2,4,0,1,1,0,3,3,summer
2012-04-24,2,5,0,1,1,0,22,22,summer
2012-04-24,2,6,0,1,1,3,117,120,summer
2012-04-24,2,7,0,1,1,3,387,390,summer
2012-04-24,2,8,0,1,1,12,599,611,summer
2012-04-24,2,9,0,1,1,6,302,308,summer
2012-04-24,2,10,0,1,1,33,129,162,summer
2012-04-24,2,11,0,1,1,27,157,184,summer
2012-04-24,2,12,0,1,1,36,188,224,summer
2012-04-24,2,13,0,1,1,35,189,224,summer
2012-04-24,2,14,0,1,1,50,166,216,summer
2012-04-24,2,15,0,1,1,60,176,236,summer
2012-04-24,2,16,0,1,1,54,308,362,summer
2012-04-24,2,17,0,1,1,72,619,691,summer
2012-04-24,2,18,0,1,1,52,580,632,summer
2012-04-24,2,19,0,1,1,33,449,482,summer
2012-04-24,2,20,0,1,1,16,269,285,summer
2012-04-24,2,21,0,1,2,13,213,226,summer
2012-04-24,2,22,0,1,1,8,149,157,summer
2012-04-24,2,23,0,1,1,4,69,73,summer
2012-04-25,2,0,0,1,1,13,23,36,summer
2012-04-25,2,1,0,1,1,8,17,25,summer
2012-04-25,2,2,0,1,1,1,6,7,summer
2012-04-25,2,3,0,1,1,0,3,3,summer
2012-04-25,2,4,0,1,1,0,6,6,summer
2012-04-25,2,5,0,1,1,0,24,24,summer
2012-04-25,2,6,0,1,1,3,103,106,summer
2012-04-25,2,7,0,1,1,13,376,389,summer
2012-04-25,2,8,0,1,1,20,634,654,summer
2012-04-25,2,9,0,1,1,33,288,321,summer
2012-04-25,2,10,0,1,1,44,138,182,summer
2012-04-25,2,11,0,1,1,42,177,219,summer
2012-04-25,2,12,0,1,1,49,220,269,summer
2012-04-25,2,13,0,1,1,35,193,228,summer
2012-04-25,2,14,0,1,1,47,176,223,summer
2012-04-25,2,15,0,1,1,47,182,229,summer
2012-04-25,2,16,0,1,1,49,327,376,summer
2012-04-25,2,17,0,1,1,68,664,732,summer
2012-04-25,2,18,0,1,1,60,649,709,summer
2012-04-25,2,19,0,1,1,42,501,543,summer
2012-04-25,2,20,0,1,1,22,358,380,summer
2012-04-25,2,21,0,1,1,27,212,239,summer
2012-04-25,2,22,0,1,1,22,170,192,summer
2012-04-25,2,23,0,1,2,10,94,104,summer
2012-04-26,2,0,0,1,2,1,42,43,summer
2012-04-26,2,1,0,1,2,1,22,23,summer
2012-04-26,2,2,0,1,2,3,10,13,summer
2012-04-26,2,3,0,1,2,1,5,6,summer
2012-04-26,2,4,0,1,2,1,2,3,summer
2012-04-26,2,5,0,1,2,0,17,17,summer
2012-04-26,2,6,0,1,2,5,122,127,summer
2012-04-26,2,7,0,1,3,3,222,225,summer
2012-04-26,2,8,0,1,3,4,358,362,summer
2012-04-26,2,9,0,1,3,12,189,201,summer
2012-04-26,2,10,0,1,2,14,125,139,summer
2012-04-26,2,11,0,1,2,16,135,151,summer
2012-04-26,2,12,0,1,2,24,180,204,summer
2012-04-26,2,13,0,1,2,19,178,197,summer
2012-04-26,2,14,0,1,2,37,132,169,summer
2012-04-26,2,15,0,1,2,39,165,204,summer
2012-04-26,2,16,0,1,2,37,281,318,summer
2012-04-26,2,17,0,1,1,49,565,614,summer
2012-04-26,2,18,0,1,2,75,589,664,summer
2012-04-26,2,19,0,1,2,57,407,464,summer
2012-04-26,2,20,0,1,1,23,314,337,summer
2012-04-26,2,21,0,1,1,28,222,250,summer
2012-04-26,2,22,0,1,1,20,163,183,summer
2012-04-26,2,23,0,1,1,6,106,112,summer
2012-04-27,2,0,0,1,1,12,61,73,summer
2012-04-27,2,1,0,1,1,3,32,35,summer
2012-04-27,2,2,0,1,1,4,18,22,summer
2012-04-27,2,3,0,1,1,1,2,3,summer
2012-04-27,2,4,0,1,1,0,6,6,summer
2012-04-27,2,5,0,1,1,0,19,19,summer
2012-04-27,2,6,0,1,1,5,115,120,summer
2012-04-27,2,7,0,1,1,10,305,315,summer
2012-04-27,2,8,0,1,1,17,575,592,summer
2012-04-27,2,9,0,1,1,42,292,334,summer
2012-04-27,2,10,0,1,1,64,172,236,summer
2012-04-27,2,11,0,1,1,47,186,233,summer
2012-04-27,2,12,0,1,1,63,244,307,summer
2012-04-27,2,13,0,1,1,94,212,306,summer
2012-04-27,2,14,0,1,1,94,206,300,summer
2012-04-27,2,15,0,1,1,101,223,324,summer
2012-04-27,2,16,0,1,1,105,335,440,summer
2012-04-27,2,17,0,1,1,89,613,702,summer
2012-04-27,2,18,0,1,1,94,560,654,summer
2012-04-27,2,19,0,1,1,62,379,441,summer
2012-04-27,2,20,0,1,1,49,240,289,summer
2012-04-27,2,21,0,1,1,23,185,208,summer
2012-04-27,2,22,0,1,1,24,134,158,summer
2012-04-27,2,23,0,1,1,11,105,116,summer
2012-04-28,2,0,0,0,1,4,99,103,summer
2012-04-28,2,1,0,0,1,7,60,67,summer
2012-04-28,2,2,0,0,1,8,49,57,summer
2012-04-28,2,3,0,0,1,3,23,26,summer
2012-04-28,2,4,0,0,1,0,2,2,summer
2012-04-28,2,5,0,0,1,2,3,5,summer
2012-04-28,2,6,0,0,1,10,18,28,summer
2012-04-28,2,7,0,0,1,10,45,55,summer
2012-04-28,2,8,0,0,1,24,134,158,summer
2012-04-28,2,9,0,0,2,45,169,214,summer
2012-04-28,2,10,0,0,2,60,231,291,summer
2012-04-28,2,11,0,0,2,96,262,358,summer
2012-04-28,2,12,0,0,2,105,276,381,summer
2012-04-28,2,13,0,0,2,120,269,389,summer
2012-04-28,2,14,0,0,1,147,293,440,summer
2012-04-28,2,15,0,0,1,148,260,408,summer
2012-04-28,2,16,0,0,2,132,244,376,summer
2012-04-28,2,17,0,0,2,98,224,322,summer
2012-04-28,2,18,0,0,3,17,73,90,summer
2012-04-28,2,19,0,0,3,29,110,139,summer
2012-04-28,2,20,0,0,2,21,81,102,summer
2012-04-28,2,21,0,0,3,12,72,84,summer
2012-04-28,2,22,0,0,2,17,66,83,summer
2012-04-28,2,23,0,0,2,5,37,42,summer
2012-04-29,2,0,0,0,3,0,36,36,summer
2012-04-29,2,1,0,0,2,5,37,42,summer
2012-04-29,2,2,0,0,2,4,36,40,summer
2012-04-29,2,3,0,0,2,2,14,16,summer
2012-04-29,2,4,0,0,2,0,4,4,summer
2012-04-29,2,5,0,0,1,0,6,6,summer
2012-04-29,2,6,0,0,1,1,6,7,summer
2012-04-29,2,7,0,0,2,7,20,27,summer
2012-04-29,2,8,0,0,1,26,81,107,summer
2012-04-29,2,9,0,0,1,52,133,185,summer
2012-04-29,2,10,0,0,1,127,253,380,summer
2012-04-29,2,11,0,0,1,128,283,411,summer
2012-04-29,2,12,0,0,1,223,361,584,summer
2012-04-29,2,13,0,0,1,226,369,595,summer
2012-04-29,2,14,0,0,1,281,372,653,summer
2012-04-29,2,15,0,0,1,279,324,603,summer
2012-04-29,2,16,0,0,1,240,347,587,summer
2012-04-29,2,17,0,0,1,188,334,522,summer
2012-04-29,2,18,0,0,1,164,323,487,summer
2012-04-29,2,19,0,0,1,128,247,375,summer
2012-04-29,2,20,0,0,1,45,198,243,summer
2012-04-29,2,21,0,0,1,65,139,204,summer
2012-04-29,2,22,0,0,1,23,85,108,summer
2012-04-29,2,23,0,0,1,15,67,82,summer
2012-04-30,2,0,0,1,1,12,36,48,summer
2012-04-30,2,1,0,1,1,9,15,24,summer
2012-04-30,2,2,0,1,1,3,5,8,summer
2012-04-30,2,3,0,1,1,0,4,4,summer
2012-04-30,2,4,0,1,1,0,2,2,summer
2012-04-30,2,5,0,1,1,1,19,20,summer
2012-04-30,2,6,0,1,1,2,121,123,summer
2012-04-30,2,7,0,1,1,6,343,349,summer
2012-04-30,2,8,0,1,1,17,579,596,summer
2012-04-30,2,9,0,1,2,29,239,268,summer
2012-04-30,2,10,0,1,2,41,116,157,summer
2012-04-30,2,11,0,1,2,52,111,163,summer
2012-04-30,2,12,0,1,2,45,180,225,summer
2012-04-30,2,13,0,1,2,48,199,247,summer
2012-04-30,2,14,0,1,2,56,162,218,summer
2012-04-30,2,15,0,1,2,55,176,231,summer
2012-04-30,2,16,0,1,1,44,303,347,summer
2012-04-30,2,17,0,1,1,66,617,683,summer
2012-04-30,2,18,0,1,2,53,611,664,summer
2012-04-30,2,19,0,1,2,51,420,471,summer
2012-04-30,2,20,0,1,2,28,281,309,summer
2012-04-30,2,21,0,1,2,26,195,221,summer
2012-04-30,2,22,0,1,2,11,123,134,summer
2012-04-30,2,23,0,1,2,10,50,60,summer
2012-05-01,2,0,0,1,2,7,28,35,summer
2012-05-01,2,1,0,1,2,0,21,21,summer
2012-05-01,2,2,0,1,2,1,7,8,summer
2012-05-01,2,3,0,1,2,1,2,3,summer
2012-05-01,2,4,0,1,2,1,7,8,summer
2012-05-01,2,5,0,1,2,0,17,17,summer
2012-05-01,2,6,0,1,3,2,24,26,summer
2012-05-01,2,7,0,1,2,8,161,169,summer
2012-05-01,2,8,0,1,2,19,538,557,summer
2012-05-01,2,9,0,1,2,18,331,349,summer
2012-05-01,2,10,0,1,1,30,144,174,summer
2012-05-01,2,11,0,1,2,50,179,229,summer
2012-05-01,2,12,0,1,2,41,228,269,summer
2012-05-01,2,13,0,1,2,41,208,249,summer
2012-05-01,2,14,0,1,2,37,167,204,summer
2012-05-01,2,15,0,1,2,48,186,234,summer
2012-05-01,2,16,0,1,1,41,313,354,summer
2012-05-01,2,17,0,1,1,65,616,681,summer
2012-05-01,2,18,0,1,1,81,662,743,summer
2012-05-01,2,19,0,1,1,58,429,487,summer
2012-05-01,2,20,0,1,1,36,299,335,summer
2012-05-01,2,21,0,1,1,31,251,282,summer
2012-05-01,2,22,0,1,1,21,190,211,summer
2012-05-01,2,23,0,1,1,16,79,95,summer
2012-05-02,2,0,0,1,1,4,43,47,summer
2012-05-02,2,1,0,1,1,8,7,15,summer
2012-05-02,2,2,0,1,1,7,9,16,summer
2012-05-02,2,3,0,1,1,0,6,6,summer
2012-05-02,2,4,0,1,1,2,2,4,summer
2012-05-02,2,5,0,1,1,2,31,33,summer
2012-05-02,2,6,0,1,3,3,117,120,summer
2012-05-02,2,7,0,1,2,14,344,358,summer
2012-05-02,2,8,0,1,2,26,640,666,summer
2012-05-02,2,9,0,1,2,26,289,315,summer
2012-05-02,2,10,0,1,2,28,147,175,summer
2012-05-02,2,11,0,1,2,39,145,184,summer
2012-05-02,2,12,0,1,2,35,210,245,summer
2012-05-02,2,13,0,1,2,49,179,228,summer
2012-05-02,2,14,0,1,1,51,189,240,summer
2012-05-02,2,15,0,1,1,52,204,256,summer
2012-05-02,2,16,0,1,1,54,313,367,summer
2012-05-02,2,17,0,1,1,70,659,729,summer
2012-05-02,2,18,0,1,1,43,770,813,summer
2012-05-02,2,19,0,1,1,43,461,504,summer
2012-05-02,2,20,0,1,1,42,296,338,summer
2012-05-02,2,21,0,1,1,21,218,239,summer
2012-05-02,2,22,0,1,1,27,146,173,summer
2012-05-02,2,23,0,1,2,21,77,98,summer
2012-05-03,2,0,0,1,2,15,75,90,summer
2012-05-03,2,1,0,1,2,9,15,24,summer
2012-05-03,2,2,0,1,2,4,13,17,summer
2012-05-03,2,3,0,1,2,2,4,6,summer
2012-05-03,2,4,0,1,2,0,2,2,summer
2012-05-03,2,5,0,1,2,1,20,21,summer
2012-05-03,2,6,0,1,2,8,128,136,summer
2012-05-03,2,7,0,1,3,8,376,384,summer
2012-05-03,2,8,0,1,3,19,608,627,summer
2012-05-03,2,9,0,1,2,25,279,304,summer
2012-05-03,2,10,0,1,2,36,132,168,summer
2012-05-03,2,11,0,1,1,34,167,201,summer
2012-05-03,2,12,0,1,1,64,237,301,summer
2012-05-03,2,13,0,1,1,48,217,265,summer
2012-05-03,2,14,0,1,1,33,171,204,summer
2012-05-03,2,15,0,1,1,63,220,283,summer
2012-05-03,2,16,0,1,1,45,325,370,summer
2012-05-03,2,17,0,1,1,87,617,704,summer
2012-05-03,2,18,0,1,1,64,642,706,summer
2012-05-03,2,19,0,1,1,55,467,522,summer
2012-05-03,2,20,0,1,1,52,368,420,summer
2012-05-03,2,21,0,1,1,42,257,299,summer
2012-05-03,2,22,0,1,1,29,217,246,summer
2012-05-03,2,23,0,1,1,21,100,121,summer
2012-05-04,2,0,0,1,1,19,70,89,summer
2012-05-04,2,1,0,1,1,15,33,48,summer
2012-05-04,2,2,0,1,1,0,11,11,summer
2012-05-04,2,3,0,1,1,0,14,14,summer
2012-05-04,2,4,0,1,1,0,4,4,summer
2012-05-04,2,5,0,1,1,0,24,24,summer
2012-05-04,2,6,0,1,1,8,127,135,summer
2012-05-04,2,7,0,1,1,9,347,356,summer
2012-05-04,2,8,0,1,1,34,584,618,summer
2012-05-04,2,9,0,1,1,32,262,294,summer
2012-05-04,2,10,0,1,2,45,154,199,summer
2012-05-04,2,11,0,1,2,77,181,258,summer
2012-05-04,2,12,0,1,3,46,125,171,summer
2012-05-04,2,13,0,1,2,71,207,278,summer
2012-05-04,2,14,0,1,2,83,159,242,summer
2012-05-04,2,15,0,1,2,103,240,343,summer
2012-05-04,2,16,0,1,1,82,358,440,summer
2012-05-04,2,17,0,1,1,96,547,643,summer
2012-05-04,2,18,0,1,1,77,564,641,summer
2012-05-04,2,19,0,1,1,64,388,452,summer
2012-05-04,2,20,0,1,1,58,255,313,summer
2012-05-04,2,21,0,1,1,49,186,235,summer
2012-05-04,2,22,0,1,1,50,182,232,summer
2012-05-04,2,23,0,1,1,51,205,256,summer
2012-05-05,2,0,0,0,1,42,111,153,summer
2012-05-05,2,1,0,0,1,28,79,107,summer
2012-05-05,2,2,0,0,1,24,51,75,summer
2012-05-05,2,3,0,0,1,11,21,32,summer
2012-05-05,2,4,0,0,1,0,9,9,summer
2012-05-05,2,5,0,0,1,8,14,22,summer
2012-05-05,2,6,0,0,2,9,33,42,summer
2012-05-05,2,7,0,0,1,8,79,87,summer
2012-05-05,2,8,0,0,1,42,155,197,summer
2012-05-05,2,9,0,0,1,61,223,284,summer
2012-05-05,2,10,0,0,1,148,284,432,summer
2012-05-05,2,11,0,0,1,221,354,575,summer
2012-05-05,2,12,0,0,1,220,330,550,summer
2012-05-05,2,13,0,0,1,217,307,524,summer
2012-05-05,2,14,0,0,3,187,241,428,summer
2012-05-05,2,15,0,0,3,241,300,541,summer
2012-05-05,2,16,0,0,2,230,310,540,summer
2012-05-05,2,17,0,0,2,204,298,502,summer
2012-05-05,2,18,0,0,2,156,278,434,summer
2012-05-05,2,19,0,0,2,151,254,405,summer
2012-05-05,2,20,0,0,1,100,209,309,summer
2012-05-05,2,21,0,0,2,86,183,269,summer
2012-05-05,2,22,0,0,2,67,150,217,summer
2012-05-05,2,23,0,0,2,35,114,149,summer
2012-05-06,2,0,0,0,2,23,111,134,summer
2012-05-06,2,1,0,0,2,37,84,121,summer
2012-05-06,2,2,0,0,2,29,64,93,summer
2012-05-06,2,3,0,0,2,9,19,28,summer
2012-05-06,2,4,0,0,3,9,7,16,summer
2012-05-06,2,5,0,0,3,1,10,11,summer
2012-05-06,2,6,0,0,3,3,14,17,summer
2012-05-06,2,7,0,0,3,5,31,36,summer
2012-05-06,2,8,0,0,2,23,91,114,summer
2012-05-06,2,9,0,0,2,63,128,191,summer
2012-05-06,2,10,0,0,2,112,221,333,summer
2012-05-06,2,11,0,0,1,144,270,414,summer
2012-05-06,2,12,0,0,2,207,351,558,summer
2012-05-06,2,13,0,0,2,197,368,565,summer
2012-05-06,2,14,0,0,2,226,292,518,summer
2012-05-06,2,15,0,0,2,229,342,571,summer
2012-05-06,2,16,0,0,2,181,363,544,summer
2012-05-06,2,17,0,0,2,195,316,511,summer
2012-05-06,2,18,0,0,2,131,332,463,summer
2012-05-06,2,19,0,0,2,117,266,383,summer
2012-05-06,2,20,0,0,1,73,203,276,summer
2012-05-06,2,21,0,0,1,55,148,203,summer
2012-05-06,2,22,0,0,1,44,113,157,summer
2012-05-06,2,23,0,0,1,22,80,102,summer
2012-05-07,2,0,0,1,2,13,21,34,summer
2012-05-07,2,1,0,1,2,1,8,9,summer
2012-05-07,2,2,0,1,1,1,5,6,summer
2012-05-07,2,3,0,1,1,2,3,5,summer
2012-05-07,2,4,0,1,2,0,2,2,summer
2012-05-07,2,5,0,1,1,2,21,23,summer
2012-05-07,2,6,0,1,1,8,134,142,summer
2012-05-07,2,7,0,1,2,18,367,385,summer
2012-05-07,2,8,0,1,2,31,608,639,summer
2012-05-07,2,9,0,1,2,61,289,350,summer
2012-05-07,2,10,0,1,2,62,128,190,summer
2012-05-07,2,11,0,1,2,64,149,213,summer
2012-05-07,2,12,0,1,2,74,189,263,summer
2012-05-07,2,13,0,1,2,75,197,272,summer
2012-05-07,2,14,0,1,2,59,180,239,summer
2012-05-07,2,15,0,1,2,76,186,262,summer
2012-05-07,2,16,0,1,2,68,320,388,summer
2012-05-07,2,17,0,1,2,102,667,769,summer
2012-05-07,2,18,0,1,2,78,602,680,summer
2012-05-07,2,19,0,1,1,83,463,546,summer
2012-05-07,2,20,0,1,1,46,277,323,summer
2012-05-07,2,21,0,1,2,37,210,247,summer
2012-05-07,2,22,0,1,2,26,147,173,summer
2012-05-07,2,23,0,1,2,21,92,113,summer
2012-05-08,2,0,0,1,2,10,28,38,summer
2012-05-08,2,1,0,1,2,6,3,9,summer
2012-05-08,2,2,0,1,2,9,7,16,summer
2012-05-08,2,3,0,1,2,2,4,6,summer
2012-05-08,2,4,0,1,2,0,5,5,summer
2012-05-08,2,5,0,1,2,0,20,20,summer
2012-05-08,2,6,0,1,1,7,158,165,summer
2012-05-08,2,7,0,1,1,21,442,463,summer
2012-05-08,2,8,0,1,2,36,605,641,summer
2012-05-08,2,9,0,1,2,37,258,295,summer
2012-05-08,2,10,0,1,2,46,111,157,summer
2012-05-08,2,11,0,1,2,60,157,217,summer
2012-05-08,2,12,0,1,2,60,203,263,summer
2012-05-08,2,13,0,1,3,53,166,219,summer
2012-05-08,2,14,0,1,3,8,63,71,summer
2012-05-08,2,15,0,1,3,40,94,134,summer
2012-05-08,2,16,0,1,3,54,335,389,summer
2012-05-08,2,17,0,1,2,77,640,717,summer
2012-05-08,2,18,0,1,2,69,641,710,summer
2012-05-08,2,19,0,1,2,59,399,458,summer
2012-05-08,2,20,0,1,2,40,262,302,summer
2012-05-08,2,21,0,1,2,21,202,223,summer
2012-05-08,2,22,0,1,3,13,134,147,summer
2012-05-08,2,23,0,1,3,10,53,63,summer
2012-05-09,2,0,0,1,2,8,27,35,summer
2012-05-09,2,1,0,1,2,3,11,14,summer
2012-05-09,2,2,0,1,3,0,1,1,summer
2012-05-09,2,3,0,1,3,0,2,2,summer
2012-05-09,2,4,0,1,3,0,5,5,summer
2012-05-09,2,5,0,1,2,1,27,28,summer
2012-05-09,2,6,0,1,2,5,121,126,summer
2012-05-09,2,7,0,1,2,17,401,418,summer
2012-05-09,2,8,0,1,2,28,594,622,summer
2012-05-09,2,9,0,1,2,40,285,325,summer
2012-05-09,2,10,0,1,2,40,113,153,summer
2012-05-09,2,11,0,1,2,45,156,201,summer
2012-05-09,2,12,0,1,2,58,222,280,summer
2012-05-09,2,13,0,1,2,50,216,266,summer
2012-05-09,2,14,0,1,2,68,175,243,summer
2012-05-09,2,15,0,1,2,68,191,259,summer
2012-05-09,2,16,0,1,2,68,289,357,summer
2012-05-09,2,17,0,1,2,76,629,705,summer
2012-05-09,2,18,0,1,3,23,349,372,summer
2012-05-09,2,19,0,1,3,2,96,98,summer
2012-05-09,2,20,0,1,3,3,48,51,summer
2012-05-09,2,21,0,1,3,4,30,34,summer
2012-05-09,2,22,0,1,3,5,62,67,summer
2012-05-09,2,23,0,1,3,8,47,55,summer
2012-05-10,2,0,0,1,3,2,31,33,summer
2012-05-10,2,1,0,1,2,2,9,11,summer
2012-05-10,2,2,0,1,2,0,3,3,summer
2012-05-10,2,3,0,1,1,0,3,3,summer
2012-05-10,2,4,0,1,1,0,2,2,summer
2012-05-10,2,5,0,1,1,1,23,24,summer
2012-05-10,2,6,0,1,1,9,130,139,summer
2012-05-10,2,7,0,1,1,8,393,401,summer
2012-05-10,2,8,0,1,1,27,603,630,summer
2012-05-10,2,9,0,1,1,62,299,361,summer
2012-05-10,2,10,0,1,1,42,112,154,summer
2012-05-10,2,11,0,1,1,77,179,256,summer
2012-05-10,2,12,0,1,1,65,207,272,summer
2012-05-10,2,13,0,1,1,90,228,318,summer
2012-05-10,2,14,0,1,1,61,186,247,summer
2012-05-10,2,15,0,1,1,79,192,271,summer
2012-05-10,2,16,0,1,1,87,334,421,summer
2012-05-10,2,17,0,1,1,84,648,732,summer
2012-05-10,2,18,0,1,1,109,661,770,summer
2012-05-10,2,19,0,1,1,84,469,553,summer
2012-05-10,2,20,0,1,1,59,315,374,summer
2012-05-10,2,21,0,1,1,19,211,230,summer
2012-05-10,2,22,0,1,1,36,196,232,summer
2012-05-10,2,23,0,1,1,23,112,135,summer
2012-05-11,2,0,0,1,1,17,47,64,summer
2012-05-11,2,1,0,1,1,14,32,46,summer
2012-05-11,2,2,0,1,1,15,16,31,summer
2012-05-11,2,3,0,1,1,5,8,13,summer
2012-05-11,2,4,0,1,1,3,6,9,summer
2012-05-11,2,5,0,1,1,3,23,26,summer
2012-05-11,2,6,0,1,1,7,128,135,summer
2012-05-11,2,7,0,1,1,6,345,351,summer
2012-05-11,2,8,0,1,1,41,579,620,summer
2012-05-11,2,9,0,1,1,34,288,322,summer
2012-05-11,2,10,0,1,1,69,141,210,summer
2012-05-11,2,11,0,1,1,88,203,291,summer
2012-05-11,2,12,0,1,1,89,259,348,summer
2012-05-11,2,13,0,1,1,100,263,363,summer
2012-05-11,2,14,0,1,1,116,218,334,summer
2012-05-11,2,15,0,1,1,140,299,439,summer
2012-05-11,2,16,0,1,1,128,397,525,summer
2012-05-11,2,17,0,1,1,102,677,779,summer
2012-05-11,2,18,0,1,1,78,518,596,summer
2012-05-11,2,19,0,1,1,73,430,503,summer
2012-05-11,2,20,0,1,1,64,277,341,summer
2012-05-11,2,21,0,1,1,45,225,270,summer
2012-05-11,2,22,0,1,1,44,190,234,summer
2012-05-11,2,23,0,1,1,38,142,180,summer
2012-05-12,2,0,0,0,1,25,111,136,summer
2012-05-12,2,1,0,0,1,14,79,93,summer
2012-05-12,2,2,0,0,1,10,46,56,summer
2012-05-12,2,3,0,0,1,14,20,34,summer
2012-05-12,2,4,0,0,1,3,6,9,summer
2012-05-12,2,5,0,0,1,5,8,13,summer
2012-05-12,2,6,0,0,1,10,23,33,summer
2012-05-12,2,7,0,0,1,10,57,67,summer
2012-05-12,2,8,0,0,1,22,156,178,summer
2012-05-12,2,9,0,0,1,87,248,335,summer
2012-05-12,2,10,0,0,1,132,279,411,summer
2012-05-12,2,11,0,0,1,157,365,522,summer
2012-05-12,2,12,0,0,1,206,353,559,summer
2012-05-12,2,13,0,0,1,293,366,659,summer
2012-05-12,2,14,0,0,1,257,358,615,summer
2012-05-12,2,15,0,0,1,269,321,590,summer
2012-05-12,2,16,0,0,2,254,337,591,summer
2012-05-12,2,17,0,0,2,233,343,576,summer
2012-05-12,2,18,0,0,2,164,382,546,summer
2012-05-12,2,19,0,0,2,166,273,439,summer
2012-05-12,2,20,0,0,1,113,174,287,summer
2012-05-12,2,21,0,0,2,74,156,230,summer
2012-05-12,2,22,0,0,1,62,212,274,summer
2012-05-12,2,23,0,0,1,42,134,176,summer
2012-05-13,2,0,0,0,1,19,79,98,summer
2012-05-13,2,1,0,0,2,22,72,94,summer
2012-05-13,2,2,0,0,2,22,60,82,summer
2012-05-13,2,3,0,0,2,2,26,28,summer
2012-05-13,2,4,0,0,2,2,7,9,summer
2012-05-13,2,5,0,0,1,4,8,12,summer
2012-05-13,2,6,0,0,1,6,15,21,summer
2012-05-13,2,7,0,0,1,18,42,60,summer
2012-05-13,2,8,0,0,1,32,124,156,summer
2012-05-13,2,9,0,0,1,79,143,222,summer
2012-05-13,2,10,0,0,1,128,222,350,summer
2012-05-13,2,11,0,0,1,150,278,428,summer
2012-05-13,2,12,0,0,1,189,342,531,summer
2012-05-13,2,13,0,0,1,255,347,602,summer
2012-05-13,2,14,0,0,1,228,324,552,summer
2012-05-13,2,15,0,0,1,190,309,499,summer
2012-05-13,2,16,0,0,1,225,339,564,summer
2012-05-13,2,17,0,0,1,191,287,478,summer
2012-05-13,2,18,0,0,2,129,260,389,summer
2012-05-13,2,19,0,0,2,107,232,339,summer
2012-05-13,2,20,0,0,2,67,163,230,summer
2012-05-13,2,21,0,0,2,48,121,169,summer
2012-05-13,2,22,0,0,2,42,89,131,summer
2012-05-13,2,23,0,0,2,17,57,74,summer
2012-05-14,2,0,0,1,2,21,14,35,summer
2012-05-14,2,1,0,1,2,5,6,11,summer
2012-05-14,2,2,0,1,1,1,1,2,summer
2012-05-14,2,3,0,1,2,0,2,2,summer
2012-05-14,2,4,0,1,2,3,3,6,summer
2012-05-14,2,5,0,1,2,1,25,26,summer
2012-05-14,2,6,0,1,3,3,62,65,summer
2012-05-14,2,7,0,1,3,3,72,75,summer
2012-05-14,2,8,0,1,3,1,155,156,summer
2012-05-14,2,9,0,1,3,5,105,110,summer
2012-05-14,2,10,0,1,3,6,53,59,summer
2012-05-14,2,11,0,1,2,12,67,79,summer
2012-05-14,2,12,0,1,2,53,132,185,summer
2012-05-14,2,13,0,1,2,33,143,176,summer
2012-05-14,2,14,0,1,2,43,128,171,summer
2012-05-14,2,15,0,1,2,40,156,196,summer
2012-05-14,2,16,0,1,3,20,91,111,summer
2012-05-14,2,17,0,1,3,25,204,229,summer
2012-05-14,2,18,0,1,2,17,283,300,summer
2012-05-14,2,19,0,1,3,10,294,304,summer
2012-05-14,2,20,0,1,2,11,178,189,summer
2012-05-14,2,21,0,1,2,7,145,152,summer
2012-05-14,2,22,0,1,2,11,118,129,summer
2012-05-14,2,23,0,1,2,11,64,75,summer
2012-05-15,2,0,0,1,2,7,25,32,summer
2012-05-15,2,1,0,1,3,5,14,19,summer
2012-05-15,2,2,0,1,2,1,3,4,summer
2012-05-15,2,3,0,1,3,1,5,6,summer
2012-05-15,2,4,0,1,3,1,4,5,summer
2012-05-15,2,5,0,1,3,0,8,8,summer
2012-05-15,2,6,0,1,3,2,22,24,summer
2012-05-15,2,7,0,1,3,1,91,92,summer
2012-05-15,2,8,0,1,2,8,401,409,summer
2012-05-15,2,9,0,1,2,28,327,355,summer
2012-05-15,2,10,0,1,1,27,144,171,summer
2012-05-15,2,11,0,1,1,38,186,224,summer
2012-05-15,2,12,0,1,1,44,220,264,summer
2012-05-15,2,13,0,1,3,35,204,239,summer
2012-05-15,2,14,0,1,2,39,145,184,summer
2012-05-15,2,15,0,1,2,51,205,256,summer
2012-05-15,2,16,0,1,1,74,300,374,summer
2012-05-15,2,17,0,1,1,75,603,678,summer
2012-05-15,2,18,0,1,1,68,665,733,summer
2012-05-15,2,19,0,1,1,57,455,512,summer
2012-05-15,2,20,0,1,3,30,233,263,summer
2012-05-15,2,21,0,1,3,11,98,109,summer
2012-05-15,2,22,0,1,1,9,74,83,summer
2012-05-15,2,23,0,1,3,13,58,71,summer
2012-05-16,2,0,0,1,2,12,27,39,summer
2012-05-16,2,1,0,1,2,7,14,21,summer
2012-05-16,2,2,0,1,1,5,14,19,summer
2012-05-16,2,3,0,1,1,1,5,6,summer
2012-05-16,2,4,0,1,1,1,3,4,summer
2012-05-16,2,5,0,1,1,4,34,38,summer
2012-05-16,2,6,0,1,1,8,150,158,summer
2012-05-16,2,7,0,1,1,14,426,440,summer
2012-05-16,2,8,0,1,1,33,617,650,summer
2012-05-16,2,9,0,1,2,33,314,347,summer
2012-05-16,2,10,0,1,1,43,149,192,summer
2012-05-16,2,11,0,1,1,55,212,267,summer
2012-05-16,2,12,0,1,1,59,271,330,summer
2012-05-16,2,13,0,1,1,77,273,350,summer
2012-05-16,2,14,0,1,1,42,221,263,summer
2012-05-16,2,15,0,1,2,52,222,274,summer
2012-05-16,2,16,0,1,1,70,376,446,summer
2012-05-16,2,17,0,1,1,104,769,873,summer
2012-05-16,2,18,0,1,1,97,749,846,summer
2012-05-16,2,19,0,1,1,91,499,590,summer
2012-05-16,2,20,0,1,1,61,398,459,summer
2012-05-16,2,21,0,1,1,63,330,393,summer
2012-05-16,2,22,0,1,1,33,253,286,summer
2012-05-16,2,23,0,1,1,26,107,133,summer
2012-05-17,2,0,0,1,1,30,49,79,summer
2012-05-17,2,1,0,1,1,12,16,28,summer
2012-05-17,2,2,0,1,1,8,8,16,summer
2012-05-17,2,3,0,1,1,0,3,3,summer
2012-05-17,2,4,0,1,1,3,13,16,summer
2012-05-17,2,5,0,1,1,1,34,35,summer
2012-05-17,2,6,0,1,1,10,149,159,summer
2012-05-17,2,7,0,1,1,25,449,474,summer
2012-05-17,2,8,0,1,1,29,605,634,summer
2012-05-17,2,9,0,1,1,57,289,346,summer
2012-05-17,2,10,0,1,1,43,162,205,summer
2012-05-17,2,11,0,1,1,77,202,279,summer
2012-05-17,2,12,0,1,1,72,276,348,summer
2012-05-17,2,13,0,1,1,86,241,327,summer
2012-05-17,2,14,0,1,1,68,202,270,summer
2012-05-17,2,15,0,1,1,83,233,316,summer
2012-05-17,2,16,0,1,1,86,344,430,summer
2012-05-17,2,17,0,1,1,133,719,852,summer
2012-05-17,2,18,0,1,1,134,734,868,summer
2012-05-17,2,19,0,1,1,86,451,537,summer
2012-05-17,2,20,0,1,1,83,363,446,summer
2012-05-17,2,21,0,1,1,45,254,299,summer
2012-05-17,2,22,0,1,1,42,209,251,summer
2012-05-17,2,23,0,1,1,29,137,166,summer
2012-05-18,2,0,0,1,1,13,57,70,summer
2012-05-18,2,1,0,1,1,16,33,49,summer
2012-05-18,2,2,0,1,1,12,9,21,summer
2012-05-18,2,3,0,1,1,6,8,14,summer
2012-05-18,2,4,0,1,1,0,11,11,summer
2012-05-18,2,5,0,1,1,1,33,34,summer
2012-05-18,2,6,0,1,1,14,168,182,summer
2012-05-18,2,7,0,1,1,40,475,515,summer
2012-05-18,2,8,0,1,1,49,696,745,summer
2012-05-18,2,9,0,1,1,57,304,361,summer
2012-05-18,2,10,0,1,1,74,181,255,summer
2012-05-18,2,11,0,1,1,109,225,334,summer
2012-05-18,2,12,0,1,1,108,252,360,summer
2012-05-18,2,13,0,1,1,98,297,395,summer
2012-05-18,2,14,0,1,1,108,242,350,summer
2012-05-18,2,15,0,1,1,131,260,391,summer
2012-05-18,2,16,0,1,1,151,417,568,summer
2012-05-18,2,17,0,1,1,124,688,812,summer
2012-05-18,2,18,0,1,1,99,570,669,summer
2012-05-18,2,19,0,1,1,91,392,483,summer
2012-05-18,2,20,0,1,1,73,264,337,summer
2012-05-18,2,21,0,1,1,49,209,258,summer
2012-05-18,2,22,0,1,1,57,194,251,summer
2012-05-18,2,23,0,1,1,41,133,174,summer
2012-05-19,2,0,0,0,1,30,118,148,summer
2012-05-19,2,1,0,0,1,20,84,104,summer
2012-05-19,2,2,0,0,1,13,56,69,summer
2012-05-19,2,3,0,0,1,10,23,33,summer
2012-05-19,2,4,0,0,1,6,8,14,summer
2012-05-19,2,5,0,0,1,1,11,12,summer
2012-05-19,2,6,0,0,1,12,38,50,summer
2012-05-19,2,7,0,0,1,28,67,95,summer
2012-05-19,2,8,0,0,1,33,162,195,summer
2012-05-19,2,9,0,0,1,79,213,292,summer
2012-05-19,2,10,0,0,1,177,275,452,summer
2012-05-19,2,11,0,0,1,235,351,586,summer
2012-05-19,2,12,0,0,1,276,366,642,summer
2012-05-19,2,13,0,0,1,332,372,704,summer
2012-05-19,2,14,0,0,1,361,369,730,summer
2012-05-19,2,15,0,0,1,356,316,672,summer
2012-05-19,2,16,0,0,1,331,311,642,summer
2012-05-19,2,17,0,0,1,279,347,626,summer
2012-05-19,2,18,0,0,1,254,391,645,summer
2012-05-19,2,19,0,0,1,203,229,432,summer
2012-05-19,2,20,0,0,1,118,197,315,summer
2012-05-19,2,21,0,0,1,81,178,259,summer
2012-05-19,2,22,0,0,1,104,234,338,summer
2012-05-19,2,23,0,0,1,71,168,239,summer
2012-05-20,2,0,0,0,1,42,128,170,summer
2012-05-20,2,1,0,0,1,28,102,130,summer
2012-05-20,2,2,0,0,1,36,62,98,summer
2012-05-20,2,3,0,0,1,26,40,66,summer
2012-05-20,2,4,0,0,1,2,14,16,summer
2012-05-20,2,5,0,0,1,1,7,8,summer
2012-05-20,2,6,0,0,1,4,21,25,summer
2012-05-20,2,7,0,0,1,35,55,90,summer
2012-05-20,2,8,0,0,1,51,120,171,summer
2012-05-20,2,9,0,0,1,129,184,313,summer
2012-05-20,2,10,0,0,1,174,258,432,summer
2012-05-20,2,11,0,0,1,258,323,581,summer
2012-05-20,2,12,0,0,1,247,390,637,summer
2012-05-20,2,13,0,0,1,244,363,607,summer
2012-05-20,2,14,0,0,1,236,307,543,summer
2012-05-20,2,15,0,0,2,246,256,502,summer
2012-05-20,2,16,0,0,1,238,339,577,summer
2012-05-20,2,17,0,0,1,209,340,549,summer
2012-05-20,2,18,0,0,1,146,328,474,summer
2012-05-20,2,19,0,0,1,142,260,402,summer
2012-05-20,2,20,0,0,1,83,191,274,summer
2012-05-20,2,21,0,0,1,51,182,233,summer
2012-05-20,2,22,0,0,1,44,101,145,summer
2012-05-20,2,23,0,0,3,32,54,86,summer
2012-05-21,2,0,0,1,3,12,28,40,summer
2012-05-21,2,1,0,1,3,4,11,15,summer
2012-05-21,2,2,0,1,3,2,9,11,summer
2012-05-21,2,3,0,1,2,0,2,2,summer
2012-05-21,2,4,0,1,3,2,5,7,summer
2012-05-21,2,5,0,1,3,1,14,15,summer
2012-05-21,2,6,0,1,3,3,76,79,summer
2012-05-21,2,7,0,1,3,7,146,153,summer
2012-05-21,2,8,0,1,3,12,258,270,summer
2012-05-21,2,9,0,1,3,14,172,186,summer
2012-05-21,2,10,0,1,3,28,71,99,summer
2012-05-21,2,11,0,1,2,24,82,106,summer
2012-05-21,2,12,0,1,2,46,124,170,summer
2012-05-21,2,13,0,1,3,49,135,184,summer
2012-05-21,2,14,0,1,3,45,135,180,summer
2012-05-21,2,15,0,1,2,67,158,225,summer
2012-05-21,2,16,0,1,2,46,269,315,summer
2012-05-21,2,17,0,1,2,40,468,508,summer
2012-05-21,2,18,0,1,1,52,478,530,summer
2012-05-21,2,19,0,1,1,57,391,448,summer
2012-05-21,2,20,0,1,1,44,292,336,summer
2012-05-21,2,21,0,1,1,31,210,241,summer
2012-05-21,2,22,0,1,2,26,116,142,summer
2012-05-21,2,23,0,1,1,18,79,97,summer
2012-05-22,2,0,0,1,1,10,26,36,summer
2012-05-22,2,1,0,1,2,11,16,27,summer
2012-05-22,2,2,0,1,2,1,10,11,summer
2012-05-22,2,3,0,1,2,0,5,5,summer
2012-05-22,2,4,0,1,2,0,7,7,summer
2012-05-22,2,5,0,1,3,0,17,17,summer
2012-05-22,2,6,0,1,3,8,129,137,summer
2012-05-22,2,7,0,1,3,9,315,324,summer
2012-05-22,2,8,0,1,2,20,570,590,summer
2012-05-22,2,9,0,1,2,46,287,333,summer
2012-05-22,2,10,0,1,2,52,148,200,summer
2012-05-22,2,11,0,1,2,39,150,189,summer
2012-05-22,2,12,0,1,2,76,178,254,summer
2012-05-22,2,13,0,1,2,48,195,243,summer
2012-05-22,2,14,0,1,2,73,149,222,summer
2012-05-22,2,15,0,1,1,54,191,245,summer
2012-05-22,2,16,0,1,1,70,316,386,summer
2012-05-22,2,17,0,1,1,69,716,785,summer
2012-05-22,2,18,0,1,1,76,709,785,summer
2012-05-22,2,19,0,1,1,44,320,364,summer
2012-05-22,2,20,0,1,1,54,319,373,summer
2012-05-22,2,21,0,1,1,28,233,261,summer
2012-05-22,2,22,0,1,1,17,157,174,summer
2012-05-22,2,23,0,1,1,14,91,105,summer
2012-05-23,2,0,0,1,1,19,28,47,summer
2012-05-23,2,1,0,1,1,23,9,32,summer
2012-05-23,2,2,0,1,2,2,10,12,summer
2012-05-23,2,3,0,1,1,0,5,5,summer
2012-05-23,2,4,0,1,3,0,3,3,summer
2012-05-23,2,5,0,1,3,6,29,35,summer
2012-05-23,2,6,0,1,1,6,154,160,summer
2012-05-23,2,7,0,1,1,16,452,468,summer
2012-05-23,2,8,0,1,1,38,681,719,summer
2012-05-23,2,9,0,1,2,39,258,297,summer
2012-05-23,2,10,0,1,1,52,139,191,summer
2012-05-23,2,11,0,1,1,46,151,197,summer
2012-05-23,2,12,0,1,2,42,206,248,summer
2012-05-23,2,13,0,1,2,69,201,270,summer
2012-05-23,2,14,0,1,1,67,181,248,summer
2012-05-23,2,15,0,1,2,65,192,257,summer
2012-05-23,2,16,0,1,3,62,216,278,summer
2012-05-23,2,17,0,1,3,45,240,285,summer
2012-05-23,2,18,0,1,3,31,296,327,summer
2012-05-23,2,19,0,1,2,40,336,376,summer
2012-05-23,2,20,0,1,2,28,267,295,summer
2012-05-23,2,21,0,1,2,24,221,245,summer
2012-05-23,2,22,0,1,2,23,136,159,summer
2012-05-23,2,23,0,1,1,23,83,106,summer
2012-05-24,2,0,0,1,1,7,49,56,summer
2012-05-24,2,1,0,1,1,9,21,30,summer
2012-05-24,2,2,0,1,1,1,15,16,summer
2012-05-24,2,3,0,1,2,1,3,4,summer
2012-05-24,2,4,0,1,2,0,5,5,summer
2012-05-24,2,5,0,1,2,1,29,30,summer
2012-05-24,2,6,0,1,2,10,146,156,summer
2012-05-24,2,7,0,1,1,22,393,415,summer
2012-05-24,2,8,0,1,1,33,659,692,summer
2012-05-24,2,9,0,1,1,34,267,301,summer
2012-05-24,2,10,0,1,1,47,138,185,summer
2012-05-24,2,11,0,1,1,61,160,221,summer
2012-05-24,2,12,0,1,1,76,213,289,summer
2012-05-24,2,13,0,1,1,69,233,302,summer
2012-05-24,2,14,0,1,1,72,180,252,summer
2012-05-24,2,15,0,1,1,69,222,291,summer
2012-05-24,2,16,0,1,1,61,329,390,summer
2012-05-24,2,17,0,1,1,120,678,798,summer
2012-05-24,2,18,0,1,1,118,634,752,summer
2012-05-24,2,19,0,1,1,76,416,492,summer
2012-05-24,2,20,0,1,2,55,343,398,summer
2012-05-24,2,21,0,1,3,48,237,285,summer
2012-05-24,2,22,0,1,2,33,210,243,summer
2012-05-24,2,23,0,1,2,36,131,167,summer
2012-05-25,2,0,0,1,1,10,63,73,summer
2012-05-25,2,1,0,1,1,8,34,42,summer
2012-05-25,2,2,0,1,2,7,16,23,summer
2012-05-25,2,3,0,1,2,8,6,14,summer
2012-05-25,2,4,0,1,2,3,6,9,summer
2012-05-25,2,5,0,1,2,2,28,30,summer
2012-05-25,2,6,0,1,2,5,108,113,summer
2012-05-25,2,7,0,1,2,7,352,359,summer
2012-05-25,2,8,0,1,2,32,551,583,summer
2012-05-25,2,9,0,1,2,52,288,340,summer
2012-05-25,2,10,0,1,1,69,163,232,summer
2012-05-25,2,11,0,1,1,90,193,283,summer
2012-05-25,2,12,0,1,1,84,237,321,summer
2012-05-25,2,13,0,1,1,86,247,333,summer
2012-05-25,2,14,0,1,1,104,263,367,summer
2012-05-25,2,15,0,1,1,106,360,466,summer
2012-05-25,2,16,0,1,1,137,447,584,summer
2012-05-25,2,17,0,1,1,124,529,653,summer
2012-05-25,2,18,0,1,1,131,391,522,summer
2012-05-25,2,19,0,1,1,111,293,404,summer
2012-05-25,2,20,0,1,1,80,270,350,summer
2012-05-25,2,21,0,1,1,62,193,255,summer
2012-05-25,2,22,0,1,1,65,147,212,summer
2012-05-25,2,23,0,1,1,34,132,166,summer
2012-05-26,2,0,0,0,1,18,98,116,summer
2012-05-26,2,1,0,0,1,18,64,82,summer
2012-05-26,2,2,0,0,1,9,55,64,summer
2012-05-26,2,3,0,0,1,9,22,31,summer
2012-05-26,2,4,0,0,1,0,2,2,summer
2012-05-26,2,5,0,0,1,0,10,10,summer
2012-05-26,2,6,0,0,1,6,25,31,summer
2012-05-26,2,7,0,0,2,10,44,54,summer
2012-05-26,2,8,0,0,1,38,103,141,summer
2012-05-26,2,9,0,0,1,97,192,289,summer
2012-05-26,2,10,0,0,1,181,256,437,summer
2012-05-26,2,11,0,0,1,208,312,520,summer
2012-05-26,2,12,0,0,1,236,293,529,summer
2012-05-26,2,13,0,0,1,265,274,539,summer
2012-05-26,2,14,0,0,1,307,257,564,summer
2012-05-26,2,15,0,0,1,274,239,513,summer
2012-05-26,2,16,0,0,1,261,243,504,summer
2012-05-26,2,17,0,0,2,235,227,462,summer
2012-05-26,2,18,0,0,2,199,216,415,summer
2012-05-26,2,19,0,0,2,159,214,373,summer
2012-05-26,2,20,0,0,2,103,152,255,summer
2012-05-26,2,21,0,0,2,100,151,251,summer
2012-05-26,2,22,0,0,1,86,118,204,summer
2012-05-26,2,23,0,0,1,36,114,150,summer
2012-05-27,2,0,0,0,2,48,89,137,summer
2012-05-27,2,1,0,0,1,17,61,78,summer
2012-05-27,2,2,0,0,1,16,45,61,summer
2012-05-27,2,3,0,0,1,11,25,36,summer
2012-05-27,2,4,0,0,1,4,7,11,summer
2012-05-27,2,5,0,0,1,2,5,7,summer
2012-05-27,2,6,0,0,1,8,14,22,summer
2012-05-27,2,7,0,0,1,22,30,52,summer
2012-05-27,2,8,0,0,1,69,82,151,summer
2012-05-27,2,9,0,0,1,130,140,270,summer
2012-05-27,2,10,0,0,1,209,215,424,summer
2012-05-27,2,11,0,0,1,268,251,519,summer
2012-05-27,2,12,0,0,1,301,269,570,summer
2012-05-27,2,13,0,0,1,270,228,498,summer
2012-05-27,2,14,0,0,1,317,230,547,summer
2012-05-27,2,15,0,0,1,290,245,535,summer
2012-05-27,2,16,0,0,1,258,243,501,summer
2012-05-27,2,17,0,0,1,275,247,522,summer
2012-05-27,2,18,0,0,1,266,252,518,summer
2012-05-27,2,19,0,0,1,230,212,442,summer
2012-05-27,2,20,0,0,1,168,224,392,summer
2012-05-27,2,21,0,0,3,64,79,143,summer
2012-05-27,2,22,0,0,3,9,50,59,summer
2012-05-27,2,23,0,0,3,31,65,96,summer
2012-05-28,2,0,1,0,1,21,44,65,summer
2012-05-28,2,1,1,0,2,14,45,59,summer
2012-05-28,2,2,1,0,1,20,28,48,summer
2012-05-28,2,3,1,0,1,6,12,18,summer
2012-05-28,2,4,1,0,1,2,4,6,summer
2012-05-28,2,5,1,0,1,4,5,9,summer
2012-05-28,2,6,1,0,1,6,14,20,summer
2012-05-28,2,7,1,0,1,24,43,67,summer
2012-05-28,2,8,1,0,1,62,93,155,summer
2012-05-28,2,9,1,0,1,121,142,263,summer
2012-05-28,2,10,1,0,1,189,175,364,summer
2012-05-28,2,11,1,0,1,254,222,476,summer
2012-05-28,2,12,1,0,1,233,292,525,summer
2012-05-28,2,13,1,0,1,272,284,556,summer
2012-05-28,2,14,1,0,1,238,227,465,summer
2012-05-28,2,15,1,0,1,181,279,460,summer
2012-05-28,2,16,1,0,1,223,278,501,summer
2012-05-28,2,17,1,0,1,158,247,405,summer
2012-05-28,2,18,1,0,1,132,251,383,summer
2012-05-28,2,19,1,0,1,148,247,395,summer
2012-05-28,2,20,1,0,1,114,203,317,summer
2012-05-28,2,21,1,0,1,66,181,247,summer
2012-05-28,2,22,1,0,1,47,110,157,summer
2012-05-28,2,23,1,0,1,22,60,82,summer
2012-05-29,2,0,0,1,1,12,33,45,summer
2012-05-29,2,1,0,1,1,1,13,14,summer
2012-05-29,2,2,0,1,1,0,8,8,summer
2012-05-29,2,3,0,1,1,1,2,3,summer
2012-05-29,2,4,0,1,1,0,5,5,summer
2012-05-29,2,5,0,1,1,1,32,33,summer
2012-05-29,2,6,0,1,1,9,145,154,summer
2012-05-29,2,7,0,1,1,19,431,450,summer
2012-05-29,2,8,0,1,1,46,588,634,summer
2012-05-29,2,9,0,1,1,26,231,257,summer
2012-05-29,2,10,0,1,1,67,116,183,summer
2012-05-29,2,11,0,1,1,50,147,197,summer
2012-05-29,2,12,0,1,1,56,181,237,summer
2012-05-29,2,13,0,1,1,63,176,239,summer
2012-05-29,2,14,0,1,1,80,158,238,summer
2012-05-29,2,15,0,1,1,71,185,256,summer
2012-05-29,2,16,0,1,1,73,320,393,summer
2012-05-29,2,17,0,1,1,107,674,781,summer
2012-05-29,2,18,0,1,1,78,632,710,summer
2012-05-29,2,19,0,1,1,69,457,526,summer
2012-05-29,2,20,0,1,3,36,168,204,summer
2012-05-29,2,21,0,1,3,3,68,71,summer
2012-05-29,2,22,0,1,2,2,53,55,summer
2012-05-29,2,23,0,1,3,10,40,50,summer
2012-05-30,2,0,0,1,3,4,32,36,summer
2012-05-30,2,1,0,1,3,0,4,4,summer
2012-05-30,2,2,0,1,3,1,4,5,summer
2012-05-30,2,3,0,1,3,0,5,5,summer
2012-05-30,2,4,0,1,2,0,6,6,summer
2012-05-30,2,5,0,1,2,1,40,41,summer
2012-05-30,2,6,0,1,2,5,139,144,summer
2012-05-30,2,7,0,1,3,14,469,483,summer
2012-05-30,2,8,0,1,2,29,642,671,summer
2012-05-30,2,9,0,1,2,23,282,305,summer
2012-05-30,2,10,0,1,2,39,138,177,summer
2012-05-30,2,11,0,1,2,53,155,208,summer
2012-05-30,2,12,0,1,1,33,220,253,summer
2012-05-30,2,13,0,1,1,53,236,289,summer
2012-05-30,2,14,0,1,1,44,208,252,summer
2012-05-30,2,15,0,1,1,54,221,275,summer
2012-05-30,2,16,0,1,1,46,352,398,summer
2012-05-30,2,17,0,1,1,83,756,839,summer
2012-05-30,2,18,0,1,1,50,746,796,summer
2012-05-30,2,19,0,1,1,50,506,556,summer
2012-05-30,2,20,0,1,2,57,374,431,summer
2012-05-30,2,21,0,1,1,41,263,304,summer
2012-05-30,2,22,0,1,1,26,191,217,summer
2012-05-30,2,23,0,1,1,39,121,160,summer
2012-05-31,2,0,0,1,1,13,48,61,summer
2012-05-31,2,1,0,1,1,4,22,26,summer
2012-05-31,2,2,0,1,1,6,8,14,summer
2012-05-31,2,3,0,1,1,0,8,8,summer
2012-05-31,2,4,0,1,1,0,8,8,summer
2012-05-31,2,5,0,1,1,1,32,33,summer
2012-05-31,2,6,0,1,1,7,171,178,summer
2012-05-31,2,7,0,1,1,18,489,507,summer
2012-05-31,2,8,0,1,1,18,675,693,summer
2012-05-31,2,9,0,1,1,47,264,311,summer
2012-05-31,2,10,0,1,1,65,155,220,summer
2012-05-31,2,11,0,1,1,65,153,218,summer
2012-05-31,2,12,0,1,1,62,230,292,summer
2012-05-31,2,13,0,1,1,77,216,293,summer
2012-05-31,2,14,0,1,1,61,193,254,summer
2012-05-31,2,15,0,1,1,81,209,290,summer
2012-05-31,2,16,0,1,1,103,384,487,summer
2012-05-31,2,17,0,1,1,85,742,827,summer
2012-05-31,2,18,0,1,1,85,700,785,summer
2012-05-31,2,19,0,1,1,104,487,591,summer
2012-05-31,2,20,0,1,1,88,391,479,summer
2012-05-31,2,21,0,1,1,41,318,359,summer
2012-05-31,2,22,0,1,1,43,221,264,summer
2012-05-31,2,23,0,1,1,26,114,140,summer
2012-06-01,2,0,0,1,1,10,76,86,summer
2012-06-01,2,1,0,1,1,0,34,34,summer
2012-06-01,2,2,0,1,1,3,13,16,summer
2012-06-01,2,3,0,1,2,0,4,4,summer
2012-06-01,2,4,0,1,2,1,5,6,summer
2012-06-01,2,5,0,1,2,4,41,45,summer
2012-06-01,2,6,0,1,3,5,136,141,summer
2012-06-01,2,7,0,1,2,33,369,402,summer
2012-06-01,2,8,0,1,2,19,675,694,summer
2012-06-01,2,9,0,1,2,24,274,298,summer
2012-06-01,2,10,0,1,2,49,155,204,summer
2012-06-01,2,11,0,1,2,42,193,235,summer
2012-06-01,2,12,0,1,2,72,238,310,summer
2012-06-01,2,13,0,1,1,76,240,316,summer
2012-06-01,2,14,0,1,3,55,199,254,summer
2012-06-01,2,15,0,1,3,45,213,258,summer
2012-06-01,2,16,0,1,3,36,186,222,summer
2012-06-01,2,17,0,1,3,25,202,227,summer
2012-06-01,2,18,0,1,3,10,100,110,summer
2012-06-01,2,19,0,1,3,4,41,45,summer
2012-06-01,2,20,0,1,3,1,38,39,summer
2012-06-01,2,21,0,1,3,12,73,85,summer
2012-06-01,2,22,0,1,3,1,22,23,summer
2012-06-01,2,23,0,1,3,6,67,73,summer
2012-06-02,2,0,0,0,2,5,81,86,summer
2012-06-02,2,1,0,0,2,15,61,76,summer
2012-06-02,2,2,0,0,2,3,38,41,summer
2012-06-02,2,3,0,0,1,8,18,26,summer
2012-06-02,2,4,0,0,1,2,11,13,summer
2012-06-02,2,5,0,0,1,1,11,12,summer
2012-06-02,2,6,0,0,2,5,31,36,summer
2012-06-02,2,7,0,0,1,9,77,86,summer
2012-06-02,2,8,0,0,1,30,180,210,summer
2012-06-02,2,9,0,0,1,89,243,332,summer
2012-06-02,2,10,0,0,1,145,348,493,summer
2012-06-02,2,11,0,0,1,179,357,536,summer
2012-06-02,2,12,0,0,1,250,418,668,summer
2012-06-02,2,13,0,0,1,279,400,679,summer
2012-06-02,2,14,0,0,1,259,388,647,summer
2012-06-02,2,15,0,0,1,297,405,702,summer
2012-06-02,2,16,0,0,1,275,369,644,summer
2012-06-02,2,17,0,0,1,248,338,586,summer
2012-06-02,2,18,0,0,1,171,341,512,summer
2012-06-02,2,19,0,0,1,185,369,554,summer
2012-06-02,2,20,0,0,1,139,260,399,summer
2012-06-02,2,21,0,0,1,96,220,316,summer
2012-06-02,2,22,0,0,1,52,176,228,summer
2012-06-02,2,23,0,0,1,53,185,238,summer
2012-06-03,2,0,0,0,1,27,142,169,summer
2012-06-03,2,1,0,0,1,21,100,121,summer
2012-06-03,2,2,0,0,1,22,67,89,summer
2012-06-03,2,3,0,0,1,16,34,50,summer
2012-06-03,2,4,0,0,1,1,12,13,summer
2012-06-03,2,5,0,0,1,1,11,12,summer
2012-06-03,2,6,0,0,1,6,16,22,summer
2012-06-03,2,7,0,0,1,6,29,35,summer
2012-06-03,2,8,0,0,1,30,110,140,summer
2012-06-03,2,9,0,0,1,70,230,300,summer
2012-06-03,2,10,0,0,1,127,277,404,summer
2012-06-03,2,11,0,0,1,199,312,511,summer
2012-06-03,2,12,0,0,1,276,408,684,summer
2012-06-03,2,13,0,0,1,265,421,686,summer
2012-06-03,2,14,0,0,1,267,411,678,summer
2012-06-03,2,15,0,0,1,236,408,644,summer
2012-06-03,2,16,0,0,1,226,436,662,summer
2012-06-03,2,17,0,0,1,192,386,578,summer
2012-06-03,2,18,0,0,1,153,343,496,summer
2012-06-03,2,19,0,0,1,116,337,453,summer
2012-06-03,2,20,0,0,1,84,230,314,summer
2012-06-03,2,21,0,0,1,66,180,246,summer
2012-06-03,2,22,0,0,1,61,165,226,summer
2012-06-03,2,23,0,0,1,26,82,108,summer
2012-06-04,2,0,0,1,1,11,38,49,summer
2012-06-04,2,1,0,1,3,4,10,14,summer
2012-06-04,2,2,0,1,1,1,10,11,summer
2012-06-04,2,3,0,1,2,0,5,5,summer
2012-06-04,2,4,0,1,1,2,6,8,summer
2012-06-04,2,5,0,1,1,2,33,35,summer
2012-06-04,2,6,0,1,1,4,135,139,summer
2012-06-04,2,7,0,1,1,13,504,517,summer
2012-06-04,2,8,0,1,1,22,643,665,summer
2012-06-04,2,9,0,1,1,38,244,282,summer
2012-06-04,2,10,0,1,1,67,120,187,summer
2012-06-04,2,11,0,1,1,71,168,239,summer
2012-06-04,2,12,0,1,1,62,220,282,summer
2012-06-04,2,13,0,1,1,85,189,274,summer
2012-06-04,2,14,0,1,1,84,186,270,summer
2012-06-04,2,15,0,1,1,77,215,292,summer
2012-06-04,2,16,0,1,1,73,375,448,summer
2012-06-04,2,17,0,1,1,101,733,834,summer
2012-06-04,2,18,0,1,1,103,719,822,summer
2012-06-04,2,19,0,1,1,91,554,645,summer
2012-06-04,2,20,0,1,1,71,390,461,summer
2012-06-04,2,21,0,1,1,40,225,265,summer
2012-06-04,2,22,0,1,1,41,127,168,summer
2012-06-04,2,23,0,1,1,8,78,86,summer
2012-06-05,2,0,0,1,1,6,28,34,summer
2012-06-05,2,1,0,1,2,2,18,20,summer
2012-06-05,2,2,0,1,3,0,8,8,summer
2012-06-05,2,3,0,1,3,0,5,5,summer
2012-06-05,2,4,0,1,3,1,4,5,summer
2012-06-05,2,5,0,1,3,1,35,36,summer
2012-06-05,2,6,0,1,1,7,177,184,summer
2012-06-05,2,7,0,1,1,29,540,569,summer
2012-06-05,2,8,0,1,2,30,680,710,summer
2012-06-05,2,9,0,1,2,50,285,335,summer
2012-06-05,2,10,0,1,2,58,118,176,summer
2012-06-05,2,11,0,1,2,65,162,227,summer
2012-06-05,2,12,0,1,2,45,202,247,summer
2012-06-05,2,13,0,1,2,66,201,267,summer
2012-06-05,2,14,0,1,2,82,194,276,summer
2012-06-05,2,15,0,1,2,54,218,272,summer
2012-06-05,2,16,0,1,1,91,382,473,summer
2012-06-05,2,17,0,1,1,86,764,850,summer
2012-06-05,2,18,0,1,1,111,679,790,summer
2012-06-05,2,19,0,1,1,68,445,513,summer
2012-06-05,2,20,0,1,1,44,371,415,summer
2012-06-05,2,21,0,1,1,30,253,283,summer
2012-06-05,2,22,0,1,1,22,171,193,summer
2012-06-05,2,23,0,1,1,20,93,113,summer
2012-06-06,2,0,0,1,1,3,46,49,summer
2012-06-06,2,1,0,1,1,6,21,27,summer
2012-06-06,2,2,0,1,1,4,7,11,summer
2012-06-06,2,3,0,1,1,0,8,8,summer
2012-06-06,2,4,0,1,1,3,7,10,summer
2012-06-06,2,5,0,1,1,1,37,38,summer
2012-06-06,2,6,0,1,1,7,165,172,summer
2012-06-06,2,7,0,1,1,16,531,547,summer
2012-06-06,2,8,0,1,1,31,637,668,summer
2012-06-06,2,9,0,1,1,35,268,303,summer
2012-06-06,2,10,0,1,1,55,148,203,summer
2012-06-06,2,11,0,1,1,65,161,226,summer
2012-06-06,2,12,0,1,1,80,235,315,summer
2012-06-06,2,13,0,1,1,73,230,303,summer
2012-06-06,2,14,0,1,1,111,191,302,summer
2012-06-06,2,15,0,1,1,75,225,300,summer
2012-06-06,2,16,0,1,1,107,345,452,summer
2012-06-06,2,17,0,1,1,72,652,724,summer
2012-06-06,2,18,0,1,3,94,688,782,summer
2012-06-06,2,19,0,1,1,52,486,538,summer
2012-06-06,2,20,0,1,1,59,349,408,summer
2012-06-06,2,21,0,1,1,38,260,298,summer
2012-06-06,2,22,0,1,1,27,221,248,summer
2012-06-06,2,23,0,1,1,13,110,123,summer
2012-06-07,2,0,0,1,1,9,50,59,summer
2012-06-07,2,1,0,1,1,5,17,22,summer
2012-06-07,2,2,0,1,1,0,12,12,summer
2012-06-07,2,3,0,1,1,0,5,5,summer
2012-06-07,2,4,0,1,1,0,6,6,summer
2012-06-07,2,5,0,1,1,0,34,34,summer
2012-06-07,2,6,0,1,1,5,165,170,summer
2012-06-07,2,7,0,1,1,20,506,526,summer
2012-06-07,2,8,0,1,1,20,661,681,summer
2012-06-07,2,9,0,1,1,37,300,337,summer
2012-06-07,2,10,0,1,1,56,154,210,summer
2012-06-07,2,11,0,1,1,67,170,237,summer
2012-06-07,2,12,0,1,1,62,274,336,summer
2012-06-07,2,13,0,1,1,65,250,315,summer
2012-06-07,2,14,0,1,1,67,198,265,summer
2012-06-07,2,15,0,1,1,99,234,333,summer
2012-06-07,2,16,0,1,1,77,389,466,summer
2012-06-07,2,17,0,1,1,91,778,869,summer
2012-06-07,2,18,0,1,1,110,703,813,summer
2012-06-07,2,19,0,1,1,65,537,602,summer
2012-06-07,2,20,0,1,1,76,402,478,summer
2012-06-07,2,21,0,1,1,30,283,313,summer
2012-06-07,2,22,0,1,1,35,193,228,summer
2012-06-07,2,23,0,1,1,42,135,177,summer
2012-06-08,2,0,0,1,1,18,59,77,summer
2012-06-08,2,1,0,1,1,4,25,29,summer
2012-06-08,2,2,0,1,1,2,17,19,summer
2012-06-08,2,3,0,1,1,0,8,8,summer
2012-06-08,2,4,0,1,1,1,9,10,summer
2012-06-08,2,5,0,1,1,1,28,29,summer
2012-06-08,2,6,0,1,1,8,131,139,summer
2012-06-08,2,7,0,1,1,19,409,428,summer
2012-06-08,2,8,0,1,1,37,663,700,summer
2012-06-08,2,9,0,1,1,47,335,382,summer
2012-06-08,2,10,0,1,1,62,187,249,summer
2012-06-08,2,11,0,1,1,65,199,264,summer
2012-06-08,2,12,0,1,1,89,280,369,summer
2012-06-08,2,13,0,1,1,129,287,416,summer
2012-06-08,2,14,0,1,1,128,245,373,summer
2012-06-08,2,15,0,1,1,98,299,397,summer
2012-06-08,2,16,0,1,1,111,412,523,summer
2012-06-08,2,17,0,1,1,114,679,793,summer
2012-06-08,2,18,0,1,1,147,576,723,summer
2012-06-08,2,19,0,1,1,95,460,555,summer
2012-06-08,2,20,0,1,1,117,291,408,summer
2012-06-08,2,21,0,1,1,83,256,339,summer
2012-06-08,2,22,0,1,1,61,230,291,summer
2012-06-08,2,23,0,1,1,52,163,215,summer
2012-06-09,2,0,0,0,1,54,152,206,summer
2012-06-09,2,1,0,0,1,34,89,123,summer
2012-06-09,2,2,0,0,1,21,68,89,summer
2012-06-09,2,3,0,0,1,12,28,40,summer
2012-06-09,2,4,0,0,1,2,6,8,summer
2012-06-09,2,5,0,0,1,4,15,19,summer
2012-06-09,2,6,0,0,1,17,63,80,summer
2012-06-09,2,7,0,0,1,26,61,87,summer
2012-06-09,2,8,0,0,1,42,202,244,summer
2012-06-09,2,9,0,0,1,99,241,340,summer
2012-06-09,2,10,0,0,1,168,298,466,summer
2012-06-09,2,11,0,0,1,218,351,569,summer
2012-06-09,2,12,0,0,1,196,335,531,summer
2012-06-09,2,13,0,0,1,236,349,585,summer
2012-06-09,2,14,0,0,1,239,354,593,summer
2012-06-09,2,15,0,0,1,218,337,555,summer
2012-06-09,2,16,0,0,1,219,315,534,summer
2012-06-09,2,17,0,0,1,238,257,495,summer
2012-06-09,2,18,0,0,1,175,276,451,summer
2012-06-09,2,19,0,0,1,128,232,360,summer
2012-06-09,2,20,0,0,1,125,238,363,summer
2012-06-09,2,21,0,0,1,105,211,316,summer
2012-06-09,2,22,0,0,1,63,151,214,summer
2012-06-09,2,23,0,0,1,69,161,230,summer
2012-06-10,2,0,0,0,1,33,125,158,summer
2012-06-10,2,1,0,0,1,32,84,116,summer
2012-06-10,2,2,0,0,1,17,56,73,summer
2012-06-10,2,3,0,0,1,6,23,29,summer
2012-06-10,2,4,0,0,1,1,9,10,summer
2012-06-10,2,5,0,0,1,3,10,13,summer
2012-06-10,2,6,0,0,1,3,27,30,summer
2012-06-10,2,7,0,0,1,21,41,62,summer
2012-06-10,2,8,0,0,1,59,122,181,summer
2012-06-10,2,9,0,0,1,91,175,266,summer
2012-06-10,2,10,0,0,1,148,265,413,summer
2012-06-10,2,11,0,0,1,184,315,499,summer
2012-06-10,2,12,0,0,1,173,329,502,summer
2012-06-10,2,13,0,0,1,204,288,492,summer
2012-06-10,2,14,0,0,1,186,314,500,summer
2012-06-10,2,15,0,0,1,159,316,475,summer
2012-06-10,2,16,0,0,1,173,335,508,summer
2012-06-10,2,17,0,0,1,184,337,521,summer
2012-06-10,2,18,0,0,1,164,326,490,summer
2012-06-10,2,19,0,0,1,115,260,375,summer
2012-06-10,2,20,0,0,1,113,250,363,summer
2012-06-10,2,21,0,0,1,83,170,253,summer
2012-06-10,2,22,0,0,1,42,117,159,summer
2012-06-10,2,23,0,0,1,30,80,110,summer
2012-06-11,2,0,0,1,1,8,33,41,summer
2012-06-11,2,1,0,1,1,9,15,24,summer
2012-06-11,2,2,0,1,1,5,12,17,summer
2012-06-11,2,3,0,1,1,2,4,6,summer
2012-06-11,2,4,0,1,1,0,7,7,summer
2012-06-11,2,5,0,1,1,1,36,37,summer
2012-06-11,2,6,0,1,1,8,136,144,summer
2012-06-11,2,7,0,1,1,25,478,503,summer
2012-06-11,2,8,0,1,1,38,613,651,summer
2012-06-11,2,9,0,1,1,57,259,316,summer
2012-06-11,2,10,0,1,1,52,95,147,summer
2012-06-11,2,11,0,1,2,59,143,202,summer
2012-06-11,2,12,0,1,2,63,198,261,summer
2012-06-11,2,13,0,1,2,63,185,248,summer
2012-06-11,2,14,0,1,2,66,193,259,summer
2012-06-11,2,15,0,1,1,72,187,259,summer
2012-06-11,2,16,0,1,2,87,340,427,summer
2012-06-11,2,17,0,1,2,85,715,800,summer
2012-06-11,2,18,0,1,2,105,726,831,summer
2012-06-11,2,19,0,1,2,89,507,596,summer
2012-06-11,2,20,0,1,2,61,333,394,summer
2012-06-11,2,21,0,1,2,32,218,250,summer
2012-06-11,2,22,0,1,2,22,142,164,summer
2012-06-11,2,23,0,1,2,8,72,80,summer
2012-06-12,2,0,0,1,2,2,26,28,summer
2012-06-12,2,1,0,1,2,5,11,16,summer
2012-06-12,2,2,0,1,2,0,6,6,summer
2012-06-12,2,3,0,1,2,3,9,12,summer
2012-06-12,2,4,0,1,3,0,4,4,summer
2012-06-12,2,5,0,1,3,1,28,29,summer
2012-06-12,2,6,0,1,2,6,130,136,summer
2012-06-12,2,7,0,1,3,16,287,303,summer
2012-06-12,2,8,0,1,2,15,598,613,summer
2012-06-12,2,9,0,1,2,31,254,285,summer
2012-06-12,2,10,0,1,3,29,96,125,summer
2012-06-12,2,11,0,1,3,8,57,65,summer
2012-06-12,2,12,0,1,3,19,76,95,summer
2012-06-12,2,13,0,1,3,11,48,59,summer
2012-06-12,2,14,0,1,3,12,48,60,summer
2012-06-12,2,15,0,1,3,22,94,116,summer
2012-06-12,2,16,0,1,2,30,209,239,summer
2012-06-12,2,17,0,1,2,56,625,681,summer
2012-06-12,2,18,0,1,1,57,596,653,summer
2012-06-12,2,19,0,1,1,47,444,491,summer
2012-06-12,2,20,0,1,1,36,350,386,summer
2012-06-12,2,21,0,1,1,41,233,274,summer
2012-06-12,2,22,0,1,1,19,188,207,summer
2012-06-12,2,23,0,1,3,11,78,89,summer
2012-06-13,2,0,0,1,2,7,27,34,summer
2012-06-13,2,1,0,1,1,7,21,28,summer
2012-06-13,2,2,0,1,1,0,4,4,summer
2012-06-13,2,3,0,1,1,1,7,8,summer
2012-06-13,2,4,0,1,1,1,9,10,summer
2012-06-13,2,5,0,1,1,2,38,40,summer
2012-06-13,2,6,0,1,1,6,188,194,summer
2012-06-13,2,7,0,1,1,25,480,505,summer
2012-06-13,2,8,0,1,2,41,672,713,summer
2012-06-13,2,9,0,1,2,54,298,352,summer
2012-06-13,2,10,0,1,2,64,134,198,summer
2012-06-13,2,11,0,1,2,64,182,246,summer
2012-06-13,2,12,0,1,2,93,241,334,summer
2012-06-13,2,13,0,1,2,52,203,255,summer
2012-06-13,2,14,0,1,2,98,222,320,summer
2012-06-13,2,15,0,1,1,65,216,281,summer
2012-06-13,2,16,0,1,1,72,320,392,summer
2012-06-13,2,17,0,1,1,75,782,857,summer
2012-06-13,2,18,0,1,1,104,640,744,summer
2012-06-13,2,19,0,1,1,123,548,671,summer
2012-06-13,2,20,0,1,1,86,362,448,summer
2012-06-13,2,21,0,1,1,79,317,396,summer
2012-06-13,2,22,0,1,1,29,209,238,summer
2012-06-13,2,23,0,1,1,25,128,153,summer
2012-06-14,2,0,0,1,1,3,45,48,summer
2012-06-14,2,1,0,1,1,4,17,21,summer
2012-06-14,2,2,0,1,2,1,8,9,summer
2012-06-14,2,3,0,1,2,1,4,5,summer
2012-06-14,2,4,0,1,2,0,6,6,summer
2012-06-14,2,5,0,1,2,0,40,40,summer
2012-06-14,2,6,0,1,1,12,169,181,summer
2012-06-14,2,7,0,1,1,26,480,506,summer
2012-06-14,2,8,0,1,1,37,682,719,summer
2012-06-14,2,9,0,1,1,45,312,357,summer
2012-06-14,2,10,0,1,1,47,132,179,summer
2012-06-14,2,11,0,1,1,60,168,228,summer
2012-06-14,2,12,0,1,2,55,210,265,summer
2012-06-14,2,13,0,1,1,71,213,284,summer
2012-06-14,2,14,0,1,1,84,214,298,summer
2012-06-14,2,15,0,1,1,111,213,324,summer
2012-06-14,2,16,0,1,1,70,368,438,summer
2012-06-14,2,17,0,1,1,117,750,867,summer
2012-06-14,2,18,0,1,1,107,716,823,summer
2012-06-14,2,19,0,1,1,96,483,579,summer
2012-06-14,2,20,0,1,1,84,351,435,summer
2012-06-14,2,21,0,1,1,67,270,337,summer
2012-06-14,2,22,0,1,2,46,196,242,summer
2012-06-14,2,23,0,1,2,36,136,172,summer
2012-06-15,2,0,0,1,1,26,68,94,summer
2012-06-15,2,1,0,1,1,9,42,51,summer
2012-06-15,2,2,0,1,1,0,15,15,summer
2012-06-15,2,3,0,1,1,2,3,5,summer
2012-06-15,2,4,0,1,1,1,13,14,summer
2012-06-15,2,5,0,1,1,2,31,33,summer
2012-06-15,2,6,0,1,1,9,142,151,summer
2012-06-15,2,7,0,1,1,17,413,430,summer
2012-06-15,2,8,0,1,1,44,609,653,summer
2012-06-15,2,9,0,1,1,58,308,366,summer
2012-06-15,2,10,0,1,1,56,160,216,summer
2012-06-15,2,11,0,1,1,106,180,286,summer
2012-06-15,2,12,0,1,1,111,292,403,summer
2012-06-15,2,13,0,1,1,121,272,393,summer
2012-06-15,2,14,0,1,1,121,255,376,summer
2012-06-15,2,15,0,1,1,107,270,377,summer
2012-06-15,2,16,0,1,1,132,426,558,summer
2012-06-15,2,17,0,1,1,125,698,823,summer
2012-06-15,2,18,0,1,1,121,572,693,summer
2012-06-15,2,19,0,1,1,98,369,467,summer
2012-06-15,2,20,0,1,1,89,296,385,summer
2012-06-15,2,21,0,1,1,83,250,333,summer
2012-06-15,2,22,0,1,1,79,242,321,summer
2012-06-15,2,23,0,1,1,46,176,222,summer
2012-06-16,2,0,0,0,1,25,112,137,summer
2012-06-16,2,1,0,0,1,16,79,95,summer
2012-06-16,2,2,0,0,1,12,55,67,summer
2012-06-16,2,3,0,0,1,8,19,27,summer
2012-06-16,2,4,0,0,1,3,5,8,summer
2012-06-16,2,5,0,0,1,2,21,23,summer
2012-06-16,2,6,0,0,1,11,36,47,summer
2012-06-16,2,7,0,0,1,10,68,78,summer
2012-06-16,2,8,0,0,1,47,157,204,summer
2012-06-16,2,9,0,0,1,88,279,367,summer
2012-06-16,2,10,0,0,1,139,296,435,summer
2012-06-16,2,11,0,0,1,213,353,566,summer
2012-06-16,2,12,0,0,1,254,349,603,summer
2012-06-16,2,13,0,0,1,293,324,617,summer
2012-06-16,2,14,0,0,1,264,309,573,summer
2012-06-16,2,15,0,0,1,295,288,583,summer
2012-06-16,2,16,0,0,2,238,304,542,summer
2012-06-16,2,17,0,0,2,244,349,593,summer
2012-06-16,2,18,0,0,2,256,315,571,summer
2012-06-16,2,19,0,0,2,184,277,461,summer
2012-06-16,2,20,0,0,2,123,229,352,summer
2012-06-16,2,21,0,0,2,98,192,290,summer
2012-06-16,2,22,0,0,1,91,189,280,summer
2012-06-16,2,23,0,0,1,49,134,183,summer
2012-06-17,2,0,0,0,1,31,117,148,summer
2012-06-17,2,1,0,0,1,21,67,88,summer
2012-06-17,2,2,0,0,1,19,55,74,summer
2012-06-17,2,3,0,0,1,6,22,28,summer
2012-06-17,2,4,0,0,1,2,16,18,summer
2012-06-17,2,5,0,0,1,4,13,17,summer
2012-06-17,2,6,0,0,1,7,16,23,summer
2012-06-17,2,7,0,0,1,18,30,48,summer
2012-06-17,2,8,0,0,1,24,95,119,summer
2012-06-17,2,9,0,0,1,91,183,274,summer
2012-06-17,2,10,0,0,1,148,288,436,summer
2012-06-17,2,11,0,0,1,196,350,546,summer
2012-06-17,2,12,0,0,1,260,355,615,summer
2012-06-17,2,13,0,0,1,267,347,614,summer
2012-06-17,2,14,0,0,1,255,327,582,summer
2012-06-17,2,15,0,0,1,203,260,463,summer
2012-06-17,2,16,0,0,1,240,340,580,summer
2012-06-17,2,17,0,0,1,232,361,593,summer
2012-06-17,2,18,0,0,1,203,310,513,summer
2012-06-17,2,19,0,0,1,146,244,390,summer
2012-06-17,2,20,0,0,1,101,201,302,summer
2012-06-17,2,21,0,0,1,76,170,246,summer
2012-06-17,2,22,0,0,1,55,98,153,summer
2012-06-17,2,23,0,0,1,29,79,108,summer
2012-06-18,2,0,0,1,1,12,28,40,summer
2012-06-18,2,1,0,1,1,9,5,14,summer
2012-06-18,2,2,0,1,1,3,6,9,summer
2012-06-18,2,3,0,1,2,1,3,4,summer
2012-06-18,2,4,0,1,2,0,9,9,summer
2012-06-18,2,5,0,1,3,1,22,23,summer
2012-06-18,2,6,0,1,3,0,37,37,summer
2012-06-18,2,7,0,1,3,10,135,145,summer
2012-06-18,2,8,0,1,2,27,447,474,summer
2012-06-18,2,9,0,1,2,28,222,250,summer
2012-06-18,2,10,0,1,3,13,78,91,summer
2012-06-18,2,11,0,1,2,25,96,121,summer
2012-06-18,2,12,0,1,3,29,139,168,summer
2012-06-18,2,13,0,1,2,51,174,225,summer
2012-06-18,2,14,0,1,2,59,160,219,summer
2012-06-18,2,15,0,1,2,61,176,237,summer
2012-06-18,2,16,0,1,2,53,279,332,summer
2012-06-18,2,17,0,1,2,54,669,723,summer
2012-06-18,2,18,0,1,2,47,595,642,summer
2012-06-18,2,19,0,1,2,52,411,463,summer
2012-06-18,2,20,0,1,2,45,317,362,summer
2012-06-18,2,21,0,1,2,35,238,273,summer
2012-06-18,2,22,0,1,2,21,143,164,summer
2012-06-18,2,23,0,1,3,17,57,74,summer
2012-06-19,2,0,0,1,2,5,30,35,summer
2012-06-19,2,1,0,1,2,1,13,14,summer
2012-06-19,2,2,0,1,2,1,14,15,summer
2012-06-19,2,3,0,1,2,1,7,8,summer
2012-06-19,2,4,0,1,2,1,9,10,summer
2012-06-19,2,5,0,1,2,3,34,37,summer
2012-06-19,2,6,0,1,2,9,152,161,summer
2012-06-19,2,7,0,1,2,18,462,480,summer
2012-06-19,2,8,0,1,2,40,633,673,summer
2012-06-19,2,9,0,1,1,40,288,328,summer
2012-06-19,2,10,0,1,1,44,136,180,summer
2012-06-19,2,11,0,1,1,56,174,230,summer
2012-06-19,2,12,0,1,1,70,222,292,summer
2012-06-19,2,13,0,1,1,69,203,272,summer
2012-06-19,2,14,0,1,1,61,166,227,summer
2012-06-19,2,15,0,1,1,72,187,259,summer
2012-06-19,2,16,0,1,1,48,286,334,summer
2012-06-19,2,17,0,1,1,86,725,811,summer
2012-06-19,2,18,0,1,1,91,704,795,summer
2012-06-19,2,19,0,1,1,82,432,514,summer
2012-06-19,2,20,0,1,1,59,399,458,summer
2012-06-19,2,21,0,1,1,37,239,276,summer
2012-06-19,2,22,0,1,1,51,240,291,summer
2012-06-19,2,23,0,1,1,23,102,125,summer
2012-06-20,2,0,0,1,1,5,48,53,summer
2012-06-20,2,1,0,1,1,7,20,27,summer
2012-06-20,2,2,0,1,1,1,5,6,summer
2012-06-20,2,3,0,1,1,2,6,8,summer
2012-06-20,2,4,0,1,1,1,6,7,summer
2012-06-20,2,5,0,1,1,2,37,39,summer
2012-06-20,2,6,0,1,2,9,156,165,summer
2012-06-20,2,7,0,1,2,20,444,464,summer
2012-06-20,2,8,0,1,2,43,600,643,summer
2012-06-20,2,9,0,1,2,40,276,316,summer
2012-06-20,2,10,0,1,1,41,126,167,summer
2012-06-20,2,11,0,1,1,54,134,188,summer
2012-06-20,2,12,0,1,1,30,150,180,summer
2012-06-20,2,13,0,1,1,48,163,211,summer
2012-06-20,2,14,0,1,1,56,134,190,summer
2012-06-20,2,15,0,1,1,36,143,179,summer
2012-06-20,2,16,0,1,1,51,284,335,summer
2012-06-20,2,17,0,1,1,80,611,691,summer
2012-06-20,2,18,0,1,1,81,591,672,summer
2012-06-20,2,19,0,1,1,90,449,539,summer
2012-06-20,2,20,0,1,1,81,326,407,summer
2012-06-20,2,21,0,1,1,42,302,344,summer
2012-06-20,2,22,0,1,1,31,226,257,summer
2012-06-20,2,23,0,1,1,21,102,123,summer
2012-06-21,3,0,0,1,1,16,53,69,fall
2012-06-21,3,1,0,1,1,2,16,18,fall
2012-06-21,3,2,0,1,1,11,7,18,fall
2012-06-21,3,3,0,1,1,3,8,11,fall
2012-06-21,3,4,0,1,1,1,11,12,fall
2012-06-21,3,5,0,1,1,3,37,40,fall
2012-06-21,3,6,0,1,2,3,147,150,fall
2012-06-21,3,7,0,1,2,26,437,463,fall
2012-06-21,3,8,0,1,1,27,563,590,fall
2012-06-21,3,9,0,1,1,32,224,256,fall
2012-06-21,3,10,0,1,1,36,114,150,fall
2012-06-21,3,11,0,1,1,40,121,161,fall
2012-06-21,3,12,0,1,1,33,182,215,fall
2012-06-21,3,13,0,1,1,31,141,172,fall
2012-06-21,3,14,0,1,1,27,149,176,fall
2012-06-21,3,15,0,1,1,40,154,194,fall
2012-06-21,3,16,0,1,1,37,283,320,fall
2012-06-21,3,17,0,1,1,80,535,615,fall
2012-06-21,3,18,0,1,1,78,562,640,fall
2012-06-21,3,19,0,1,1,84,415,499,fall
2012-06-21,3,20,0,1,1,79,357,436,fall
2012-06-21,3,21,0,1,1,55,256,311,fall
2012-06-21,3,22,0,1,1,22,221,243,fall
2012-06-21,3,23,0,1,1,12,134,146,fall
2012-06-22,3,0,0,1,2,16,77,93,fall
2012-06-22,3,1,0,1,1,3,28,31,fall
2012-06-22,3,2,0,1,1,0,12,12,fall
2012-06-22,3,3,0,1,1,1,6,7,fall
2012-06-22,3,4,0,1,2,3,7,10,fall
2012-06-22,3,5,0,1,2,3,35,38,fall
2012-06-22,3,6,0,1,2,4,118,122,fall
2012-06-22,3,7,0,1,1,19,340,359,fall
2012-06-22,3,8,0,1,1,49,564,613,fall
2012-06-22,3,9,0,1,1,55,278,333,fall
2012-06-22,3,10,0,1,1,52,133,185,fall
2012-06-22,3,11,0,1,1,76,160,236,fall
2012-06-22,3,12,0,1,1,63,191,254,fall
2012-06-22,3,13,0,1,1,72,228,300,fall
2012-06-22,3,14,0,1,1,65,198,263,fall
2012-06-22,3,15,0,1,1,72,212,284,fall
2012-06-22,3,16,0,1,1,67,313,380,fall
2012-06-22,3,17,0,1,2,95,551,646,fall
2012-06-22,3,18,0,1,2,62,443,505,fall
2012-06-22,3,19,0,1,2,45,317,362,fall
2012-06-22,3,20,0,1,2,31,171,202,fall
2012-06-22,3,21,0,1,3,40,177,217,fall
2012-06-22,3,22,0,1,1,42,155,197,fall
2012-06-22,3,23,0,1,2,29,145,174,fall
2012-06-23,3,0,0,0,1,14,102,116,fall
2012-06-23,3,1,0,0,1,16,107,123,fall
2012-06-23,3,2,0,0,2,18,75,93,fall
2012-06-23,3,3,0,0,2,10,32,42,fall
2012-06-23,3,4,0,0,2,6,13,19,fall
2012-06-23,3,5,0,0,2,1,11,12,fall
2012-06-23,3,6,0,0,1,10,37,47,fall
2012-06-23,3,7,0,0,1,19,59,78,fall
2012-06-23,3,8,0,0,1,34,133,167,fall
2012-06-23,3,9,0,0,1,85,247,332,fall
2012-06-23,3,10,0,0,1,177,317,494,fall
2012-06-23,3,11,0,0,1,167,349,516,fall
2012-06-23,3,12,0,0,1,203,399,602,fall
2012-06-23,3,13,0,0,1,226,338,564,fall
2012-06-23,3,14,0,0,1,238,371,609,fall
2012-06-23,3,15,0,0,1,217,266,483,fall
2012-06-23,3,16,0,0,1,196,317,513,fall
2012-06-23,3,17,0,0,1,214,316,530,fall
2012-06-23,3,18,0,0,1,194,287,481,fall
2012-06-23,3,19,0,0,1,185,240,425,fall
2012-06-23,3,20,0,0,1,158,228,386,fall
2012-06-23,3,21,0,0,1,99,223,322,fall
2012-06-23,3,22,0,0,1,101,178,279,fall
2012-06-23,3,23,0,0,1,69,156,225,fall
2012-06-24,3,0,0,0,1,31,132,163,fall
2012-06-24,3,1,0,0,2,39,88,127,fall
2012-06-24,3,2,0,0,2,34,80,114,fall
2012-06-24,3,3,0,0,2,19,41,60,fall
2012-06-24,3,4,0,0,2,4,9,13,fall
2012-06-24,3,5,0,0,1,1,7,8,fall
2012-06-24,3,6,0,0,1,6,19,25,fall
2012-06-24,3,7,0,0,1,23,48,71,fall
2012-06-24,3,8,0,0,1,38,103,141,fall
2012-06-24,3,9,0,0,1,63,169,232,fall
2012-06-24,3,10,0,0,1,161,291,452,fall
2012-06-24,3,11,0,0,1,215,291,506,fall
2012-06-24,3,12,0,0,1,227,329,556,fall
2012-06-24,3,13,0,0,1,237,348,585,fall
2012-06-24,3,14,0,0,1,253,298,551,fall
2012-06-24,3,15,0,0,1,197,290,487,fall
2012-06-24,3,16,0,0,1,181,280,461,fall
2012-06-24,3,17,0,0,1,203,329,532,fall
2012-06-24,3,18,0,0,1,186,348,534,fall
2012-06-24,3,19,0,0,1,176,247,423,fall
2012-06-24,3,20,0,0,1,108,224,332,fall
2012-06-24,3,21,0,0,1,76,177,253,fall
2012-06-24,3,22,0,0,1,53,125,178,fall
2012-06-24,3,23,0,0,1,20,67,87,fall
2012-06-25,3,0,0,1,1,31,37,68,fall
2012-06-25,3,1,0,1,1,11,20,31,fall
2012-06-25,3,2,0,1,1,4,10,14,fall
2012-06-25,3,3,0,1,1,1,4,5,fall
2012-06-25,3,4,0,1,1,0,4,4,fall
2012-06-25,3,5,0,1,1,1,42,43,fall
2012-06-25,3,6,0,1,1,11,147,158,fall
2012-06-25,3,7,0,1,1,30,455,485,fall
2012-06-25,3,8,0,1,1,53,555,608,fall
2012-06-25,3,9,0,1,1,37,231,268,fall
2012-06-25,3,10,0,1,1,58,126,184,fall
2012-06-25,3,11,0,1,1,54,127,181,fall
2012-06-25,3,12,0,1,2,74,196,270,fall
2012-06-25,3,13,0,1,1,79,181,260,fall
2012-06-25,3,14,0,1,1,90,161,251,fall
2012-06-25,3,15,0,1,1,65,168,233,fall
2012-06-25,3,16,0,1,1,104,310,414,fall
2012-06-25,3,17,0,1,1,76,757,833,fall
2012-06-25,3,18,0,1,1,100,691,791,fall
2012-06-25,3,19,0,1,1,74,508,582,fall
2012-06-25,3,20,0,1,1,100,375,475,fall
2012-06-25,3,21,0,1,1,50,281,331,fall
2012-06-25,3,22,0,1,1,21,166,187,fall
2012-06-25,3,23,0,1,1,15,88,103,fall
2012-06-26,3,0,0,1,1,8,29,37,fall
2012-06-26,3,1,0,1,1,11,19,30,fall
2012-06-26,3,2,0,1,1,2,7,9,fall
2012-06-26,3,3,0,1,1,2,7,9,fall
2012-06-26,3,4,0,1,1,1,9,10,fall
2012-06-26,3,5,0,1,1,3,36,39,fall
2012-06-26,3,6,0,1,1,12,176,188,fall
2012-06-26,3,7,0,1,1,21,531,552,fall
2012-06-26,3,8,0,1,1,34,622,656,fall
2012-06-26,3,9,0,1,1,30,298,328,fall
2012-06-26,3,10,0,1,1,37,153,190,fall
2012-06-26,3,11,0,1,1,46,189,235,fall
2012-06-26,3,12,0,1,1,80,228,308,fall
2012-06-26,3,13,0,1,1,74,232,306,fall
2012-06-26,3,14,0,1,1,81,186,267,fall
2012-06-26,3,15,0,1,1,88,229,317,fall
2012-06-26,3,16,0,1,1,67,349,416,fall
2012-06-26,3,17,0,1,1,104,796,900,fall
2012-06-26,3,18,0,1,1,105,719,824,fall
2012-06-26,3,19,0,1,1,83,529,612,fall
2012-06-26,3,20,0,1,1,88,417,505,fall
2012-06-26,3,21,0,1,1,61,267,328,fall
2012-06-26,3,22,0,1,1,26,219,245,fall
2012-06-26,3,23,0,1,1,13,118,131,fall
2012-06-27,3,0,0,1,1,15,39,54,fall
2012-06-27,3,1,0,1,1,5,18,23,fall
2012-06-27,3,2,0,1,1,2,12,14,fall
2012-06-27,3,3,0,1,1,1,7,8,fall
2012-06-27,3,4,0,1,1,0,11,11,fall
2012-06-27,3,5,0,1,1,2,34,36,fall
2012-06-27,3,6,0,1,1,7,193,200,fall
2012-06-27,3,7,0,1,1,29,498,527,fall
2012-06-27,3,8,0,1,1,49,638,687,fall
2012-06-27,3,9,0,1,1,29,253,282,fall
2012-06-27,3,10,0,1,1,34,138,172,fall
2012-06-27,3,11,0,1,1,64,145,209,fall
2012-06-27,3,12,0,1,1,77,245,322,fall
2012-06-27,3,13,0,1,1,77,244,321,fall
2012-06-27,3,14,0,1,1,78,192,270,fall
2012-06-27,3,15,0,1,1,61,188,249,fall
2012-06-27,3,16,0,1,1,55,337,392,fall
2012-06-27,3,17,0,1,1,113,730,843,fall
2012-06-27,3,18,0,1,1,85,719,804,fall
2012-06-27,3,19,0,1,1,101,542,643,fall
2012-06-27,3,20,0,1,1,76,369,445,fall
2012-06-27,3,21,0,1,1,54,313,367,fall
2012-06-27,3,22,0,1,1,52,245,297,fall
2012-06-27,3,23,0,1,1,11,148,159,fall
2012-06-28,3,0,0,1,1,2,52,54,fall
2012-06-28,3,1,0,1,1,11,14,25,fall
2012-06-28,3,2,0,1,1,1,12,13,fall
2012-06-28,3,3,0,1,1,1,6,7,fall
2012-06-28,3,4,0,1,1,0,11,11,fall
2012-06-28,3,5,0,1,1,8,39,47,fall
2012-06-28,3,6,0,1,1,8,185,193,fall
2012-06-28,3,7,0,1,1,24,484,508,fall
2012-06-28,3,8,0,1,1,40,577,617,fall
2012-06-28,3,9,0,1,1,33,318,351,fall
2012-06-28,3,10,0,1,1,40,144,184,fall
2012-06-28,3,11,0,1,1,41,170,211,fall
2012-06-28,3,12,0,1,1,49,227,276,fall
2012-06-28,3,13,0,1,1,31,205,236,fall
2012-06-28,3,14,0,1,1,66,188,254,fall
2012-06-28,3,15,0,1,1,24,195,219,fall
2012-06-28,3,16,0,1,1,56,331,387,fall
2012-06-28,3,17,0,1,1,71,634,705,fall
2012-06-28,3,18,0,1,1,100,597,697,fall
2012-06-28,3,19,0,1,1,79,492,571,fall
2012-06-28,3,20,0,1,1,71,399,470,fall
2012-06-28,3,21,0,1,1,89,309,398,fall
2012-06-28,3,22,0,1,1,50,224,274,fall
2012-06-28,3,23,0,1,1,26,145,171,fall
2012-06-29,3,0,0,1,1,24,90,114,fall
2012-06-29,3,1,0,1,1,9,33,42,fall
2012-06-29,3,2,0,1,1,3,15,18,fall
2012-06-29,3,3,0,1,1,3,5,8,fall
2012-06-29,3,4,0,1,1,1,9,10,fall
2012-06-29,3,5,0,1,1,6,39,45,fall
2012-06-29,3,6,0,1,2,15,148,163,fall
2012-06-29,3,7,0,1,1,19,361,380,fall
2012-06-29,3,8,0,1,2,48,576,624,fall
2012-06-29,3,9,0,1,1,39,261,300,fall
2012-06-29,3,10,0,1,1,32,139,171,fall
2012-06-29,3,11,0,1,2,51,137,188,fall
2012-06-29,3,12,0,1,2,53,173,226,fall
2012-06-29,3,13,0,1,1,45,194,239,fall
2012-06-29,3,14,0,1,1,49,184,233,fall
2012-06-29,3,15,0,1,1,47,183,230,fall
2012-06-29,3,16,0,1,1,59,292,351,fall
2012-06-29,3,17,0,1,1,82,457,539,fall
2012-06-29,3,18,0,1,1,50,414,464,fall
2012-06-29,3,19,0,1,1,60,303,363,fall
2012-06-29,3,20,0,1,1,53,255,308,fall
2012-06-29,3,21,0,1,2,41,195,236,fall
2012-06-29,3,22,0,1,3,34,129,163,fall
2012-06-29,3,23,0,1,3,6,42,48,fall
2012-06-30,3,0,0,0,3,4,65,69,fall
2012-06-30,3,1,0,0,3,3,55,58,fall
2012-06-30,3,2,0,0,2,7,54,61,fall
2012-06-30,3,3,0,0,2,3,20,23,fall
2012-06-30,3,4,0,0,2,3,15,18,fall
2012-06-30,3,5,0,0,1,3,7,10,fall
2012-06-30,3,6,0,0,1,6,36,42,fall
2012-06-30,3,7,0,0,1,10,82,92,fall
2012-06-30,3,8,0,0,1,26,168,194,fall
2012-06-30,3,9,0,0,1,41,234,275,fall
2012-06-30,3,10,0,0,1,96,308,404,fall
2012-06-30,3,11,0,0,1,102,350,452,fall
2012-06-30,3,12,0,0,1,143,328,471,fall
2012-06-30,3,13,0,0,1,105,323,428,fall
2012-06-30,3,14,0,0,1,114,295,409,fall
2012-06-30,3,15,0,0,1,117,287,404,fall
2012-06-30,3,16,0,0,1,109,264,373,fall
2012-06-30,3,17,0,0,1,131,231,362,fall
2012-06-30,3,18,0,0,1,91,248,339,fall
2012-06-30,3,19,0,0,1,134,240,374,fall
2012-06-30,3,20,0,0,1,88,204,292,fall
2012-06-30,3,21,0,0,1,48,165,213,fall
2012-06-30,3,22,0,0,1,38,134,172,fall
2012-06-30,3,23,0,0,1,33,119,152,fall
2012-07-01,3,0,0,0,1,27,122,149,fall
2012-07-01,3,1,0,0,1,12,81,93,fall
2012-07-01,3,2,0,0,1,21,69,90,fall
2012-07-01,3,3,0,0,1,6,27,33,fall
2012-07-01,3,4,0,0,1,0,4,4,fall
2012-07-01,3,5,0,0,1,3,7,10,fall
2012-07-01,3,6,0,0,1,8,19,27,fall
2012-07-01,3,7,0,0,1,13,37,50,fall
2012-07-01,3,8,0,0,1,36,106,142,fall
2012-07-01,3,9,0,0,1,51,168,219,fall
2012-07-01,3,10,0,0,1,98,268,366,fall
2012-07-01,3,11,0,0,1,121,256,377,fall
2012-07-01,3,12,0,0,1,114,319,433,fall
2012-07-01,3,13,0,0,1,111,309,420,fall
2012-07-01,3,14,0,0,1,98,346,444,fall
2012-07-01,3,15,0,0,1,101,244,345,fall
2012-07-01,3,16,0,0,1,85,228,313,fall
2012-07-01,3,17,0,0,1,90,323,413,fall
2012-07-01,3,18,0,0,1,95,275,370,fall
2012-07-01,3,19,0,0,1,103,279,382,fall
2012-07-01,3,20,0,0,1,88,244,332,fall
2012-07-01,3,21,0,0,1,77,181,258,fall
2012-07-01,3,22,0,0,1,41,110,151,fall
2012-07-01,3,23,0,0,3,22,88,110,fall
2012-07-02,3,0,0,1,2,12,31,43,fall
2012-07-02,3,1,0,1,2,3,14,17,fall
2012-07-02,3,2,0,1,2,1,14,15,fall
2012-07-02,3,3,0,1,2,0,5,5,fall
2012-07-02,3,4,0,1,2,2,10,12,fall
2012-07-02,3,5,0,1,2,3,37,40,fall
2012-07-02,3,6,0,1,1,4,132,136,fall
2012-07-02,3,7,0,1,1,8,390,398,fall
2012-07-02,3,8,0,1,1,20,548,568,fall
2012-07-02,3,9,0,1,1,56,239,295,fall
2012-07-02,3,10,0,1,1,70,104,174,fall
2012-07-02,3,11,0,1,1,67,134,201,fall
2012-07-02,3,12,0,1,1,74,183,257,fall
2012-07-02,3,13,0,1,1,74,162,236,fall
2012-07-02,3,14,0,1,1,79,151,230,fall
2012-07-02,3,15,0,1,1,59,175,234,fall
2012-07-02,3,16,0,1,1,61,304,365,fall
2012-07-02,3,17,0,1,1,82,665,747,fall
2012-07-02,3,18,0,1,1,72,658,730,fall
2012-07-02,3,19,0,1,1,71,510,581,fall
2012-07-02,3,20,0,1,1,38,357,395,fall
2012-07-02,3,21,0,1,1,17,241,258,fall
2012-07-02,3,22,0,1,1,19,169,188,fall
2012-07-02,3,23,0,1,1,12,90,102,fall
2012-07-03,3,0,0,1,1,9,44,53,fall
2012-07-03,3,1,0,1,1,5,9,14,fall
2012-07-03,3,2,0,1,1,2,8,10,fall
2012-07-03,3,3,0,1,1,0,2,2,fall
2012-07-03,3,4,0,1,1,0,6,6,fall
2012-07-03,3,5,0,1,1,2,33,35,fall
2012-07-03,3,6,0,1,1,5,149,154,fall
2012-07-03,3,7,0,1,1,21,462,483,fall
2012-07-03,3,8,0,1,1,42,604,646,fall
2012-07-03,3,9,0,1,1,46,226,272,fall
2012-07-03,3,10,0,1,1,56,153,209,fall
2012-07-03,3,11,0,1,1,66,151,217,fall
2012-07-03,3,12,0,1,1,74,198,272,fall
2012-07-03,3,13,0,1,1,80,203,283,fall
2012-07-03,3,14,0,1,1,69,241,310,fall
2012-07-03,3,15,0,1,2,71,330,401,fall
2012-07-03,3,16,0,1,2,90,437,527,fall
2012-07-03,3,17,0,1,2,102,620,722,fall
2012-07-03,3,18,0,1,2,85,542,627,fall
2012-07-03,3,19,0,1,2,66,431,497,fall
2012-07-03,3,20,0,1,3,80,296,376,fall
2012-07-03,3,21,0,1,2,36,160,196,fall
2012-07-03,3,22,0,1,1,26,151,177,fall
2012-07-03,3,23,0,1,1,19,152,171,fall
2012-07-04,3,0,1,0,1,19,140,159,fall
2012-07-04,3,1,1,0,1,27,96,123,fall
2012-07-04,3,2,1,0,1,27,66,93,fall
2012-07-04,3,3,1,0,1,9,23,32,fall
2012-07-04,3,4,1,0,1,5,11,16,fall
2012-07-04,3,5,1,0,1,5,14,19,fall
2012-07-04,3,6,1,0,1,9,23,32,fall
2012-07-04,3,7,1,0,1,10,62,72,fall
2012-07-04,3,8,1,0,1,43,110,153,fall
2012-07-04,3,9,1,0,1,90,203,293,fall
2012-07-04,3,10,1,0,1,143,304,447,fall
2012-07-04,3,11,1,0,1,164,321,485,fall
2012-07-04,3,12,1,0,1,164,330,494,fall
2012-07-04,3,13,1,0,1,177,322,499,fall
2012-07-04,3,14,1,0,1,190,357,547,fall
2012-07-04,3,15,1,0,1,155,299,454,fall
2012-07-04,3,16,1,0,1,163,226,389,fall
2012-07-04,3,17,1,0,1,161,253,414,fall
2012-07-04,3,18,1,0,1,159,271,430,fall
2012-07-04,3,19,1,0,1,177,255,432,fall
2012-07-04,3,20,1,0,1,237,314,551,fall
2012-07-04,3,21,1,0,1,222,362,584,fall
2012-07-04,3,22,1,0,1,175,327,502,fall
2012-07-04,3,23,1,0,2,31,152,183,fall
2012-07-05,3,0,0,1,1,17,71,88,fall
2012-07-05,3,1,0,1,1,6,24,30,fall
2012-07-05,3,2,0,1,1,4,14,18,fall
2012-07-05,3,3,0,1,1,2,5,7,fall
2012-07-05,3,4,0,1,1,0,7,7,fall
2012-07-05,3,5,0,1,1,1,28,29,fall
2012-07-05,3,6,0,1,1,3,130,133,fall
2012-07-05,3,7,0,1,1,27,316,343,fall
2012-07-05,3,8,0,1,1,36,514,550,fall
2012-07-05,3,9,0,1,1,47,246,293,fall
2012-07-05,3,10,0,1,1,69,117,186,fall
2012-07-05,3,11,0,1,1,107,137,244,fall
2012-07-05,3,12,0,1,1,88,188,276,fall
2012-07-05,3,13,0,1,1,129,181,310,fall
2012-07-05,3,14,0,1,1,87,154,241,fall
2012-07-05,3,15,0,1,1,71,183,254,fall
2012-07-05,3,16,0,1,1,109,324,433,fall
2012-07-05,3,17,0,1,1,114,575,689,fall
2012-07-05,3,18,0,1,2,96,511,607,fall
2012-07-05,3,19,0,1,2,128,375,503,fall
2012-07-05,3,20,0,1,2,78,243,321,fall
2012-07-05,3,21,0,1,1,91,232,323,fall
2012-07-05,3,22,0,1,1,63,162,225,fall
2012-07-05,3,23,0,1,1,32,99,131,fall
2012-07-06,3,0,0,1,1,39,63,102,fall
2012-07-06,3,1,0,1,1,7,22,29,fall
2012-07-06,3,2,0,1,1,4,13,17,fall
2012-07-06,3,3,0,1,2,1,6,7,fall
2012-07-06,3,4,0,1,1,2,4,6,fall
2012-07-06,3,5,0,1,1,4,31,35,fall
2012-07-06,3,6,0,1,1,4,127,131,fall
2012-07-06,3,7,0,1,1,20,333,353,fall
2012-07-06,3,8,0,1,1,28,557,585,fall
2012-07-06,3,9,0,1,1,55,249,304,fall
2012-07-06,3,10,0,1,1,80,130,210,fall
2012-07-06,3,11,0,1,1,92,141,233,fall
2012-07-06,3,12,0,1,1,111,220,331,fall
2012-07-06,3,13,0,1,1,99,194,293,fall
2012-07-06,3,14,0,1,1,91,184,275,fall
2012-07-06,3,15,0,1,1,79,206,285,fall
2012-07-06,3,16,0,1,1,69,300,369,fall
2012-07-06,3,17,0,1,1,90,486,576,fall
2012-07-06,3,18,0,1,1,106,454,560,fall
2012-07-06,3,19,0,1,1,112,306,418,fall
2012-07-06,3,20,0,1,1,91,245,336,fall
2012-07-06,3,21,0,1,1,77,223,300,fall
2012-07-06,3,22,0,1,1,78,210,288,fall
2012-07-06,3,23,0,1,1,27,137,164,fall
2012-07-07,3,0,0,0,1,35,115,150,fall
2012-07-07,3,1,0,0,1,16,55,71,fall
2012-07-07,3,2,0,0,1,11,47,58,fall
2012-07-07,3,3,0,0,1,12,19,31,fall
2012-07-07,3,4,0,0,1,3,13,16,fall
2012-07-07,3,5,0,0,1,2,12,14,fall
2012-07-07,3,6,0,0,1,4,27,31,fall
2012-07-07,3,7,0,0,1,8,63,71,fall
2012-07-07,3,8,0,0,1,32,120,152,fall
2012-07-07,3,9,0,0,1,69,187,256,fall
2012-07-07,3,10,0,0,1,100,225,325,fall
2012-07-07,3,11,0,0,1,122,245,367,fall
2012-07-07,3,12,0,0,1,124,218,342,fall
2012-07-07,3,13,0,0,2,116,244,360,fall
2012-07-07,3,14,0,0,2,105,203,308,fall
2012-07-07,3,15,0,0,1,113,193,306,fall
2012-07-07,3,16,0,0,1,102,192,294,fall
2012-07-07,3,17,0,0,1,103,176,279,fall
2012-07-07,3,18,0,0,1,83,194,277,fall
2012-07-07,3,19,0,0,1,68,219,287,fall
2012-07-07,3,20,0,0,1,79,197,276,fall
2012-07-07,3,21,0,0,1,51,150,201,fall
2012-07-07,3,22,0,0,1,56,164,220,fall
2012-07-07,3,23,0,0,1,34,114,148,fall
2012-07-08,3,0,0,0,1,22,125,147,fall
2012-07-08,3,1,0,0,1,25,99,124,fall
2012-07-08,3,2,0,0,1,11,59,70,fall
2012-07-08,3,3,0,0,1,1,34,35,fall
2012-07-08,3,4,0,0,1,2,11,13,fall
2012-07-08,3,5,0,0,1,1,5,6,fall
2012-07-08,3,6,0,0,1,5,16,21,fall
2012-07-08,3,7,0,0,1,19,33,52,fall
2012-07-08,3,8,0,0,1,35,95,130,fall
2012-07-08,3,9,0,0,1,70,172,242,fall
2012-07-08,3,10,0,0,1,85,234,319,fall
2012-07-08,3,11,0,0,1,120,269,389,fall
2012-07-08,3,12,0,0,1,105,271,376,fall
2012-07-08,3,13,0,0,1,118,219,337,fall
2012-07-08,3,14,0,0,1,77,235,312,fall
2012-07-08,3,15,0,0,3,80,218,298,fall
2012-07-08,3,16,0,0,2,65,226,291,fall
2012-07-08,3,17,0,0,1,68,202,270,fall
2012-07-08,3,18,0,0,1,54,199,253,fall
2012-07-08,3,19,0,0,1,66,184,250,fall
2012-07-08,3,20,0,0,1,79,206,285,fall
2012-07-08,3,21,0,0,1,58,149,207,fall
2012-07-08,3,22,0,0,3,12,110,122,fall
2012-07-08,3,23,0,0,3,25,98,123,fall
2012-07-09,3,0,0,1,2,6,33,39,fall
2012-07-09,3,1,0,1,3,5,13,18,fall
2012-07-09,3,2,0,1,3,1,4,5,fall
2012-07-09,3,3,0,1,3,0,5,5,fall
2012-07-09,3,4,0,1,3,1,1,2,fall
2012-07-09,3,5,0,1,2,1,27,28,fall
2012-07-09,3,6,0,1,3,6,86,92,fall
2012-07-09,3,7,0,1,3,7,223,230,fall
2012-07-09,3,8,0,1,2,26,429,455,fall
2012-07-09,3,9,0,1,2,38,325,363,fall
2012-07-09,3,10,0,1,2,58,117,175,fall
2012-07-09,3,11,0,1,2,72,144,216,fall
2012-07-09,3,12,0,1,2,61,205,266,fall
2012-07-09,3,13,0,1,2,67,188,255,fall
2012-07-09,3,14,0,1,2,58,184,242,fall
2012-07-09,3,15,0,1,2,66,214,280,fall
2012-07-09,3,16,0,1,1,88,325,413,fall
2012-07-09,3,17,0,1,1,108,741,849,fall
2012-07-09,3,18,0,1,1,82,790,872,fall
2012-07-09,3,19,0,1,1,88,543,631,fall
2012-07-09,3,20,0,1,2,69,378,447,fall
2012-07-09,3,21,0,1,2,33,298,331,fall
2012-07-09,3,22,0,1,2,35,189,224,fall
2012-07-09,3,23,0,1,2,22,109,131,fall
2012-07-10,3,0,0,1,1,16,53,69,fall
2012-07-10,3,1,0,1,1,0,15,15,fall
2012-07-10,3,2,0,1,1,1,15,16,fall
2012-07-10,3,3,0,1,1,0,3,3,fall
2012-07-10,3,4,0,1,1,0,4,4,fall
2012-07-10,3,5,0,1,1,3,39,42,fall
2012-07-10,3,6,0,1,2,4,183,187,fall
2012-07-10,3,7,0,1,2,31,489,520,fall
2012-07-10,3,8,0,1,1,34,615,649,fall
2012-07-10,3,9,0,1,1,47,284,331,fall
2012-07-10,3,10,0,1,1,56,134,190,fall
2012-07-10,3,11,0,1,1,92,157,249,fall
2012-07-10,3,12,0,1,1,69,203,272,fall
2012-07-10,3,13,0,1,1,77,203,280,fall
2012-07-10,3,14,0,1,1,71,171,242,fall
2012-07-10,3,15,0,1,1,77,188,265,fall
2012-07-10,3,16,0,1,1,89,346,435,fall
2012-07-10,3,17,0,1,1,103,769,872,fall
2012-07-10,3,18,0,1,3,70,749,819,fall
2012-07-10,3,19,0,1,3,55,359,414,fall
2012-07-10,3,20,0,1,3,9,75,84,fall
2012-07-10,3,21,0,1,3,7,83,90,fall
2012-07-10,3,22,0,1,2,14,125,139,fall
2012-07-10,3,23,0,1,2,29,74,103,fall
2012-07-11,3,0,0,1,2,6,38,44,fall
2012-07-11,3,1,0,1,1,3,11,14,fall
2012-07-11,3,2,0,1,1,0,5,5,fall
2012-07-11,3,3,0,1,1,0,5,5,fall
2012-07-11,3,4,0,1,1,1,6,7,fall
2012-07-11,3,5,0,1,1,5,36,41,fall
2012-07-11,3,6,0,1,1,17,168,185,fall
2012-07-11,3,7,0,1,2,26,471,497,fall
2012-07-11,3,8,0,1,2,30,644,674,fall
2012-07-11,3,9,0,1,2,30,298,328,fall
2012-07-11,3,10,0,1,2,47,148,195,fall
2012-07-11,3,11,0,1,2,56,173,229,fall
2012-07-11,3,12,0,1,2,69,223,292,fall
2012-07-11,3,13,0,1,2,65,208,273,fall
2012-07-11,3,14,0,1,1,66,175,241,fall
2012-07-11,3,15,0,1,1,56,220,276,fall
2012-07-11,3,16,0,1,1,53,358,411,fall
2012-07-11,3,17,0,1,1,90,740,830,fall
2012-07-11,3,18,0,1,1,79,735,814,fall
2012-07-11,3,19,0,1,1,73,560,633,fall
2012-07-11,3,20,0,1,1,73,410,483,fall
2012-07-11,3,21,0,1,1,69,322,391,fall
2012-07-11,3,22,0,1,1,41,203,244,fall
2012-07-11,3,23,0,1,2,20,132,152,fall
2012-07-12,3,0,0,1,2,1,55,56,fall
2012-07-12,3,1,0,1,2,0,21,21,fall
2012-07-12,3,2,0,1,2,0,9,9,fall
2012-07-12,3,3,0,1,1,0,10,10,fall
2012-07-12,3,4,0,1,1,0,5,5,fall
2012-07-12,3,5,0,1,1,4,40,44,fall
2012-07-12,3,6,0,1,1,7,171,178,fall
2012-07-12,3,7,0,1,1,32,480,512,fall
2012-07-12,3,8,0,1,1,49,653,702,fall
2012-07-12,3,9,0,1,1,42,285,327,fall
2012-07-12,3,10,0,1,1,69,145,214,fall
2012-07-12,3,11,0,1,1,49,166,215,fall
2012-07-12,3,12,0,1,1,71,221,292,fall
2012-07-12,3,13,0,1,1,52,225,277,fall
2012-07-12,3,14,0,1,1,42,167,209,fall
2012-07-12,3,15,0,1,1,63,208,271,fall
2012-07-12,3,16,0,1,1,69,370,439,fall
2012-07-12,3,17,0,1,1,91,704,795,fall
2012-07-12,3,18,0,1,1,86,739,825,fall
2012-07-12,3,19,0,1,1,97,532,629,fall
2012-07-12,3,20,0,1,1,75,439,514,fall
2012-07-12,3,21,0,1,1,44,329,373,fall
2012-07-12,3,22,0,1,1,56,262,318,fall
2012-07-12,3,23,0,1,2,33,178,211,fall
2012-07-13,3,0,0,1,2,19,76,95,fall
2012-07-13,3,1,0,1,2,17,42,59,fall
2012-07-13,3,2,0,1,2,2,15,17,fall
2012-07-13,3,3,0,1,2,2,7,9,fall
2012-07-13,3,4,0,1,2,0,11,11,fall
2012-07-13,3,5,0,1,2,4,30,34,fall
2012-07-13,3,6,0,1,2,7,120,127,fall
2012-07-13,3,7,0,1,2,27,353,380,fall
2012-07-13,3,8,0,1,2,53,660,713,fall
2012-07-13,3,9,0,1,2,70,344,414,fall
2012-07-13,3,10,0,1,2,78,190,268,fall
2012-07-13,3,11,0,1,2,68,220,288,fall
2012-07-13,3,12,0,1,2,125,254,379,fall
2012-07-13,3,13,0,1,2,100,274,374,fall
2012-07-13,3,14,0,1,2,120,249,369,fall
2012-07-13,3,15,0,1,2,92,261,353,fall
2012-07-13,3,16,0,1,2,111,381,492,fall
2012-07-13,3,17,0,1,2,138,697,835,fall
2012-07-13,3,18,0,1,1,108,523,631,fall
2012-07-13,3,19,0,1,1,103,385,488,fall
2012-07-13,3,20,0,1,1,95,294,389,fall
2012-07-13,3,21,0,1,1,76,223,299,fall
2012-07-13,3,22,0,1,1,59,204,263,fall
2012-07-13,3,23,0,1,2,37,175,212,fall
2012-07-14,3,0,0,0,2,35,156,191,fall
2012-07-14,3,1,0,0,2,13,105,118,fall
2012-07-14,3,2,0,0,2,10,91,101,fall
2012-07-14,3,3,0,0,2,9,31,40,fall
2012-07-14,3,4,0,0,3,3,6,9,fall
2012-07-14,3,5,0,0,2,0,5,5,fall
2012-07-14,3,6,0,0,2,6,29,35,fall
2012-07-14,3,7,0,0,1,7,41,48,fall
2012-07-14,3,8,0,0,1,33,118,151,fall
2012-07-14,3,9,0,0,1,82,200,282,fall
2012-07-14,3,10,0,0,2,123,278,401,fall
2012-07-14,3,11,0,0,2,143,296,439,fall
2012-07-14,3,12,0,0,2,181,318,499,fall
2012-07-14,3,13,0,0,2,219,372,591,fall
2012-07-14,3,14,0,0,1,269,363,632,fall
2012-07-14,3,15,0,0,1,243,317,560,fall
2012-07-14,3,16,0,0,2,226,340,566,fall
2012-07-14,3,17,0,0,3,199,259,458,fall
2012-07-14,3,18,0,0,1,108,243,351,fall
2012-07-14,3,19,0,0,1,156,275,431,fall
2012-07-14,3,20,0,0,1,101,255,356,fall
2012-07-14,3,21,0,0,1,69,200,269,fall
2012-07-14,3,22,0,0,1,65,160,225,fall
2012-07-14,3,23,0,0,2,55,156,211,fall
2012-07-15,3,0,0,0,1,40,147,187,fall
2012-07-15,3,1,0,0,2,49,119,168,fall
2012-07-15,3,2,0,0,2,29,86,115,fall
2012-07-15,3,3,0,0,2,15,42,57,fall
2012-07-15,3,4,0,0,2,8,11,19,fall
2012-07-15,3,5,0,0,1,2,7,9,fall
2012-07-15,3,6,0,0,1,6,9,15,fall
2012-07-15,3,7,0,0,1,17,30,47,fall
2012-07-15,3,8,0,0,2,37,96,133,fall
2012-07-15,3,9,0,0,2,58,163,221,fall
2012-07-15,3,10,0,0,1,141,241,382,fall
2012-07-15,3,11,0,0,1,170,281,451,fall
2012-07-15,3,12,0,0,1,153,336,489,fall
2012-07-15,3,13,0,0,1,171,309,480,fall
2012-07-15,3,14,0,0,1,162,314,476,fall
2012-07-15,3,15,0,0,1,182,307,489,fall
2012-07-15,3,16,0,0,1,152,343,495,fall
2012-07-15,3,17,0,0,1,122,314,436,fall
2012-07-15,3,18,0,0,3,84,228,312,fall
2012-07-15,3,19,0,0,1,109,203,312,fall
2012-07-15,3,20,0,0,1,95,199,294,fall
2012-07-15,3,21,0,0,1,59,164,223,fall
2012-07-15,3,22,0,0,1,34,96,130,fall
2012-07-15,3,23,0,0,1,25,66,91,fall
2012-07-16,3,0,0,1,3,11,32,43,fall
2012-07-16,3,1,0,1,2,1,10,11,fall
2012-07-16,3,2,0,1,1,4,11,15,fall
2012-07-16,3,3,0,1,1,2,4,6,fall
2012-07-16,3,4,0,1,1,1,11,12,fall
2012-07-16,3,5,0,1,1,10,40,50,fall
2012-07-16,3,6,0,1,1,8,132,140,fall
2012-07-16,3,7,0,1,1,24,459,483,fall
2012-07-16,3,8,0,1,1,48,619,667,fall
2012-07-16,3,9,0,1,1,51,297,348,fall
2012-07-16,3,10,0,1,1,69,117,186,fall
2012-07-16,3,11,0,1,1,57,125,182,fall
2012-07-16,3,12,0,1,1,79,158,237,fall
2012-07-16,3,13,0,1,1,63,176,239,fall
2012-07-16,3,14,0,1,1,53,159,212,fall
2012-07-16,3,15,0,1,1,61,176,237,fall
2012-07-16,3,16,0,1,3,77,309,386,fall
2012-07-16,3,17,0,1,3,86,669,755,fall
2012-07-16,3,18,0,1,1,97,697,794,fall
2012-07-16,3,19,0,1,1,92,503,595,fall
2012-07-16,3,20,0,1,1,66,388,454,fall
2012-07-16,3,21,0,1,1,45,283,328,fall
2012-07-16,3,22,0,1,1,56,228,284,fall
2012-07-16,3,23,0,1,1,27,139,166,fall
2012-07-17,3,0,0,1,1,10,43,53,fall
2012-07-17,3,1,0,1,1,4,21,25,fall
2012-07-17,3,2,0,1,1,1,6,7,fall
2012-07-17,3,3,0,1,1,0,3,3,fall
2012-07-17,3,4,0,1,1,0,7,7,fall
2012-07-17,3,5,0,1,1,7,31,38,fall
2012-07-17,3,6,0,1,1,16,197,213,fall
2012-07-17,3,7,0,1,2,26,500,526,fall
2012-07-17,3,8,0,1,2,43,618,661,fall
2012-07-17,3,9,0,1,2,32,288,320,fall
2012-07-17,3,10,0,1,2,37,122,159,fall
2012-07-17,3,11,0,1,2,60,146,206,fall
2012-07-17,3,12,0,1,2,80,174,254,fall
2012-07-17,3,13,0,1,1,53,168,221,fall
2012-07-17,3,14,0,1,1,54,160,214,fall
2012-07-17,3,15,0,1,1,57,187,244,fall
2012-07-17,3,16,0,1,1,64,317,381,fall
2012-07-17,3,17,0,1,1,95,675,770,fall
2012-07-17,3,18,0,1,1,60,712,772,fall
2012-07-17,3,19,0,1,1,69,478,547,fall
2012-07-17,3,20,0,1,1,52,375,427,fall
2012-07-17,3,21,0,1,1,50,283,333,fall
2012-07-17,3,22,0,1,1,29,215,244,fall
2012-07-17,3,23,0,1,1,22,139,161,fall
2012-07-18,3,0,0,1,1,8,45,53,fall
2012-07-18,3,1,0,1,1,2,14,16,fall
2012-07-18,3,2,0,1,1,3,5,8,fall
2012-07-18,3,3,0,1,1,2,2,4,fall
2012-07-18,3,4,0,1,1,0,6,6,fall
2012-07-18,3,5,0,1,1,5,41,46,fall
2012-07-18,3,6,0,1,1,10,152,162,fall
2012-07-18,3,7,0,1,1,23,472,495,fall
2012-07-18,3,8,0,1,1,55,624,679,fall
2012-07-18,3,9,0,1,1,44,253,297,fall
2012-07-18,3,10,0,1,1,39,99,138,fall
2012-07-18,3,11,0,1,1,47,136,183,fall
2012-07-18,3,12,0,1,1,36,166,202,fall
2012-07-18,3,13,0,1,1,49,154,203,fall
2012-07-18,3,14,0,1,1,54,116,170,fall
2012-07-18,3,15,0,1,3,42,152,194,fall
2012-07-18,3,16,0,1,1,34,190,224,fall
2012-07-18,3,17,0,1,1,35,335,370,fall
2012-07-18,3,18,0,1,2,63,580,643,fall
2012-07-18,3,19,0,1,2,78,438,516,fall
2012-07-18,3,20,0,1,1,56,310,366,fall
2012-07-18,3,21,0,1,1,53,266,319,fall
2012-07-18,3,22,0,1,1,42,246,288,fall
2012-07-18,3,23,0,1,1,19,112,131,fall
2012-07-19,3,0,0,1,1,16,50,66,fall
2012-07-19,3,1,0,1,1,6,19,25,fall
2012-07-19,3,2,0,1,1,0,7,7,fall
2012-07-19,3,3,0,1,1,1,4,5,fall
2012-07-19,3,4,0,1,1,0,8,8,fall
2012-07-19,3,5,0,1,2,5,35,40,fall
2012-07-19,3,6,0,1,1,8,144,152,fall
2012-07-19,3,7,0,1,1,23,450,473,fall
2012-07-19,3,8,0,1,1,32,625,657,fall
2012-07-19,3,9,0,1,2,36,282,318,fall
2012-07-19,3,10,0,1,1,41,157,198,fall
2012-07-19,3,11,0,1,1,54,162,216,fall
2012-07-19,3,12,0,1,1,59,215,274,fall
2012-07-19,3,13,0,1,1,74,180,254,fall
2012-07-19,3,14,0,1,1,46,151,197,fall
2012-07-19,3,15,0,1,1,66,226,292,fall
2012-07-19,3,16,0,1,1,70,288,358,fall
2012-07-19,3,17,0,1,1,93,678,771,fall
2012-07-19,3,18,0,1,1,93,684,777,fall
2012-07-19,3,19,0,1,1,53,480,533,fall
2012-07-19,3,20,0,1,1,65,440,505,fall
2012-07-19,3,21,0,1,3,38,294,332,fall
2012-07-19,3,22,0,1,3,6,62,68,fall
2012-07-19,3,23,0,1,3,3,62,65,fall
2012-07-20,3,0,0,1,3,2,32,34,fall
2012-07-20,3,1,0,1,1,2,9,11,fall
2012-07-20,3,2,0,1,2,5,14,19,fall
2012-07-20,3,3,0,1,2,7,29,36,fall
2012-07-20,3,4,0,1,2,3,6,9,fall
2012-07-20,3,5,0,1,2,2,40,42,fall
2012-07-20,3,6,0,1,2,3,123,126,fall
2012-07-20,3,7,0,1,2,14,346,360,fall
2012-07-20,3,8,0,1,2,39,652,691,fall
2012-07-20,3,9,0,1,2,45,328,373,fall
2012-07-20,3,10,0,1,2,51,182,233,fall
2012-07-20,3,11,0,1,3,51,161,212,fall
2012-07-20,3,12,0,1,3,41,233,274,fall
2012-07-20,3,13,0,1,3,20,136,156,fall
2012-07-20,3,14,0,1,3,53,176,229,fall
2012-07-20,3,15,0,1,2,47,169,216,fall
2012-07-20,3,16,0,1,2,70,366,436,fall
2012-07-20,3,17,0,1,2,95,620,715,fall
2012-07-20,3,18,0,1,2,73,549,622,fall
2012-07-20,3,19,0,1,2,44,358,402,fall
2012-07-20,3,20,0,1,3,35,216,251,fall
2012-07-20,3,21,0,1,3,14,108,122,fall
2012-07-20,3,22,0,1,2,13,122,135,fall
2012-07-20,3,23,0,1,2,18,148,166,fall
2012-07-21,3,0,0,0,3,11,92,103,fall
2012-07-21,3,1,0,0,2,10,62,72,fall
2012-07-21,3,2,0,0,3,5,55,60,fall
2012-07-21,3,3,0,0,3,7,18,25,fall
2012-07-21,3,4,0,0,3,11,5,16,fall
2012-07-21,3,5,0,0,3,7,10,17,fall
2012-07-21,3,6,0,0,3,3,12,15,fall
2012-07-21,3,7,0,0,2,8,29,37,fall
2012-07-21,3,8,0,0,2,18,94,112,fall
2012-07-21,3,9,0,0,2,32,175,207,fall
2012-07-21,3,10,0,0,3,49,219,268,fall
2012-07-21,3,11,0,0,2,80,225,305,fall
2012-07-21,3,12,0,0,3,156,301,457,fall
2012-07-21,3,13,0,0,3,106,248,354,fall
2012-07-21,3,14,0,0,2,121,222,343,fall
2012-07-21,3,15,0,0,3,148,232,380,fall
2012-07-21,3,16,0,0,3,130,196,326,fall
2012-07-21,3,17,0,0,3,92,149,241,fall
2012-07-21,3,18,0,0,2,51,126,177,fall
2012-07-21,3,19,0,0,2,67,171,238,fall
2012-07-21,3,20,0,0,3,51,163,214,fall
2012-07-21,3,21,0,0,2,29,134,163,fall
2012-07-21,3,22,0,0,2,40,140,180,fall
2012-07-21,3,23,0,0,2,32,117,149,fall
2012-07-22,3,0,0,0,2,17,96,113,fall
2012-07-22,3,1,0,0,2,31,99,130,fall
2012-07-22,3,2,0,0,2,32,90,122,fall
2012-07-22,3,3,0,0,2,13,30,43,fall
2012-07-22,3,4,0,0,1,6,10,16,fall
2012-07-22,3,5,0,0,1,0,6,6,fall
2012-07-22,3,6,0,0,2,5,14,19,fall
2012-07-22,3,7,0,0,2,13,25,38,fall
2012-07-22,3,8,0,0,2,31,122,153,fall
2012-07-22,3,9,0,0,2,79,179,258,fall
2012-07-22,3,10,0,0,2,114,265,379,fall
2012-07-22,3,11,0,0,2,191,314,505,fall
2012-07-22,3,12,0,0,2,178,326,504,fall
2012-07-22,3,13,0,0,2,238,388,626,fall
2012-07-22,3,14,0,0,1,256,360,616,fall
2012-07-22,3,15,0,0,1,254,370,624,fall
2012-07-22,3,16,0,0,1,245,383,628,fall
2012-07-22,3,17,0,0,1,188,368,556,fall
2012-07-22,3,18,0,0,1,173,342,515,fall
2012-07-22,3,19,0,0,1,180,342,522,fall
2012-07-22,3,20,0,0,1,124,254,378,fall
2012-07-22,3,21,0,0,1,88,257,345,fall
2012-07-22,3,22,0,0,1,55,136,191,fall
2012-07-22,3,23,0,0,1,33,90,123,fall
2012-07-23,3,0,0,1,1,11,36,47,fall
2012-07-23,3,1,0,1,1,7,20,27,fall
2012-07-23,3,2,0,1,2,3,14,17,fall
2012-07-23,3,3,0,1,2,0,2,2,fall
2012-07-23,3,4,0,1,2,0,8,8,fall
2012-07-23,3,5,0,1,2,3,48,51,fall
2012-07-23,3,6,0,1,2,9,148,157,fall
2012-07-23,3,7,0,1,1,17,404,421,fall
2012-07-23,3,8,0,1,1,47,691,738,fall
2012-07-23,3,9,0,1,2,57,288,345,fall
2012-07-23,3,10,0,1,2,63,137,200,fall
2012-07-23,3,11,0,1,2,69,129,198,fall
2012-07-23,3,12,0,1,2,109,205,314,fall
2012-07-23,3,13,0,1,2,64,176,240,fall
2012-07-23,3,14,0,1,2,82,189,271,fall
2012-07-23,3,15,0,1,1,76,205,281,fall
2012-07-23,3,16,0,1,1,111,346,457,fall
2012-07-23,3,17,0,1,1,87,760,847,fall
2012-07-23,3,18,0,1,1,69,672,741,fall
2012-07-23,3,19,0,1,1,94,488,582,fall
2012-07-23,3,20,0,1,1,56,347,403,fall
2012-07-23,3,21,0,1,1,45,251,296,fall
2012-07-23,3,22,0,1,1,40,169,209,fall
2012-07-23,3,23,0,1,1,16,98,114,fall
2012-07-24,3,0,0,1,1,12,52,64,fall
2012-07-24,3,1,0,1,1,7,10,17,fall
2012-07-24,3,2,0,1,1,6,10,16,fall
2012-07-24,3,3,0,1,1,1,5,6,fall
2012-07-24,3,4,0,1,1,0,6,6,fall
2012-07-24,3,5,0,1,1,5,45,50,fall
2012-07-24,3,6,0,1,1,17,173,190,fall
2012-07-24,3,7,0,1,1,24,492,516,fall
2012-07-24,3,8,0,1,1,49,694,743,fall
2012-07-24,3,9,0,1,1,40,299,339,fall
2012-07-24,3,10,0,1,1,62,156,218,fall
2012-07-24,3,11,0,1,2,45,156,201,fall
2012-07-24,3,12,0,1,2,60,169,229,fall
2012-07-24,3,13,0,1,2,73,200,273,fall
2012-07-24,3,14,0,1,2,48,196,244,fall
2012-07-24,3,15,0,1,1,73,212,285,fall
2012-07-24,3,16,0,1,1,86,369,455,fall
2012-07-24,3,17,0,1,1,94,775,869,fall
2012-07-24,3,18,0,1,1,110,767,877,fall
2012-07-24,3,19,0,1,1,109,523,632,fall
2012-07-24,3,20,0,1,1,85,438,523,fall
2012-07-24,3,21,0,1,1,53,325,378,fall
2012-07-24,3,22,0,1,1,43,226,269,fall
2012-07-24,3,23,0,1,1,38,154,192,fall
2012-07-25,3,0,0,1,1,9,57,66,fall
2012-07-25,3,1,0,1,1,2,26,28,fall
2012-07-25,3,2,0,1,1,1,11,12,fall
2012-07-25,3,3,0,1,1,1,11,12,fall
2012-07-25,3,4,0,1,1,0,4,4,fall
2012-07-25,3,5,0,1,1,5,54,59,fall
2012-07-25,3,6,0,1,1,11,179,190,fall
2012-07-25,3,7,0,1,1,34,473,507,fall
2012-07-25,3,8,0,1,1,43,745,788,fall
2012-07-25,3,9,0,1,1,65,277,342,fall
2012-07-25,3,10,0,1,1,68,163,231,fall
2012-07-25,3,11,0,1,1,79,202,281,fall
2012-07-25,3,12,0,1,1,77,233,310,fall
2012-07-25,3,13,0,1,1,81,231,312,fall
2012-07-25,3,14,0,1,1,88,159,247,fall
2012-07-25,3,15,0,1,1,94,223,317,fall
2012-07-25,3,16,0,1,1,91,393,484,fall
2012-07-25,3,17,0,1,1,130,783,913,fall
2012-07-25,3,18,0,1,1,104,787,891,fall
2012-07-25,3,19,0,1,1,116,582,698,fall
2012-07-25,3,20,0,1,1,106,461,567,fall
2012-07-25,3,21,0,1,1,71,326,397,fall
2012-07-25,3,22,0,1,1,55,223,278,fall
2012-07-25,3,23,0,1,1,52,187,239,fall
2012-07-26,3,0,0,1,1,27,65,92,fall
2012-07-26,3,1,0,1,1,6,23,29,fall
2012-07-26,3,2,0,1,1,5,16,21,fall
2012-07-26,3,3,0,1,1,0,8,8,fall
2012-07-26,3,4,0,1,1,0,4,4,fall
2012-07-26,3,5,0,1,1,2,40,42,fall
2012-07-26,3,6,0,1,1,16,165,181,fall
2012-07-26,3,7,0,1,1,17,478,495,fall
2012-07-26,3,8,0,1,2,49,680,729,fall
2012-07-26,3,9,0,1,2,55,289,344,fall
2012-07-26,3,10,0,1,1,79,143,222,fall
2012-07-26,3,11,0,1,1,69,143,212,fall
2012-07-26,3,12,0,1,1,73,206,279,fall
2012-07-26,3,13,0,1,1,53,189,242,fall
2012-07-26,3,14,0,1,1,62,151,213,fall
2012-07-26,3,15,0,1,1,65,173,238,fall
2012-07-26,3,16,0,1,1,62,312,374,fall
2012-07-26,3,17,0,1,1,110,628,738,fall
2012-07-26,3,18,0,1,1,73,615,688,fall
2012-07-26,3,19,0,1,1,80,534,614,fall
2012-07-26,3,20,0,1,1,47,399,446,fall
2012-07-26,3,21,0,1,1,35,236,271,fall
2012-07-26,3,22,0,1,1,33,201,234,fall
2012-07-26,3,23,0,1,1,18,127,145,fall
2012-07-27,3,0,0,1,1,14,83,97,fall
2012-07-27,3,1,0,1,1,12,42,54,fall
2012-07-27,3,2,0,1,1,8,18,26,fall
2012-07-27,3,3,0,1,1,3,9,12,fall
2012-07-27,3,4,0,1,1,3,5,8,fall
2012-07-27,3,5,0,1,1,3,34,37,fall
2012-07-27,3,6,0,1,1,10,129,139,fall
2012-07-27,3,7,0,1,1,13,397,410,fall
2012-07-27,3,8,0,1,1,34,642,676,fall
2012-07-27,3,9,0,1,1,34,329,363,fall
2012-07-27,3,10,0,1,1,85,146,231,fall
2012-07-27,3,11,0,1,1,67,184,251,fall
2012-07-27,3,12,0,1,1,92,207,299,fall
2012-07-27,3,13,0,1,1,83,231,314,fall
2012-07-27,3,14,0,1,1,105,221,326,fall
2012-07-27,3,15,0,1,1,81,242,323,fall
2012-07-27,3,16,0,1,1,80,419,499,fall
2012-07-27,3,17,0,1,1,101,598,699,fall
2012-07-27,3,18,0,1,1,100,522,622,fall
2012-07-27,3,19,0,1,1,93,423,516,fall
2012-07-27,3,20,0,1,1,85,269,354,fall
2012-07-27,3,21,0,1,1,71,189,260,fall
2012-07-27,3,22,0,1,1,48,151,199,fall
2012-07-27,3,23,0,1,1,34,155,189,fall
2012-07-28,3,0,0,0,1,21,170,191,fall
2012-07-28,3,1,0,0,1,11,69,80,fall
2012-07-28,3,2,0,0,1,14,76,90,fall
2012-07-28,3,3,0,0,1,10,33,43,fall
2012-07-28,3,4,0,0,1,1,10,11,fall
2012-07-28,3,5,0,0,1,4,10,14,fall
2012-07-28,3,6,0,0,1,10,40,50,fall
2012-07-28,3,7,0,0,1,18,58,76,fall
2012-07-28,3,8,0,0,1,36,127,163,fall
2012-07-28,3,9,0,0,1,110,227,337,fall
2012-07-28,3,10,0,0,1,129,266,395,fall
2012-07-28,3,11,0,0,1,162,295,457,fall
2012-07-28,3,12,0,0,1,157,330,487,fall
2012-07-28,3,13,0,0,1,173,325,498,fall
2012-07-28,3,14,0,0,1,186,308,494,fall
2012-07-28,3,15,0,0,1,206,291,497,fall
2012-07-28,3,16,0,0,1,208,279,487,fall
2012-07-28,3,17,0,0,1,199,280,479,fall
2012-07-28,3,18,0,0,1,151,330,481,fall
2012-07-28,3,19,0,0,1,115,223,338,fall
2012-07-28,3,20,0,0,1,79,154,233,fall
2012-07-28,3,21,0,0,1,94,206,300,fall
2012-07-28,3,22,0,0,1,88,188,276,fall
2012-07-28,3,23,0,0,1,52,156,208,fall
2012-07-29,3,0,0,0,1,59,129,188,fall
2012-07-29,3,1,0,0,1,49,109,158,fall
2012-07-29,3,2,0,0,1,33,79,112,fall
2012-07-29,3,3,0,0,1,18,37,55,fall
2012-07-29,3,4,0,0,1,2,11,13,fall
2012-07-29,3,5,0,0,1,3,14,17,fall
2012-07-29,3,6,0,0,1,6,12,18,fall
2012-07-29,3,7,0,0,1,4,36,40,fall
2012-07-29,3,8,0,0,1,37,90,127,fall
2012-07-29,3,9,0,0,1,64,162,226,fall
2012-07-29,3,10,0,0,1,123,258,381,fall
2012-07-29,3,11,0,0,1,183,326,509,fall
2012-07-29,3,12,0,0,1,154,357,511,fall
2012-07-29,3,13,0,0,1,181,302,483,fall
2012-07-29,3,14,0,0,1,231,291,522,fall
2012-07-29,3,15,0,0,1,195,306,501,fall
2012-07-29,3,16,0,0,1,191,330,521,fall
2012-07-29,3,17,0,0,1,164,367,531,fall
2012-07-29,3,18,0,0,1,117,302,419,fall
2012-07-29,3,19,0,0,1,143,300,443,fall
2012-07-29,3,20,0,0,1,75,228,303,fall
2012-07-29,3,21,0,0,1,72,199,271,fall
2012-07-29,3,22,0,0,1,31,117,148,fall
2012-07-29,3,23,0,0,1,18,82,100,fall
2012-07-30,3,0,0,1,1,12,46,58,fall
2012-07-30,3,1,0,1,1,4,15,19,fall
2012-07-30,3,2,0,1,1,2,6,8,fall
2012-07-30,3,3,0,1,1,0,3,3,fall
2012-07-30,3,4,0,1,1,0,5,5,fall
2012-07-30,3,5,0,1,1,4,43,47,fall
2012-07-30,3,6,0,1,1,6,155,161,fall
2012-07-30,3,7,0,1,1,14,455,469,fall
2012-07-30,3,8,0,1,2,31,720,751,fall
2012-07-30,3,9,0,1,2,34,259,293,fall
2012-07-30,3,10,0,1,2,54,135,189,fall
2012-07-30,3,11,0,1,2,69,146,215,fall
2012-07-30,3,12,0,1,2,77,201,278,fall
2012-07-30,3,13,0,1,1,57,169,226,fall
2012-07-30,3,14,0,1,1,87,167,254,fall
2012-07-30,3,15,0,1,1,51,185,236,fall
2012-07-30,3,16,0,1,1,88,337,425,fall
2012-07-30,3,17,0,1,1,62,765,827,fall
2012-07-30,3,18,0,1,1,77,735,812,fall
2012-07-30,3,19,0,1,1,81,584,665,fall
2012-07-30,3,20,0,1,1,78,384,462,fall
2012-07-30,3,21,0,1,1,71,251,322,fall
2012-07-30,3,22,0,1,2,47,183,230,fall
2012-07-30,3,23,0,1,1,34,116,150,fall
2012-07-31,3,0,0,1,1,11,27,38,fall
2012-07-31,3,1,0,1,1,3,18,21,fall
2012-07-31,3,2,0,1,1,0,8,8,fall
2012-07-31,3,3,0,1,1,1,5,6,fall
2012-07-31,3,4,0,1,1,0,6,6,fall
2012-07-31,3,5,0,1,1,5,40,45,fall
2012-07-31,3,6,0,1,1,2,192,194,fall
2012-07-31,3,7,0,1,1,21,492,513,fall
2012-07-31,3,8,0,1,1,30,730,760,fall
2012-07-31,3,9,0,1,1,31,302,333,fall
2012-07-31,3,10,0,1,1,73,154,227,fall
2012-07-31,3,11,0,1,1,54,170,224,fall
2012-07-31,3,12,0,1,1,50,198,248,fall
2012-07-31,3,13,0,1,1,69,219,288,fall
2012-07-31,3,14,0,1,1,72,188,260,fall
2012-07-31,3,15,0,1,1,29,115,144,fall
2012-07-31,3,16,0,1,1,66,336,402,fall
2012-07-31,3,17,0,1,1,94,726,820,fall
2012-07-31,3,18,0,1,1,99,758,857,fall
2012-07-31,3,19,0,1,3,90,524,614,fall
2012-07-31,3,20,0,1,3,55,397,452,fall
2012-07-31,3,21,0,1,1,60,292,352,fall
2012-07-31,3,22,0,1,1,33,224,257,fall
2012-07-31,3,23,0,1,2,20,127,147,fall
2012-08-01,3,0,0,1,1,3,44,47,fall
2012-08-01,3,1,0,1,1,5,28,33,fall
2012-08-01,3,2,0,1,1,0,13,13,fall
2012-08-01,3,3,0,1,1,0,7,7,fall
2012-08-01,3,4,0,1,2,1,3,4,fall
2012-08-01,3,5,0,1,2,3,46,49,fall
2012-08-01,3,6,0,1,1,6,179,185,fall
2012-08-01,3,7,0,1,2,19,468,487,fall
2012-08-01,3,8,0,1,2,32,649,681,fall
2012-08-01,3,9,0,1,2,34,316,350,fall
2012-08-01,3,10,0,1,1,61,175,236,fall
2012-08-01,3,11,0,1,1,54,180,234,fall
2012-08-01,3,12,0,1,1,75,209,284,fall
2012-08-01,3,13,0,1,1,59,221,280,fall
2012-08-01,3,14,0,1,1,88,175,263,fall
2012-08-01,3,15,0,1,1,89,206,295,fall
2012-08-01,3,16,0,1,1,93,386,479,fall
2012-08-01,3,17,0,1,1,103,734,837,fall
2012-08-01,3,18,0,1,3,105,786,891,fall
2012-08-01,3,19,0,1,1,88,564,652,fall
2012-08-01,3,20,0,1,1,65,448,513,fall
2012-08-01,3,21,0,1,1,36,284,320,fall
2012-08-01,3,22,0,1,1,37,251,288,fall
2012-08-01,3,23,0,1,1,18,134,152,fall
2012-08-02,3,0,0,1,1,8,55,63,fall
2012-08-02,3,1,0,1,1,6,36,42,fall
2012-08-02,3,2,0,1,1,3,8,11,fall
2012-08-02,3,3,0,1,1,0,6,6,fall
2012-08-02,3,4,0,1,1,0,9,9,fall
2012-08-02,3,5,0,1,1,4,37,41,fall
2012-08-02,3,6,0,1,1,6,177,183,fall
2012-08-02,3,7,0,1,1,21,452,473,fall
2012-08-02,3,8,0,1,1,21,718,739,fall
2012-08-02,3,9,0,1,1,31,312,343,fall
2012-08-02,3,10,0,1,1,51,130,181,fall
2012-08-02,3,11,0,1,1,59,167,226,fall
2012-08-02,3,12,0,1,1,56,230,286,fall
2012-08-02,3,13,0,1,1,98,212,310,fall
2012-08-02,3,14,0,1,1,54,171,225,fall
2012-08-02,3,15,0,1,1,68,202,270,fall
2012-08-02,3,16,0,1,1,71,335,406,fall
2012-08-02,3,17,0,1,1,90,775,865,fall
2012-08-02,3,18,0,1,1,86,681,767,fall
2012-08-02,3,19,0,1,1,98,509,607,fall
2012-08-02,3,20,0,1,1,51,376,427,fall
2012-08-02,3,21,0,1,1,41,301,342,fall
2012-08-02,3,22,0,1,1,35,227,262,fall
2012-08-02,3,23,0,1,1,25,152,177,fall
2012-08-03,3,0,0,1,1,15,56,71,fall
2012-08-03,3,1,0,1,1,11,32,43,fall
2012-08-03,3,2,0,1,1,0,14,14,fall
2012-08-03,3,3,0,1,1,1,5,6,fall
2012-08-03,3,4,0,1,1,1,11,12,fall
2012-08-03,3,5,0,1,1,2,35,37,fall
2012-08-03,3,6,0,1,1,5,158,163,fall
2012-08-03,3,7,0,1,1,25,396,421,fall
2012-08-03,3,8,0,1,1,32,636,668,fall
2012-08-03,3,9,0,1,2,69,327,396,fall
2012-08-03,3,10,0,1,2,82,167,249,fall
2012-08-03,3,11,0,1,2,77,186,263,fall
2012-08-03,3,12,0,1,2,95,243,338,fall
2012-08-03,3,13,0,1,2,98,247,345,fall
2012-08-03,3,14,0,1,2,102,229,331,fall
2012-08-03,3,15,0,1,1,112,268,380,fall
2012-08-03,3,16,0,1,2,112,380,492,fall
2012-08-03,3,17,0,1,2,95,646,741,fall
2012-08-03,3,18,0,1,2,98,573,671,fall
2012-08-03,3,19,0,1,2,81,388,469,fall
2012-08-03,3,20,0,1,2,89,300,389,fall
2012-08-03,3,21,0,1,2,54,224,278,fall
2012-08-03,3,22,0,1,1,46,156,202,fall
2012-08-03,3,23,0,1,1,26,170,196,fall
2012-08-04,3,0,0,0,1,24,137,161,fall
2012-08-04,3,1,0,0,1,23,99,122,fall
2012-08-04,3,2,0,0,1,20,64,84,fall
2012-08-04,3,3,0,0,1,11,19,30,fall
2012-08-04,3,4,0,0,1,2,11,13,fall
2012-08-04,3,5,0,0,1,1,16,17,fall
2012-08-04,3,6,0,0,1,12,37,49,fall
2012-08-04,3,7,0,0,1,18,49,67,fall
2012-08-04,3,8,0,0,1,49,132,181,fall
2012-08-04,3,9,0,0,1,61,217,278,fall
2012-08-04,3,10,0,0,1,108,288,396,fall
2012-08-04,3,11,0,0,1,155,315,470,fall
2012-08-04,3,12,0,0,1,222,325,547,fall
2012-08-04,3,13,0,0,1,195,332,527,fall
2012-08-04,3,14,0,0,1,183,289,472,fall
2012-08-04,3,15,0,0,1,205,284,489,fall
2012-08-04,3,16,0,0,1,197,253,450,fall
2012-08-04,3,17,0,0,1,179,313,492,fall
2012-08-04,3,18,0,0,1,169,321,490,fall
2012-08-04,3,19,0,0,1,133,264,397,fall
2012-08-04,3,20,0,0,1,117,195,312,fall
2012-08-04,3,21,0,0,1,96,193,289,fall
2012-08-04,3,22,0,0,1,104,165,269,fall
2012-08-04,3,23,0,0,1,61,161,222,fall
2012-08-05,3,0,0,0,1,32,121,153,fall
2012-08-05,3,1,0,0,1,8,79,87,fall
2012-08-05,3,2,0,0,1,5,68,73,fall
2012-08-05,3,3,0,0,1,9,32,41,fall
2012-08-05,3,4,0,0,1,3,11,14,fall
2012-08-05,3,5,0,0,1,1,18,19,fall
2012-08-05,3,6,0,0,1,7,12,19,fall
2012-08-05,3,7,0,0,1,18,50,68,fall
2012-08-05,3,8,0,0,1,27,81,108,fall
2012-08-05,3,9,0,0,1,61,168,229,fall
2012-08-05,3,10,0,0,1,111,253,364,fall
2012-08-05,3,11,0,0,1,155,282,437,fall
2012-08-05,3,12,0,0,1,161,330,491,fall
2012-08-05,3,13,0,0,1,208,315,523,fall
2012-08-05,3,14,0,0,1,161,365,526,fall
2012-08-05,3,15,0,0,1,164,286,450,fall
2012-08-05,3,16,0,0,1,143,278,421,fall
2012-08-05,3,17,0,0,1,122,260,382,fall
2012-08-05,3,18,0,0,3,75,154,229,fall
2012-08-05,3,19,0,0,1,46,139,185,fall
2012-08-05,3,20,0,0,1,53,140,193,fall
2012-08-05,3,21,0,0,1,51,157,208,fall
2012-08-05,3,22,0,0,1,57,100,157,fall
2012-08-05,3,23,0,0,2,29,58,87,fall
2012-08-06,3,0,0,1,2,9,24,33,fall
2012-08-06,3,1,0,1,1,1,10,11,fall
2012-08-06,3,2,0,1,2,0,5,5,fall
2012-08-06,3,3,0,1,3,0,5,5,fall
2012-08-06,3,4,0,1,2,3,8,11,fall
2012-08-06,3,5,0,1,1,2,23,25,fall
2012-08-06,3,6,0,1,2,4,137,141,fall
2012-08-06,3,7,0,1,3,14,393,407,fall
2012-08-06,3,8,0,1,2,27,578,605,fall
2012-08-06,3,9,0,1,3,28,248,276,fall
2012-08-06,3,10,0,1,1,54,159,213,fall
2012-08-06,3,11,0,1,1,108,152,260,fall
2012-08-06,3,12,0,1,2,72,213,285,fall
2012-08-06,3,13,0,1,1,85,204,289,fall
2012-08-06,3,14,0,1,1,99,188,287,fall
2012-08-06,3,15,0,1,1,91,183,274,fall
2012-08-06,3,16,0,1,1,88,363,451,fall
2012-08-06,3,17,0,1,1,112,746,858,fall
2012-08-06,3,18,0,1,1,100,743,843,fall
2012-08-06,3,19,0,1,1,109,531,640,fall
2012-08-06,3,20,0,1,1,89,368,457,fall
2012-08-06,3,21,0,1,1,72,245,317,fall
2012-08-06,3,22,0,1,1,50,157,207,fall
2012-08-06,3,23,0,1,1,16,97,113,fall
2012-08-07,3,0,0,1,1,15,32,47,fall
2012-08-07,3,1,0,1,1,2,16,18,fall
2012-08-07,3,2,0,1,1,6,7,13,fall
2012-08-07,3,3,0,1,1,0,6,6,fall
2012-08-07,3,4,0,1,1,2,7,9,fall
2012-08-07,3,5,0,1,1,3,33,36,fall
2012-08-07,3,6,0,1,2,3,176,179,fall
2012-08-07,3,7,0,1,2,21,481,502,fall
2012-08-07,3,8,0,1,2,41,664,705,fall
2012-08-07,3,9,0,1,2,44,283,327,fall
2012-08-07,3,10,0,1,2,89,161,250,fall
2012-08-07,3,11,0,1,2,84,130,214,fall
2012-08-07,3,12,0,1,2,86,197,283,fall
2012-08-07,3,13,0,1,2,68,185,253,fall
2012-08-07,3,14,0,1,2,76,185,261,fall
2012-08-07,3,15,0,1,1,100,206,306,fall
2012-08-07,3,16,0,1,3,101,344,445,fall
2012-08-07,3,17,0,1,2,125,743,868,fall
2012-08-07,3,18,0,1,2,103,711,814,fall
2012-08-07,3,19,0,1,2,104,506,610,fall
2012-08-07,3,20,0,1,2,74,374,448,fall
2012-08-07,3,21,0,1,2,70,247,317,fall
2012-08-07,3,22,0,1,1,43,181,224,fall
2012-08-07,3,23,0,1,1,18,120,138,fall
2012-08-08,3,0,0,1,1,12,46,58,fall
2012-08-08,3,1,0,1,1,3,20,23,fall
2012-08-08,3,2,0,1,1,1,5,6,fall
2012-08-08,3,3,0,1,1,1,6,7,fall
2012-08-08,3,4,0,1,1,1,6,7,fall
2012-08-08,3,5,0,1,2,3,40,43,fall
2012-08-08,3,6,0,1,2,4,169,173,fall
2012-08-08,3,7,0,1,2,24,458,482,fall
2012-08-08,3,8,0,1,2,48,689,737,fall
2012-08-08,3,9,0,1,2,33,308,341,fall
2012-08-08,3,10,0,1,2,63,151,214,fall
2012-08-08,3,11,0,1,2,80,159,239,fall
2012-08-08,3,12,0,1,2,63,217,280,fall
2012-08-08,3,13,0,1,2,101,212,313,fall
2012-08-08,3,14,0,1,2,63,173,236,fall
2012-08-08,3,15,0,1,2,110,168,278,fall
2012-08-08,3,16,0,1,2,113,328,441,fall
2012-08-08,3,17,0,1,2,107,751,858,fall
2012-08-08,3,18,0,1,2,117,745,862,fall
2012-08-08,3,19,0,1,1,119,567,686,fall
2012-08-08,3,20,0,1,1,76,424,500,fall
2012-08-08,3,21,0,1,1,70,311,381,fall
2012-08-08,3,22,0,1,1,35,198,233,fall
2012-08-08,3,23,0,1,1,16,120,136,fall
2012-08-09,3,0,0,1,1,16,51,67,fall
2012-08-09,3,1,0,1,1,5,23,28,fall
2012-08-09,3,2,0,1,1,2,12,14,fall
2012-08-09,3,3,0,1,1,1,5,6,fall
2012-08-09,3,4,0,1,2,0,10,10,fall
2012-08-09,3,5,0,1,2,4,37,41,fall
2012-08-09,3,6,0,1,1,5,162,167,fall
2012-08-09,3,7,0,1,2,24,451,475,fall
2012-08-09,3,8,0,1,1,28,670,698,fall
2012-08-09,3,9,0,1,1,54,299,353,fall
2012-08-09,3,10,0,1,1,72,133,205,fall
2012-08-09,3,11,0,1,1,94,166,260,fall
2012-08-09,3,12,0,1,1,85,192,277,fall
2012-08-09,3,13,0,1,1,80,201,281,fall
2012-08-09,3,14,0,1,1,86,161,247,fall
2012-08-09,3,15,0,1,1,63,204,267,fall
2012-08-09,3,16,0,1,1,97,320,417,fall
2012-08-09,3,17,0,1,1,111,699,810,fall
2012-08-09,3,18,0,1,2,78,733,811,fall
2012-08-09,3,19,0,1,1,90,533,623,fall
2012-08-09,3,20,0,1,1,91,387,478,fall
2012-08-09,3,21,0,1,2,50,286,336,fall
2012-08-09,3,22,0,1,2,41,218,259,fall
2012-08-09,3,23,0,1,1,19,137,156,fall
2012-08-10,3,0,0,1,1,17,68,85,fall
2012-08-10,3,1,0,1,1,6,35,41,fall
2012-08-10,3,2,0,1,1,6,14,20,fall
2012-08-10,3,3,0,1,2,3,6,9,fall
2012-08-10,3,4,0,1,3,0,7,7,fall
2012-08-10,3,5,0,1,3,4,29,33,fall
2012-08-10,3,6,0,1,3,3,41,44,fall
2012-08-10,3,7,0,1,3,5,128,133,fall
2012-08-10,3,8,0,1,3,7,112,119,fall
2012-08-10,3,9,0,1,2,21,199,220,fall
2012-08-10,3,10,0,1,1,27,166,193,fall
2012-08-10,3,11,0,1,3,73,178,251,fall
2012-08-10,3,12,0,1,2,75,240,315,fall
2012-08-10,3,13,0,1,2,66,224,290,fall
2012-08-10,3,14,0,1,1,71,236,307,fall
2012-08-10,3,15,0,1,1,100,224,324,fall
2012-08-10,3,16,0,1,1,96,371,467,fall
2012-08-10,3,17,0,1,1,111,619,730,fall
2012-08-10,3,18,0,1,1,88,552,640,fall
2012-08-10,3,19,0,1,1,98,394,492,fall
2012-08-10,3,20,0,1,1,55,315,370,fall
2012-08-10,3,21,0,1,1,50,236,286,fall
2012-08-10,3,22,0,1,1,50,168,218,fall
2012-08-10,3,23,0,1,1,33,159,192,fall
2012-08-11,3,0,0,0,1,38,142,180,fall
2012-08-11,3,1,0,0,1,32,84,116,fall
2012-08-11,3,2,0,0,3,19,66,85,fall
2012-08-11,3,3,0,0,3,2,19,21,fall
2012-08-11,3,4,0,0,1,3,7,10,fall
2012-08-11,3,5,0,0,1,2,9,11,fall
2012-08-11,3,6,0,0,2,5,18,23,fall
2012-08-11,3,7,0,0,1,8,54,62,fall
2012-08-11,3,8,0,0,1,30,132,162,fall
2012-08-11,3,9,0,0,1,54,217,271,fall
2012-08-11,3,10,0,0,1,125,282,407,fall
2012-08-11,3,11,0,0,1,203,296,499,fall
2012-08-11,3,12,0,0,1,214,332,546,fall
2012-08-11,3,13,0,0,1,228,341,569,fall
2012-08-11,3,14,0,0,1,248,290,538,fall
2012-08-11,3,15,0,0,1,246,316,562,fall
2012-08-11,3,16,0,0,1,227,304,531,fall
2012-08-11,3,17,0,0,3,220,292,512,fall
2012-08-11,3,18,0,0,2,107,193,300,fall
2012-08-11,3,19,0,0,2,97,178,275,fall
2012-08-11,3,20,0,0,3,31,129,160,fall
2012-08-11,3,21,0,0,2,26,102,128,fall
2012-08-11,3,22,0,0,2,40,128,168,fall
2012-08-11,3,23,0,0,3,42,121,163,fall
2012-08-12,3,0,0,0,2,24,96,120,fall
2012-08-12,3,1,0,0,1,21,92,113,fall
2012-08-12,3,2,0,0,1,19,67,86,fall
2012-08-12,3,3,0,0,1,11,37,48,fall
2012-08-12,3,4,0,0,1,2,8,10,fall
2012-08-12,3,5,0,0,1,1,9,10,fall
2012-08-12,3,6,0,0,1,2,14,16,fall
2012-08-12,3,7,0,0,1,9,30,39,fall
2012-08-12,3,8,0,0,1,35,84,119,fall
2012-08-12,3,9,0,0,1,64,153,217,fall
2012-08-12,3,10,0,0,1,88,240,328,fall
2012-08-12,3,11,0,0,1,167,282,449,fall
2012-08-12,3,12,0,0,1,163,342,505,fall
2012-08-12,3,13,0,0,1,178,365,543,fall
2012-08-12,3,14,0,0,1,213,366,579,fall
2012-08-12,3,15,0,0,1,235,342,577,fall
2012-08-12,3,16,0,0,1,213,300,513,fall
2012-08-12,3,17,0,0,1,186,319,505,fall
2012-08-12,3,18,0,0,1,164,327,491,fall
2012-08-12,3,19,0,0,1,148,317,465,fall
2012-08-12,3,20,0,0,1,96,204,300,fall
2012-08-12,3,21,0,0,1,78,142,220,fall
2012-08-12,3,22,0,0,1,40,141,181,fall
2012-08-12,3,23,0,0,1,25,85,110,fall
2012-08-13,3,0,0,1,1,14,33,47,fall
2012-08-13,3,1,0,1,1,3,11,14,fall
2012-08-13,3,2,0,1,1,1,8,9,fall
2012-08-13,3,3,0,1,1,1,5,6,fall
2012-08-13,3,4,0,1,1,0,11,11,fall
2012-08-13,3,5,0,1,1,3,33,36,fall
2012-08-13,3,6,0,1,1,4,155,159,fall
2012-08-13,3,7,0,1,1,11,425,436,fall
2012-08-13,3,8,0,1,2,25,648,673,fall
2012-08-13,3,9,0,1,2,40,265,305,fall
2012-08-13,3,10,0,1,2,88,111,199,fall
2012-08-13,3,11,0,1,1,94,151,245,fall
2012-08-13,3,12,0,1,1,96,180,276,fall
2012-08-13,3,13,0,1,1,79,175,254,fall
2012-08-13,3,14,0,1,1,85,163,248,fall
2012-08-13,3,15,0,1,1,80,194,274,fall
2012-08-13,3,16,0,1,1,116,348,464,fall
2012-08-13,3,17,0,1,1,102,716,818,fall
2012-08-13,3,18,0,1,1,103,709,812,fall
2012-08-13,3,19,0,1,1,88,467,555,fall
2012-08-13,3,20,0,1,1,58,374,432,fall
2012-08-13,3,21,0,1,1,44,246,290,fall
2012-08-13,3,22,0,1,1,44,148,192,fall
2012-08-13,3,23,0,1,1,28,100,128,fall
2012-08-14,3,0,0,1,1,12,48,60,fall
2012-08-14,3,1,0,1,1,8,19,27,fall
2012-08-14,3,2,0,1,2,2,9,11,fall
2012-08-14,3,3,0,1,2,0,3,3,fall
2012-08-14,3,4,0,1,2,0,5,5,fall
2012-08-14,3,5,0,1,2,1,35,36,fall
2012-08-14,3,6,0,1,3,1,63,64,fall
2012-08-14,3,7,0,1,2,1,178,179,fall
2012-08-14,3,8,0,1,2,27,591,618,fall
2012-08-14,3,9,0,1,2,48,354,402,fall
2012-08-14,3,10,0,1,1,53,155,208,fall
2012-08-14,3,11,0,1,1,69,127,196,fall
2012-08-14,3,12,0,1,1,93,207,300,fall
2012-08-14,3,13,0,1,1,83,203,286,fall
2012-08-14,3,14,0,1,1,80,175,255,fall
2012-08-14,3,15,0,1,1,84,199,283,fall
2012-08-14,3,16,0,1,1,95,363,458,fall
2012-08-14,3,17,0,1,3,78,734,812,fall
2012-08-14,3,18,0,1,1,97,757,854,fall
2012-08-14,3,19,0,1,1,94,533,627,fall
2012-08-14,3,20,0,1,1,65,371,436,fall
2012-08-14,3,21,0,1,1,56,252,308,fall
2012-08-14,3,22,0,1,1,28,161,189,fall
2012-08-14,3,23,0,1,1,53,114,167,fall
2012-08-15,3,0,0,1,1,8,52,60,fall
2012-08-15,3,1,0,1,1,6,31,37,fall
2012-08-15,3,2,0,1,1,1,7,8,fall
2012-08-15,3,3,0,1,1,1,10,11,fall
2012-08-15,3,4,0,1,1,0,4,4,fall
2012-08-15,3,5,0,1,1,4,35,39,fall
2012-08-15,3,6,0,1,1,12,160,172,fall
2012-08-15,3,7,0,1,2,25,467,492,fall
2012-08-15,3,8,0,1,2,40,642,682,fall
2012-08-15,3,9,0,1,2,57,310,367,fall
2012-08-15,3,10,0,1,2,70,163,233,fall
2012-08-15,3,11,0,1,2,80,155,235,fall
2012-08-15,3,12,0,1,1,77,230,307,fall
2012-08-15,3,13,0,1,2,88,206,294,fall
2012-08-15,3,14,0,1,2,94,161,255,fall
2012-08-15,3,15,0,1,1,70,196,266,fall
2012-08-15,3,16,0,1,1,91,340,431,fall
2012-08-15,3,17,0,1,1,102,749,851,fall
2012-08-15,3,18,0,1,1,80,768,848,fall
2012-08-15,3,19,0,1,1,124,525,649,fall
2012-08-15,3,20,0,1,1,72,355,427,fall
2012-08-15,3,21,0,1,1,49,266,315,fall
2012-08-15,3,22,0,1,1,29,197,226,fall
2012-08-15,3,23,0,1,1,18,120,138,fall
2012-08-16,3,0,0,1,1,13,63,76,fall
2012-08-16,3,1,0,1,1,3,18,21,fall
2012-08-16,3,2,0,1,1,0,15,15,fall
2012-08-16,3,3,0,1,1,0,4,4,fall
2012-08-16,3,4,0,1,1,2,3,5,fall
2012-08-16,3,5,0,1,1,7,30,37,fall
2012-08-16,3,6,0,1,1,3,162,165,fall
2012-08-16,3,7,0,1,1,16,448,464,fall
2012-08-16,3,8,0,1,1,33,649,682,fall
2012-08-16,3,9,0,1,1,41,296,337,fall
2012-08-16,3,10,0,1,1,78,121,199,fall
2012-08-16,3,11,0,1,1,83,191,274,fall
2012-08-16,3,12,0,1,1,96,247,343,fall
2012-08-16,3,13,0,1,1,81,219,300,fall
2012-08-16,3,14,0,1,1,72,176,248,fall
2012-08-16,3,15,0,1,1,63,197,260,fall
2012-08-16,3,16,0,1,1,79,340,419,fall
2012-08-16,3,17,0,1,1,130,767,897,fall
2012-08-16,3,18,0,1,1,109,723,832,fall
2012-08-16,3,19,0,1,1,119,558,677,fall
2012-08-16,3,20,0,1,1,100,414,514,fall
2012-08-16,3,21,0,1,1,83,273,356,fall
2012-08-16,3,22,0,1,1,69,185,254,fall
2012-08-16,3,23,0,1,1,58,168,226,fall
2012-08-17,3,0,0,1,1,21,67,88,fall
2012-08-17,3,1,0,1,1,16,38,54,fall
2012-08-17,3,2,0,1,1,4,15,19,fall
2012-08-17,3,3,0,1,1,0,6,6,fall
2012-08-17,3,4,0,1,1,0,9,9,fall
2012-08-17,3,5,0,1,1,2,34,36,fall
2012-08-17,3,6,0,1,1,6,151,157,fall
2012-08-17,3,7,0,1,1,11,368,379,fall
2012-08-17,3,8,0,1,1,43,625,668,fall
2012-08-17,3,9,0,1,1,58,320,378,fall
2012-08-17,3,10,0,1,1,82,149,231,fall
2012-08-17,3,11,0,1,1,98,205,303,fall
2012-08-17,3,12,0,1,1,110,255,365,fall
2012-08-17,3,13,0,1,1,103,254,357,fall
2012-08-17,3,14,0,1,1,128,200,328,fall
2012-08-17,3,15,0,1,1,127,256,383,fall
2012-08-17,3,16,0,1,2,116,372,488,fall
2012-08-17,3,17,0,1,1,144,647,791,fall
2012-08-17,3,18,0,1,2,108,561,669,fall
2012-08-17,3,19,0,1,2,88,403,491,fall
2012-08-17,3,20,0,1,2,97,262,359,fall
2012-08-17,3,21,0,1,2,57,198,255,fall
2012-08-17,3,22,0,1,3,43,170,213,fall
2012-08-17,3,23,0,1,3,21,100,121,fall
2012-08-18,3,0,0,0,2,6,99,105,fall
2012-08-18,3,1,0,0,3,14,78,92,fall
2012-08-18,3,2,0,0,3,4,39,43,fall
2012-08-18,3,3,0,0,1,7,23,30,fall
2012-08-18,3,4,0,0,1,5,8,13,fall
2012-08-18,3,5,0,0,1,2,7,9,fall
2012-08-18,3,6,0,0,1,4,23,27,fall
2012-08-18,3,7,0,0,1,12,52,64,fall
2012-08-18,3,8,0,0,1,28,161,189,fall
2012-08-18,3,9,0,0,1,81,211,292,fall
2012-08-18,3,10,0,0,1,166,314,480,fall
2012-08-18,3,11,0,0,1,180,356,536,fall
2012-08-18,3,12,0,0,1,266,388,654,fall
2012-08-18,3,13,0,0,1,289,355,644,fall
2012-08-18,3,14,0,0,1,242,356,598,fall
2012-08-18,3,15,0,0,1,250,346,596,fall
2012-08-18,3,16,0,0,1,287,354,641,fall
2012-08-18,3,17,0,0,1,256,379,635,fall
2012-08-18,3,18,0,0,1,225,329,554,fall
2012-08-18,3,19,0,0,1,164,324,488,fall
2012-08-18,3,20,0,0,1,99,242,341,fall
2012-08-18,3,21,0,0,1,90,248,338,fall
2012-08-18,3,22,0,0,1,90,171,261,fall
2012-08-18,3,23,0,0,1,60,175,235,fall
2012-08-19,3,0,0,0,1,44,143,187,fall
2012-08-19,3,1,0,0,1,29,102,131,fall
2012-08-19,3,2,0,0,2,16,103,119,fall
2012-08-19,3,3,0,0,2,21,34,55,fall
2012-08-19,3,4,0,0,2,4,22,26,fall
2012-08-19,3,5,0,0,2,3,8,11,fall
2012-08-19,3,6,0,0,2,5,15,20,fall
2012-08-19,3,7,0,0,2,12,29,41,fall
2012-08-19,3,8,0,0,2,34,90,124,fall
2012-08-19,3,9,0,0,2,86,184,270,fall
2012-08-19,3,10,0,0,2,138,287,425,fall
2012-08-19,3,11,0,0,3,83,189,272,fall
2012-08-19,3,12,0,0,3,112,186,298,fall
2012-08-19,3,13,0,0,3,50,112,162,fall
2012-08-19,3,14,0,0,3,41,108,149,fall
2012-08-19,3,15,0,0,2,89,187,276,fall
2012-08-19,3,16,0,0,2,97,259,356,fall
2012-08-19,3,17,0,0,2,76,267,343,fall
2012-08-19,3,18,0,0,2,86,291,377,fall
2012-08-19,3,19,0,0,2,72,269,341,fall
2012-08-19,3,20,0,0,2,61,213,274,fall
2012-08-19,3,21,0,0,3,36,154,190,fall
2012-08-19,3,22,0,0,2,6,50,56,fall
2012-08-19,3,23,0,0,2,7,39,46,fall
2012-08-20,3,0,0,1,2,1,25,26,fall
2012-08-20,3,1,0,1,1,0,10,10,fall
2012-08-20,3,2,0,1,1,0,5,5,fall
2012-08-20,3,3,0,1,1,0,3,3,fall
2012-08-20,3,4,0,1,2,0,7,7,fall
2012-08-20,3,5,0,1,2,2,35,37,fall
2012-08-20,3,6,0,1,2,6,155,161,fall
2012-08-20,3,7,0,1,2,15,427,442,fall
2012-08-20,3,8,0,1,2,37,618,655,fall
2012-08-20,3,9,0,1,2,55,302,357,fall
2012-08-20,3,10,0,1,2,69,124,193,fall
2012-08-20,3,11,0,1,1,90,151,241,fall
2012-08-20,3,12,0,1,2,66,216,282,fall
2012-08-20,3,13,0,1,1,97,194,291,fall
2012-08-20,3,14,0,1,1,87,188,275,fall
2012-08-20,3,15,0,1,1,102,207,309,fall
2012-08-20,3,16,0,1,1,103,357,460,fall
2012-08-20,3,17,0,1,1,83,810,893,fall
2012-08-20,3,18,0,1,2,89,726,815,fall
2012-08-20,3,19,0,1,2,33,266,299,fall
2012-08-20,3,20,0,1,2,30,231,261,fall
2012-08-20,3,21,0,1,1,26,219,245,fall
2012-08-20,3,22,0,1,2,25,136,161,fall
2012-08-20,3,23,0,1,2,10,92,102,fall
2012-08-21,3,0,0,1,2,7,52,59,fall
2012-08-21,3,1,0,1,2,11,22,33,fall
2012-08-21,3,2,0,1,2,1,7,8,fall
2012-08-21,3,3,0,1,1,0,3,3,fall
2012-08-21,3,4,0,1,1,0,4,4,fall
2012-08-21,3,5,0,1,1,4,30,34,fall
2012-08-21,3,6,0,1,1,5,164,169,fall
2012-08-21,3,7,0,1,1,19,500,519,fall
2012-08-21,3,8,0,1,1,27,696,723,fall
2012-08-21,3,9,0,1,1,47,281,328,fall
2012-08-21,3,10,0,1,1,58,120,178,fall
2012-08-21,3,11,0,1,1,61,195,256,fall
2012-08-21,3,12,0,1,1,79,226,305,fall
2012-08-21,3,13,0,1,1,76,255,331,fall
2012-08-21,3,14,0,1,1,110,192,302,fall
2012-08-21,3,15,0,1,1,76,226,302,fall
2012-08-21,3,16,0,1,1,109,358,467,fall
2012-08-21,3,17,0,1,1,92,786,878,fall
2012-08-21,3,18,0,1,1,93,532,625,fall
2012-08-21,3,19,0,1,3,56,420,476,fall
2012-08-21,3,20,0,1,1,62,296,358,fall
2012-08-21,3,21,0,1,1,41,239,280,fall
2012-08-21,3,22,0,1,1,24,208,232,fall
2012-08-21,3,23,0,1,1,23,113,136,fall
2012-08-22,3,0,0,1,1,9,46,55,fall
2012-08-22,3,1,0,1,1,1,20,21,fall
2012-08-22,3,2,0,1,1,7,10,17,fall
2012-08-22,3,3,0,1,1,0,7,7,fall
2012-08-22,3,4,0,1,1,1,7,8,fall
2012-08-22,3,5,0,1,1,2,38,40,fall
2012-08-22,3,6,0,1,1,12,175,187,fall
2012-08-22,3,7,0,1,1,16,537,553,fall
2012-08-22,3,8,0,1,1,37,703,740,fall
2012-08-22,3,9,0,1,1,41,335,376,fall
2012-08-22,3,10,0,1,1,66,159,225,fall
2012-08-22,3,11,0,1,1,71,196,267,fall
2012-08-22,3,12,0,1,1,59,253,312,fall
2012-08-22,3,13,0,1,1,74,242,316,fall
2012-08-22,3,14,0,1,1,82,184,266,fall
2012-08-22,3,15,0,1,1,94,222,316,fall
2012-08-22,3,16,0,1,3,102,358,460,fall
2012-08-22,3,17,0,1,3,72,711,783,fall
2012-08-22,3,18,0,1,3,91,592,683,fall
2012-08-22,3,19,0,1,2,56,524,580,fall
2012-08-22,3,20,0,1,1,59,332,391,fall
2012-08-22,3,21,0,1,1,60,291,351,fall
2012-08-22,3,22,0,1,1,55,226,281,fall
2012-08-22,3,23,0,1,1,27,113,140,fall
2012-08-23,3,0,0,1,1,9,51,60,fall
2012-08-23,3,1,0,1,1,10,15,25,fall
2012-08-23,3,2,0,1,1,9,11,20,fall
2012-08-23,3,3,0,1,1,3,6,9,fall
2012-08-23,3,4,0,1,1,0,6,6,fall
2012-08-23,3,5,0,1,1,1,36,37,fall
2012-08-23,3,6,0,1,2,14,178,192,fall
2012-08-23,3,7,0,1,2,18,463,481,fall
2012-08-23,3,8,0,1,2,45,662,707,fall
2012-08-23,3,9,0,1,2,58,354,412,fall
2012-08-23,3,10,0,1,1,76,157,233,fall
2012-08-23,3,11,0,1,1,86,192,278,fall
2012-08-23,3,12,0,1,1,97,235,332,fall
2012-08-23,3,13,0,1,1,93,253,346,fall
2012-08-23,3,14,0,1,1,114,191,305,fall
2012-08-23,3,15,0,1,1,104,201,305,fall
2012-08-23,3,16,0,1,1,121,344,465,fall
2012-08-23,3,17,0,1,1,111,709,820,fall
2012-08-23,3,18,0,1,1,130,811,941,fall
2012-08-23,3,19,0,1,1,96,537,633,fall
2012-08-23,3,20,0,1,1,70,404,474,fall
2012-08-23,3,21,0,1,1,53,276,329,fall
2012-08-23,3,22,0,1,2,21,177,198,fall
2012-08-23,3,23,0,1,2,24,133,157,fall
2012-08-24,3,0,0,1,2,27,84,111,fall
2012-08-24,3,1,0,1,2,5,37,42,fall
2012-08-24,3,2,0,1,1,1,15,16,fall
2012-08-24,3,3,0,1,1,2,6,8,fall
2012-08-24,3,4,0,1,2,2,6,8,fall
2012-08-24,3,5,0,1,1,1,37,38,fall
2012-08-24,3,6,0,1,2,9,142,151,fall
2012-08-24,3,7,0,1,2,13,412,425,fall
2012-08-24,3,8,0,1,2,41,703,744,fall
2012-08-24,3,9,0,1,2,58,331,389,fall
2012-08-24,3,10,0,1,2,78,184,262,fall
2012-08-24,3,11,0,1,2,69,212,281,fall
2012-08-24,3,12,0,1,2,95,276,371,fall
2012-08-24,3,13,0,1,2,79,272,351,fall
2012-08-24,3,14,0,1,1,109,229,338,fall
2012-08-24,3,15,0,1,2,99,251,350,fall
2012-08-24,3,16,0,1,2,101,414,515,fall
2012-08-24,3,17,0,1,2,117,695,812,fall
2012-08-24,3,18,0,1,2,109,627,736,fall
2012-08-24,3,19,0,1,2,106,430,536,fall
2012-08-24,3,20,0,1,2,66,297,363,fall
2012-08-24,3,21,0,1,2,58,248,306,fall
2012-08-24,3,22,0,1,2,42,209,251,fall
2012-08-24,3,23,0,1,2,38,140,178,fall
2012-08-25,3,0,0,0,2,21,114,135,fall
2012-08-25,3,1,0,0,2,15,100,115,fall
2012-08-25,3,2,0,0,2,18,61,79,fall
2012-08-25,3,3,0,0,1,7,31,38,fall
2012-08-25,3,4,0,0,2,3,9,12,fall
2012-08-25,3,5,0,0,2,4,10,14,fall
2012-08-25,3,6,0,0,2,5,25,30,fall
2012-08-25,3,7,0,0,2,14,88,102,fall
2012-08-25,3,8,0,0,2,29,133,162,fall
2012-08-25,3,9,0,0,2,60,228,288,fall
2012-08-25,3,10,0,0,2,148,294,442,fall
2012-08-25,3,11,0,0,2,143,314,457,fall
2012-08-25,3,12,0,0,3,217,367,584,fall
2012-08-25,3,13,0,0,2,186,331,517,fall
2012-08-25,3,14,0,0,3,150,332,482,fall
2012-08-25,3,15,0,0,2,79,154,233,fall
2012-08-25,3,16,0,0,2,174,260,434,fall
2012-08-25,3,17,0,0,2,132,271,403,fall
2012-08-25,3,18,0,0,2,122,261,383,fall
2012-08-25,3,19,0,0,2,97,257,354,fall
2012-08-25,3,20,0,0,3,65,176,241,fall
2012-08-25,3,21,0,0,1,60,148,208,fall
2012-08-25,3,22,0,0,1,46,136,182,fall
2012-08-25,3,23,0,0,2,34,124,158,fall
2012-08-26,3,0,0,0,1,23,111,134,fall
2012-08-26,3,1,0,0,1,18,116,134,fall
2012-08-26,3,2,0,0,2,12,104,116,fall
2012-08-26,3,3,0,0,2,11,42,53,fall
2012-08-26,3,4,0,0,2,5,11,16,fall
2012-08-26,3,5,0,0,1,3,13,16,fall
2012-08-26,3,6,0,0,1,5,16,21,fall
2012-08-26,3,7,0,0,1,11,23,34,fall
2012-08-26,3,8,0,0,1,21,112,133,fall
2012-08-26,3,9,0,0,1,67,196,263,fall
2012-08-26,3,10,0,0,1,127,258,385,fall
2012-08-26,3,11,0,0,1,150,332,482,fall
2012-08-26,3,12,0,0,3,225,401,626,fall
2012-08-26,3,13,0,0,3,166,375,541,fall
2012-08-26,3,14,0,0,1,125,252,377,fall
2012-08-26,3,15,0,0,3,132,259,391,fall
2012-08-26,3,16,0,0,3,57,116,173,fall
2012-08-26,3,17,0,0,1,61,172,233,fall
2012-08-26,3,18,0,0,2,77,187,264,fall
2012-08-26,3,19,0,0,2,80,212,292,fall
2012-08-26,3,20,0,0,1,40,171,211,fall
2012-08-26,3,21,0,0,1,26,140,166,fall
2012-08-26,3,22,0,0,1,20,94,114,fall
2012-08-26,3,23,0,0,1,21,59,80,fall
2012-08-27,3,0,0,1,1,4,28,32,fall
2012-08-27,3,1,0,1,1,3,4,7,fall
2012-08-27,3,2,0,1,1,0,8,8,fall
2012-08-27,3,3,0,1,1,1,3,4,fall
2012-08-27,3,4,0,1,1,1,11,12,fall
2012-08-27,3,5,0,1,1,4,32,36,fall
2012-08-27,3,6,0,1,1,4,141,145,fall
2012-08-27,3,7,0,1,1,15,418,433,fall
2012-08-27,3,8,0,1,1,29,670,699,fall
2012-08-27,3,9,0,1,1,40,302,342,fall
2012-08-27,3,10,0,1,1,63,143,206,fall
2012-08-27,3,11,0,1,1,47,182,229,fall
2012-08-27,3,12,0,1,1,69,214,283,fall
2012-08-27,3,13,0,1,1,77,211,288,fall
2012-08-27,3,14,0,1,1,66,180,246,fall
2012-08-27,3,15,0,1,1,77,205,282,fall
2012-08-27,3,16,0,1,1,77,367,444,fall
2012-08-27,3,17,0,1,1,101,744,845,fall
2012-08-27,3,18,0,1,1,83,751,834,fall
2012-08-27,3,19,0,1,1,74,499,573,fall
2012-08-27,3,20,0,1,1,50,366,416,fall
2012-08-27,3,21,0,1,1,39,239,278,fall
2012-08-27,3,22,0,1,1,30,131,161,fall
2012-08-27,3,23,0,1,1,35,79,114,fall
2012-08-28,3,0,0,1,1,9,29,38,fall
2012-08-28,3,1,0,1,1,4,17,21,fall
2012-08-28,3,2,0,1,1,2,13,15,fall
2012-08-28,3,3,0,1,1,0,4,4,fall
2012-08-28,3,4,0,1,1,2,6,8,fall
2012-08-28,3,5,0,1,2,3,39,42,fall
2012-08-28,3,6,0,1,2,3,144,147,fall
2012-08-28,3,7,0,1,2,14,255,269,fall
2012-08-28,3,8,0,1,2,25,668,693,fall
2012-08-28,3,9,0,1,2,44,351,395,fall
2012-08-28,3,10,0,1,1,39,165,204,fall
2012-08-28,3,11,0,1,1,47,171,218,fall
2012-08-28,3,12,0,1,1,56,241,297,fall
2012-08-28,3,13,0,1,1,56,232,288,fall
2012-08-28,3,14,0,1,1,72,179,251,fall
2012-08-28,3,15,0,1,1,59,258,317,fall
2012-08-28,3,16,0,1,1,84,396,480,fall
2012-08-28,3,17,0,1,1,90,774,864,fall
2012-08-28,3,18,0,1,1,82,736,818,fall
2012-08-28,3,19,0,1,1,82,515,597,fall
2012-08-28,3,20,0,1,1,87,348,435,fall
2012-08-28,3,21,0,1,1,38,276,314,fall
2012-08-28,3,22,0,1,1,20,196,216,fall
2012-08-28,3,23,0,1,1,17,92,109,fall
2012-08-29,3,0,0,1,1,8,39,47,fall
2012-08-29,3,1,0,1,1,2,12,14,fall
2012-08-29,3,2,0,1,1,2,4,6,fall
2012-08-29,3,3,0,1,1,0,9,9,fall
2012-08-29,3,4,0,1,1,2,8,10,fall
2012-08-29,3,5,0,1,1,3,37,40,fall
2012-08-29,3,6,0,1,1,6,175,181,fall
2012-08-29,3,7,0,1,1,23,531,554,fall
2012-08-29,3,8,0,1,1,28,780,808,fall
2012-08-29,3,9,0,1,1,40,308,348,fall
2012-08-29,3,10,0,1,1,34,144,178,fall
2012-08-29,3,11,0,1,1,67,186,253,fall
2012-08-29,3,12,0,1,1,79,281,360,fall
2012-08-29,3,13,0,1,1,68,232,300,fall
2012-08-29,3,14,0,1,1,87,214,301,fall
2012-08-29,3,15,0,1,1,96,242,338,fall
2012-08-29,3,16,0,1,1,104,389,493,fall
2012-08-29,3,17,0,1,1,108,762,870,fall
2012-08-29,3,18,0,1,1,119,693,812,fall
2012-08-29,3,19,0,1,1,120,523,643,fall
2012-08-29,3,20,0,1,1,49,378,427,fall
2012-08-29,3,21,0,1,1,48,265,313,fall
2012-08-29,3,22,0,1,1,50,185,235,fall
2012-08-29,3,23,0,1,1,34,123,157,fall
2012-08-30,3,0,0,1,1,14,51,65,fall
2012-08-30,3,1,0,1,1,6,17,23,fall
2012-08-30,3,2,0,1,1,3,14,17,fall
2012-08-30,3,3,0,1,1,0,5,5,fall
2012-08-30,3,4,0,1,1,4,4,8,fall
2012-08-30,3,5,0,1,1,2,33,35,fall
2012-08-30,3,6,0,1,1,8,155,163,fall
2012-08-30,3,7,0,1,1,31,501,532,fall
2012-08-30,3,8,0,1,1,53,701,754,fall
2012-08-30,3,9,0,1,1,57,339,396,fall
2012-08-30,3,10,0,1,1,73,161,234,fall
2012-08-30,3,11,0,1,1,85,191,276,fall
2012-08-30,3,12,0,1,1,73,221,294,fall
2012-08-30,3,13,0,1,1,76,214,290,fall
2012-08-30,3,14,0,1,1,74,199,273,fall
2012-08-30,3,15,0,1,1,99,239,338,fall
2012-08-30,3,16,0,1,1,77,405,482,fall
2012-08-30,3,17,0,1,1,93,751,844,fall
2012-08-30,3,18,0,1,1,109,744,853,fall
2012-08-30,3,19,0,1,1,78,532,610,fall
2012-08-30,3,20,0,1,1,68,403,471,fall
2012-08-30,3,21,0,1,1,32,275,307,fall
2012-08-30,3,22,0,1,1,38,253,291,fall
2012-08-30,3,23,0,1,1,19,133,152,fall
2012-08-31,3,0,0,1,1,13,69,82,fall
2012-08-31,3,1,0,1,1,8,24,32,fall
2012-08-31,3,2,0,1,1,9,11,20,fall
2012-08-31,3,3,0,1,1,3,2,5,fall
2012-08-31,3,4,0,1,1,0,7,7,fall
2012-08-31,3,5,0,1,1,2,27,29,fall
2012-08-31,3,6,0,1,2,7,101,108,fall
2012-08-31,3,7,0,1,2,21,400,421,fall
2012-08-31,3,8,0,1,2,36,654,690,fall
2012-08-31,3,9,0,1,1,61,337,398,fall
2012-08-31,3,10,0,1,1,59,197,256,fall
2012-08-31,3,11,0,1,1,88,221,309,fall
2012-08-31,3,12,0,1,1,120,290,410,fall
2012-08-31,3,13,0,1,1,97,271,368,fall
2012-08-31,3,14,0,1,1,112,324,436,fall
2012-08-31,3,15,0,1,1,109,417,526,fall
2012-08-31,3,16,0,1,1,111,417,528,fall
2012-08-31,3,17,0,1,1,129,488,617,fall
2012-08-31,3,18,0,1,1,87,459,546,fall
2012-08-31,3,19,0,1,1,91,361,452,fall
2012-08-31,3,20,0,1,1,102,254,356,fall
2012-08-31,3,21,0,1,1,71,232,303,fall
2012-08-31,3,22,0,1,1,65,212,277,fall
2012-08-31,3,23,0,1,1,32,142,174,fall
2012-09-01,3,0,0,0,1,22,146,168,fall
2012-09-01,3,1,0,0,1,11,68,79,fall
2012-09-01,3,2,0,0,1,8,61,69,fall
2012-09-01,3,3,0,0,1,6,29,35,fall
2012-09-01,3,4,0,0,1,3,9,12,fall
2012-09-01,3,5,0,0,1,2,20,22,fall
2012-09-01,3,6,0,0,1,13,23,36,fall
2012-09-01,3,7,0,0,2,8,58,66,fall
2012-09-01,3,8,0,0,2,28,134,162,fall
2012-09-01,3,9,0,0,2,62,175,237,fall
2012-09-01,3,10,0,0,2,128,289,417,fall
2012-09-01,3,11,0,0,2,219,273,492,fall
2012-09-01,3,12,0,0,2,187,284,471,fall
2012-09-01,3,13,0,0,2,237,267,504,fall
2012-09-01,3,14,0,0,2,240,274,514,fall
2012-09-01,3,15,0,0,2,257,306,563,fall
2012-09-01,3,16,0,0,2,209,253,462,fall
2012-09-01,3,17,0,0,2,205,258,463,fall
2012-09-01,3,18,0,0,2,184,258,442,fall
2012-09-01,3,19,0,0,3,157,235,392,fall
2012-09-01,3,20,0,0,3,67,140,207,fall
2012-09-01,3,21,0,0,3,21,83,104,fall
2012-09-01,3,22,0,0,2,21,57,78,fall
2012-09-01,3,23,0,0,1,57,88,145,fall
2012-09-02,3,0,0,0,2,27,72,99,fall
2012-09-02,3,1,0,0,1,15,58,73,fall
2012-09-02,3,2,0,0,1,28,56,84,fall
2012-09-02,3,3,0,0,1,9,33,42,fall
2012-09-02,3,4,0,0,1,7,15,22,fall
2012-09-02,3,5,0,0,1,2,10,12,fall
2012-09-02,3,6,0,0,2,2,13,15,fall
2012-09-02,3,7,0,0,1,13,29,42,fall
2012-09-02,3,8,0,0,1,30,99,129,fall
2012-09-02,3,9,0,0,2,88,144,232,fall
2012-09-02,3,10,0,0,2,158,230,388,fall
2012-09-02,3,11,0,0,2,226,263,489,fall
2012-09-02,3,12,0,0,3,248,297,545,fall
2012-09-02,3,13,0,0,3,263,230,493,fall
2012-09-02,3,14,0,0,3,249,208,457,fall
2012-09-02,3,15,0,0,3,179,176,355,fall
2012-09-02,3,16,0,0,1,222,252,474,fall
2012-09-02,3,17,0,0,1,219,284,503,fall
2012-09-02,3,18,0,0,1,227,273,500,fall
2012-09-02,3,19,0,0,2,140,152,292,fall
2012-09-02,3,20,0,0,2,63,41,104,fall
2012-09-02,3,21,0,0,1,79,92,171,fall
2012-09-02,3,22,0,0,3,66,100,166,fall
2012-09-02,3,23,0,0,3,53,70,123,fall
2012-09-03,3,0,1,0,2,42,62,104,fall
2012-09-03,3,1,1,0,2,18,37,55,fall
2012-09-03,3,2,1,0,1,10,30,40,fall
2012-09-03,3,3,1,0,1,6,22,28,fall
2012-09-03,3,4,1,0,1,6,5,11,fall
2012-09-03,3,5,1,0,1,1,3,4,fall
2012-09-03,3,6,1,0,1,3,12,15,fall
2012-09-03,3,7,1,0,1,6,37,43,fall
2012-09-03,3,8,1,0,2,36,91,127,fall
2012-09-03,3,9,1,0,2,71,158,229,fall
2012-09-03,3,10,1,0,2,135,224,359,fall
2012-09-03,3,11,1,0,2,187,272,459,fall
2012-09-03,3,12,1,0,2,191,352,543,fall
2012-09-03,3,13,1,0,2,209,357,566,fall
2012-09-03,3,14,1,0,1,163,349,512,fall
2012-09-03,3,15,1,0,1,168,281,449,fall
2012-09-03,3,16,1,0,1,165,335,500,fall
2012-09-03,3,17,1,0,1,181,317,498,fall
2012-09-03,3,18,1,0,1,145,337,482,fall
2012-09-03,3,19,1,0,1,73,301,374,fall
2012-09-03,3,20,1,0,1,78,183,261,fall
2012-09-03,3,21,1,0,1,42,142,184,fall
2012-09-03,3,22,1,0,2,17,104,121,fall
2012-09-03,3,23,1,0,2,12,58,70,fall
2012-09-04,3,0,0,1,2,10,19,29,fall
2012-09-04,3,1,0,1,1,15,9,24,fall
2012-09-04,3,2,0,1,1,1,4,5,fall
2012-09-04,3,3,0,1,2,1,9,10,fall
2012-09-04,3,4,0,1,2,0,8,8,fall
2012-09-04,3,5,0,1,2,1,37,38,fall
2012-09-04,3,6,0,1,2,7,165,172,fall
2012-09-04,3,7,0,1,2,13,480,493,fall
2012-09-04,3,8,0,1,1,15,617,632,fall
2012-09-04,3,9,0,1,2,30,293,323,fall
2012-09-04,3,10,0,1,2,42,130,172,fall
2012-09-04,3,11,0,1,2,39,159,198,fall
2012-09-04,3,12,0,1,1,54,233,287,fall
2012-09-04,3,13,0,1,1,72,203,275,fall
2012-09-04,3,14,0,1,1,72,202,274,fall
2012-09-04,3,15,0,1,1,68,224,292,fall
2012-09-04,3,16,0,1,1,61,397,458,fall
2012-09-04,3,17,0,1,1,110,746,856,fall
2012-09-04,3,18,0,1,1,94,745,839,fall
2012-09-04,3,19,0,1,1,50,502,552,fall
2012-09-04,3,20,0,1,1,47,338,385,fall
2012-09-04,3,21,0,1,1,28,240,268,fall
2012-09-04,3,22,0,1,1,25,154,179,fall
2012-09-04,3,23,0,1,1,12,83,95,fall
2012-09-05,3,0,0,1,1,10,27,37,fall
2012-09-05,3,1,0,1,1,2,11,13,fall
2012-09-05,3,2,0,1,1,0,9,9,fall
2012-09-05,3,3,0,1,1,0,4,4,fall
2012-09-05,3,4,0,1,1,2,3,5,fall
2012-09-05,3,5,0,1,2,1,39,40,fall
2012-09-05,3,6,0,1,1,7,203,210,fall
2012-09-05,3,7,0,1,2,11,489,500,fall
2012-09-05,3,8,0,1,1,33,692,725,fall
2012-09-05,3,9,0,1,1,27,263,290,fall
2012-09-05,3,10,0,1,2,54,181,235,fall
2012-09-05,3,11,0,1,2,61,156,217,fall
2012-09-05,3,12,0,1,1,49,217,266,fall
2012-09-05,3,13,0,1,1,50,184,234,fall
2012-09-05,3,14,0,1,1,34,177,211,fall
2012-09-05,3,15,0,1,1,41,204,245,fall
2012-09-05,3,16,0,1,1,86,344,430,fall
2012-09-05,3,17,0,1,1,83,780,863,fall
2012-09-05,3,18,0,1,1,82,757,839,fall
2012-09-05,3,19,0,1,1,64,598,662,fall
2012-09-05,3,20,0,1,1,55,357,412,fall
2012-09-05,3,21,0,1,1,18,278,296,fall
2012-09-05,3,22,0,1,1,38,181,219,fall
2012-09-05,3,23,0,1,1,24,126,150,fall
2012-09-06,3,0,0,1,2,30,35,65,fall
2012-09-06,3,1,0,1,2,2,16,18,fall
2012-09-06,3,2,0,1,1,1,7,8,fall
2012-09-06,3,3,0,1,1,0,9,9,fall
2012-09-06,3,4,0,1,2,0,8,8,fall
2012-09-06,3,5,0,1,2,3,35,38,fall
2012-09-06,3,6,0,1,2,11,189,200,fall
2012-09-06,3,7,0,1,2,21,461,482,fall
2012-09-06,3,8,0,1,3,24,622,646,fall
2012-09-06,3,9,0,1,3,8,115,123,fall
2012-09-06,3,10,0,1,3,9,40,49,fall
2012-09-06,3,11,0,1,3,10,52,62,fall
2012-09-06,3,12,0,1,2,11,126,137,fall
2012-09-06,3,13,0,1,2,39,152,191,fall
2012-09-06,3,14,0,1,1,38,178,216,fall
2012-09-06,3,15,0,1,1,42,228,270,fall
2012-09-06,3,16,0,1,1,42,374,416,fall
2012-09-06,3,17,0,1,1,67,741,808,fall
2012-09-06,3,18,0,1,1,74,761,835,fall
2012-09-06,3,19,0,1,1,54,504,558,fall
2012-09-06,3,20,0,1,1,50,356,406,fall
2012-09-06,3,21,0,1,1,32,240,272,fall
2012-09-06,3,22,0,1,1,24,193,217,fall
2012-09-06,3,23,0,1,1,19,150,169,fall
2012-09-07,3,0,0,1,1,17,79,96,fall
2012-09-07,3,1,0,1,1,10,19,29,fall
2012-09-07,3,2,0,1,1,1,10,11,fall
2012-09-07,3,3,0,1,1,0,9,9,fall
2012-09-07,3,4,0,1,1,1,7,8,fall
2012-09-07,3,5,0,1,1,1,39,40,fall
2012-09-07,3,6,0,1,1,5,135,140,fall
2012-09-07,3,7,0,1,1,21,465,486,fall
2012-09-07,3,8,0,1,1,29,690,719,fall
2012-09-07,3,9,0,1,1,33,311,344,fall
2012-09-07,3,10,0,1,1,53,171,224,fall
2012-09-07,3,11,0,1,1,81,215,296,fall
2012-09-07,3,12,0,1,1,76,247,323,fall
2012-09-07,3,13,0,1,1,71,283,354,fall
2012-09-07,3,14,0,1,1,66,187,253,fall
2012-09-07,3,15,0,1,1,66,265,331,fall
2012-09-07,3,16,0,1,1,75,395,470,fall
2012-09-07,3,17,0,1,1,88,684,772,fall
2012-09-07,3,18,0,1,1,95,697,792,fall
2012-09-07,3,19,0,1,1,70,498,568,fall
2012-09-07,3,20,0,1,1,51,340,391,fall
2012-09-07,3,21,0,1,1,55,246,301,fall
2012-09-07,3,22,0,1,1,52,247,299,fall
2012-09-07,3,23,0,1,1,28,220,248,fall
2012-09-08,3,0,0,0,1,20,130,150,fall
2012-09-08,3,1,0,0,2,10,107,117,fall
2012-09-08,3,2,0,0,1,9,68,77,fall
2012-09-08,3,3,0,0,2,3,40,43,fall
2012-09-08,3,4,0,0,2,3,8,11,fall
2012-09-08,3,5,0,0,2,2,13,15,fall
2012-09-08,3,6,0,0,2,8,26,34,fall
2012-09-08,3,7,0,0,1,11,71,82,fall
2012-09-08,3,8,0,0,1,33,197,230,fall
2012-09-08,3,9,0,0,1,87,261,348,fall
2012-09-08,3,10,0,0,1,100,322,422,fall
2012-09-08,3,11,0,0,1,173,405,578,fall
2012-09-08,3,12,0,0,1,220,474,694,fall
2012-09-08,3,13,0,0,1,233,435,668,fall
2012-09-08,3,14,0,0,1,260,366,626,fall
2012-09-08,3,15,0,0,3,175,337,512,fall
2012-09-08,3,16,0,0,3,19,95,114,fall
2012-09-08,3,17,0,0,3,52,119,171,fall
2012-09-08,3,18,0,0,3,27,140,167,fall
2012-09-08,3,19,0,0,3,28,187,215,fall
2012-09-08,3,20,0,0,2,28,166,194,fall
2012-09-08,3,21,0,0,2,26,155,181,fall
2012-09-08,3,22,0,0,2,18,176,194,fall
2012-09-08,3,23,0,0,2,12,121,133,fall
2012-09-09,3,0,0,0,2,18,106,124,fall
2012-09-09,3,1,0,0,1,20,104,124,fall
2012-09-09,3,2,0,0,1,15,81,96,fall
2012-09-09,3,3,0,0,1,14,32,46,fall
2012-09-09,3,4,0,0,1,12,16,28,fall
2012-09-09,3,5,0,0,1,16,39,55,fall
2012-09-09,3,6,0,0,1,11,24,35,fall
2012-09-09,3,7,0,0,1,20,50,70,fall
2012-09-09,3,8,0,0,1,27,143,170,fall
2012-09-09,3,9,0,0,1,85,214,299,fall
2012-09-09,3,10,0,0,1,172,323,495,fall
2012-09-09,3,11,0,0,1,194,391,585,fall
2012-09-09,3,12,0,0,1,247,510,757,fall
2012-09-09,3,13,0,0,1,238,491,729,fall
2012-09-09,3,14,0,0,1,232,415,647,fall
2012-09-09,3,15,0,0,1,284,412,696,fall
2012-09-09,3,16,0,0,1,228,473,701,fall
2012-09-09,3,17,0,0,1,213,458,671,fall
2012-09-09,3,18,0,0,1,156,404,560,fall
2012-09-09,3,19,0,0,1,134,362,496,fall
2012-09-09,3,20,0,0,1,91,265,356,fall
2012-09-09,3,21,0,0,1,57,149,206,fall
2012-09-09,3,22,0,0,1,64,125,189,fall
2012-09-09,3,23,0,0,1,22,70,92,fall
2012-09-10,3,0,0,1,1,6,35,41,fall
2012-09-10,3,1,0,1,1,7,11,18,fall
2012-09-10,3,2,0,1,1,11,6,17,fall
2012-09-10,3,3,0,1,1,5,7,12,fall
2012-09-10,3,4,0,1,1,1,4,5,fall
2012-09-10,3,5,0,1,1,4,36,40,fall
2012-09-10,3,6,0,1,1,8,172,180,fall
2012-09-10,3,7,0,1,1,20,427,447,fall
2012-09-10,3,8,0,1,1,33,697,730,fall
2012-09-10,3,9,0,1,1,40,321,361,fall
2012-09-10,3,10,0,1,1,42,168,210,fall
2012-09-10,3,11,0,1,1,69,167,236,fall
2012-09-10,3,12,0,1,1,76,256,332,fall
2012-09-10,3,13,0,1,1,72,251,323,fall
2012-09-10,3,14,0,1,1,107,233,340,fall
2012-09-10,3,15,0,1,1,115,231,346,fall
2012-09-10,3,16,0,1,1,108,380,488,fall
2012-09-10,3,17,0,1,1,127,744,871,fall
2012-09-10,3,18,0,1,1,111,857,968,fall
2012-09-10,3,19,0,1,1,71,562,633,fall
2012-09-10,3,20,0,1,1,34,356,390,fall
2012-09-10,3,21,0,1,1,29,256,285,fall
2012-09-10,3,22,0,1,1,15,144,159,fall
2012-09-10,3,23,0,1,1,7,86,93,fall
2012-09-11,3,0,0,1,1,5,27,32,fall
2012-09-11,3,1,0,1,1,0,10,10,fall
2012-09-11,3,2,0,1,1,1,5,6,fall
2012-09-11,3,3,0,1,1,1,7,8,fall
2012-09-11,3,4,0,1,1,1,8,9,fall
2012-09-11,3,5,0,1,1,3,41,44,fall
2012-09-11,3,6,0,1,1,11,200,211,fall
2012-09-11,3,7,0,1,1,24,572,596,fall
2012-09-11,3,8,0,1,1,48,702,750,fall
2012-09-11,3,9,0,1,1,35,323,358,fall
2012-09-11,3,10,0,1,1,54,142,196,fall
2012-09-11,3,11,0,1,1,60,187,247,fall
2012-09-11,3,12,0,1,1,62,254,316,fall
2012-09-11,3,13,0,1,1,72,256,328,fall
2012-09-11,3,14,0,1,1,74,181,255,fall
2012-09-11,3,15,0,1,1,73,253,326,fall
2012-09-11,3,16,0,1,1,99,437,536,fall
2012-09-11,3,17,0,1,1,168,802,970,fall
2012-09-11,3,18,0,1,1,110,767,877,fall
2012-09-11,3,19,0,1,1,56,540,596,fall
2012-09-11,3,20,0,1,1,40,421,461,fall
2012-09-11,3,21,0,1,1,28,282,310,fall
2012-09-11,3,22,0,1,1,27,189,216,fall
2012-09-11,3,23,0,1,1,18,91,109,fall
2012-09-12,3,0,0,1,1,8,41,49,fall
2012-09-12,3,1,0,1,1,2,19,21,fall
2012-09-12,3,2,0,1,1,2,9,11,fall
2012-09-12,3,3,0,1,1,0,7,7,fall
2012-09-12,3,4,0,1,1,0,5,5,fall
2012-09-12,3,5,0,1,1,4,44,48,fall
2012-09-12,3,6,0,1,1,6,199,205,fall
2012-09-12,3,7,0,1,1,24,533,557,fall
2012-09-12,3,8,0,1,1,43,727,770,fall
2012-09-12,3,9,0,1,1,50,278,328,fall
2012-09-12,3,10,0,1,1,57,148,205,fall
2012-09-12,3,11,0,1,1,51,181,232,fall
2012-09-12,3,12,0,1,1,88,264,352,fall
2012-09-12,3,13,0,1,1,85,238,323,fall
2012-09-12,3,14,0,1,1,78,200,278,fall
2012-09-12,3,15,0,1,1,75,243,318,fall
2012-09-12,3,16,0,1,1,90,419,509,fall
2012-09-12,3,17,0,1,1,114,811,925,fall
2012-09-12,3,18,0,1,1,91,886,977,fall
2012-09-12,3,19,0,1,1,78,557,635,fall
2012-09-12,3,20,0,1,1,38,432,470,fall
2012-09-12,3,21,0,1,1,27,279,306,fall
2012-09-12,3,22,0,1,1,23,189,212,fall
2012-09-12,3,23,0,1,1,16,111,127,fall
2012-09-13,3,0,0,1,1,11,46,57,fall
2012-09-13,3,1,0,1,1,6,22,28,fall
2012-09-13,3,2,0,1,1,0,9,9,fall
2012-09-13,3,3,0,1,1,2,9,11,fall
2012-09-13,3,4,0,1,1,0,6,6,fall
2012-09-13,3,5,0,1,1,3,54,57,fall
2012-09-13,3,6,0,1,1,9,186,195,fall
2012-09-13,3,7,0,1,1,22,549,571,fall
2012-09-13,3,8,0,1,1,33,725,758,fall
2012-09-13,3,9,0,1,1,46,292,338,fall
2012-09-13,3,10,0,1,1,63,149,212,fall
2012-09-13,3,11,0,1,1,71,183,254,fall
2012-09-13,3,12,0,1,1,57,240,297,fall
2012-09-13,3,13,0,1,1,60,223,283,fall
2012-09-13,3,14,0,1,1,60,214,274,fall
2012-09-13,3,15,0,1,1,99,253,352,fall
2012-09-13,3,16,0,1,1,85,406,491,fall
2012-09-13,3,17,0,1,1,97,787,884,fall
2012-09-13,3,18,0,1,1,108,744,852,fall
2012-09-13,3,19,0,1,1,80,594,674,fall
2012-09-13,3,20,0,1,1,55,408,463,fall
2012-09-13,3,21,0,1,1,26,291,317,fall
2012-09-13,3,22,0,1,1,28,223,251,fall
2012-09-13,3,23,0,1,1,33,137,170,fall
2012-09-14,3,0,0,1,1,24,63,87,fall
2012-09-14,3,1,0,1,1,6,35,41,fall
2012-09-14,3,2,0,1,1,7,23,30,fall
2012-09-14,3,3,0,1,1,5,9,14,fall
2012-09-14,3,4,0,1,1,1,11,12,fall
2012-09-14,3,5,0,1,1,1,40,41,fall
2012-09-14,3,6,0,1,1,8,144,152,fall
2012-09-14,3,7,0,1,2,17,437,454,fall
2012-09-14,3,8,0,1,2,51,715,766,fall
2012-09-14,3,9,0,1,2,46,301,347,fall
2012-09-14,3,10,0,1,2,75,171,246,fall
2012-09-14,3,11,0,1,2,84,196,280,fall
2012-09-14,3,12,0,1,2,119,290,409,fall
2012-09-14,3,13,0,1,2,107,301,408,fall
2012-09-14,3,14,0,1,2,113,258,371,fall
2012-09-14,3,15,0,1,2,94,273,367,fall
2012-09-14,3,16,0,1,2,109,454,563,fall
2012-09-14,3,17,0,1,1,137,757,894,fall
2012-09-14,3,18,0,1,1,116,692,808,fall
2012-09-14,3,19,0,1,1,83,496,579,fall
2012-09-14,3,20,0,1,1,67,337,404,fall
2012-09-14,3,21,0,1,1,42,270,312,fall
2012-09-14,3,22,0,1,1,40,189,229,fall
2012-09-14,3,23,0,1,1,27,168,195,fall
2012-09-15,3,0,0,0,1,38,169,207,fall
2012-09-15,3,1,0,0,1,8,101,109,fall
2012-09-15,3,2,0,0,1,18,75,93,fall
2012-09-15,3,3,0,0,1,6,31,37,fall
2012-09-15,3,4,0,0,2,3,3,6,fall
2012-09-15,3,5,0,0,1,1,15,16,fall
2012-09-15,3,6,0,0,1,6,27,33,fall
2012-09-15,3,7,0,0,1,10,63,73,fall
2012-09-15,3,8,0,0,1,43,169,212,fall
2012-09-15,3,9,0,0,1,79,263,342,fall
2012-09-15,3,10,0,0,1,119,323,442,fall
2012-09-15,3,11,0,0,1,228,399,627,fall
2012-09-15,3,12,0,0,1,287,419,706,fall
2012-09-15,3,13,0,0,1,327,377,704,fall
2012-09-15,3,14,0,0,1,325,390,715,fall
2012-09-15,3,15,0,0,2,312,342,654,fall
2012-09-15,3,16,0,0,2,350,433,783,fall
2012-09-15,3,17,0,0,2,295,434,729,fall
2012-09-15,3,18,0,0,2,232,382,614,fall
2012-09-15,3,19,0,0,1,169,309,478,fall
2012-09-15,3,20,0,0,1,89,241,330,fall
2012-09-15,3,21,0,0,1,86,210,296,fall
2012-09-15,3,22,0,0,1,82,197,279,fall
2012-09-15,3,23,0,0,1,47,182,229,fall
2012-09-16,3,0,0,0,1,28,123,151,fall
2012-09-16,3,1,0,0,1,35,82,117,fall
2012-09-16,3,2,0,0,1,27,62,89,fall
2012-09-16,3,3,0,0,1,10,38,48,fall
2012-09-16,3,4,0,0,1,2,6,8,fall
2012-09-16,3,5,0,0,1,3,10,13,fall
2012-09-16,3,6,0,0,1,9,26,35,fall
2012-09-16,3,7,0,0,1,28,43,71,fall
2012-09-16,3,8,0,0,1,34,94,128,fall
2012-09-16,3,9,0,0,1,70,226,296,fall
2012-09-16,3,10,0,0,1,160,330,490,fall
2012-09-16,3,11,0,0,1,183,376,559,fall
2012-09-16,3,12,0,0,1,188,468,656,fall
2012-09-16,3,13,0,0,1,240,454,694,fall
2012-09-16,3,14,0,0,1,225,410,635,fall
2012-09-16,3,15,0,0,1,215,342,557,fall
2012-09-16,3,16,0,0,1,194,402,596,fall
2012-09-16,3,17,0,0,1,177,393,570,fall
2012-09-16,3,18,0,0,1,120,361,481,fall
2012-09-16,3,19,0,0,1,91,312,403,fall
2012-09-16,3,20,0,0,1,57,267,324,fall
2012-09-16,3,21,0,0,1,43,148,191,fall
2012-09-16,3,22,0,0,1,18,109,127,fall
2012-09-16,3,23,0,0,1,9,85,94,fall
2012-09-17,3,0,0,1,1,14,31,45,fall
2012-09-17,3,1,0,1,1,9,12,21,fall
2012-09-17,3,2,0,1,1,5,8,13,fall
2012-09-17,3,3,0,1,1,0,7,7,fall
2012-09-17,3,4,0,1,1,2,9,11,fall
2012-09-17,3,5,0,1,1,1,44,45,fall
2012-09-17,3,6,0,1,1,7,157,164,fall
2012-09-17,3,7,0,1,1,18,474,492,fall
2012-09-17,3,8,0,1,1,36,647,683,fall
2012-09-17,3,9,0,1,1,34,265,299,fall
2012-09-17,3,10,0,1,2,73,129,202,fall
2012-09-17,3,11,0,1,2,61,191,252,fall
2012-09-17,3,12,0,1,2,62,233,295,fall
2012-09-17,3,13,0,1,1,112,231,343,fall
2012-09-17,3,14,0,1,2,129,203,332,fall
2012-09-17,3,15,0,1,2,82,256,338,fall
2012-09-17,3,16,0,1,2,74,379,453,fall
2012-09-17,3,17,0,1,2,102,740,842,fall
2012-09-17,3,18,0,1,2,66,708,774,fall
2012-09-17,3,19,0,1,2,51,435,486,fall
2012-09-17,3,20,0,1,2,32,308,340,fall
2012-09-17,3,21,0,1,3,28,205,233,fall
2012-09-17,3,22,0,1,3,20,109,129,fall
2012-09-17,3,23,0,1,3,4,66,70,fall
2012-09-18,3,0,0,1,3,2,11,13,fall
2012-09-18,3,1,0,1,3,0,5,5,fall
2012-09-18,3,2,0,1,3,0,4,4,fall
2012-09-18,3,3,0,1,2,0,6,6,fall
2012-09-18,3,4,0,1,2,2,5,7,fall
2012-09-18,3,5,0,1,2,3,45,48,fall
2012-09-18,3,6,0,1,2,4,163,167,fall
2012-09-18,3,7,0,1,2,13,343,356,fall
2012-09-18,3,8,0,1,2,32,640,672,fall
2012-09-18,3,9,0,1,2,27,266,293,fall
2012-09-18,3,10,0,1,3,30,130,160,fall
2012-09-18,3,11,0,1,2,36,115,151,fall
2012-09-18,3,12,0,1,3,16,72,88,fall
2012-09-18,3,13,0,1,2,17,97,114,fall
2012-09-18,3,14,0,1,3,27,116,143,fall
2012-09-18,3,15,0,1,3,1,35,36,fall
2012-09-18,3,16,0,1,3,19,122,141,fall
2012-09-18,3,17,0,1,3,36,302,338,fall
2012-09-18,3,18,0,1,2,19,262,281,fall
2012-09-18,3,19,0,1,2,22,302,324,fall
2012-09-18,3,20,0,1,2,19,271,290,fall
2012-09-18,3,21,0,1,2,21,186,207,fall
2012-09-18,3,22,0,1,3,14,137,151,fall
2012-09-18,3,23,0,1,2,11,67,78,fall
2012-09-19,3,0,0,1,2,3,23,26,fall
2012-09-19,3,1,0,1,2,0,12,12,fall
2012-09-19,3,2,0,1,2,0,3,3,fall
2012-09-19,3,3,0,1,2,1,4,5,fall
2012-09-19,3,4,0,1,2,0,10,10,fall
2012-09-19,3,5,0,1,2,2,54,56,fall
2012-09-19,3,6,0,1,1,6,166,172,fall
2012-09-19,3,7,0,1,1,16,529,545,fall
2012-09-19,3,8,0,1,1,39,758,797,fall
2012-09-19,3,9,0,1,1,26,336,362,fall
2012-09-19,3,10,0,1,1,23,169,192,fall
2012-09-19,3,11,0,1,1,44,203,247,fall
2012-09-19,3,12,0,1,1,53,260,313,fall
2012-09-19,3,13,0,1,1,55,234,289,fall
2012-09-19,3,14,0,1,1,59,227,286,fall
2012-09-19,3,15,0,1,1,57,254,311,fall
2012-09-19,3,16,0,1,1,69,397,466,fall
2012-09-19,3,17,0,1,1,74,812,886,fall
2012-09-19,3,18,0,1,1,85,807,892,fall
2012-09-19,3,19,0,1,1,72,539,611,fall
2012-09-19,3,20,0,1,1,31,378,409,fall
2012-09-19,3,21,0,1,1,25,324,349,fall
2012-09-19,3,22,0,1,1,31,198,229,fall
2012-09-19,3,23,0,1,1,17,106,123,fall
2012-09-20,3,0,0,1,1,12,46,58,fall
2012-09-20,3,1,0,1,1,4,14,18,fall
2012-09-20,3,2,0,1,1,2,9,11,fall
2012-09-20,3,3,0,1,1,0,6,6,fall
2012-09-20,3,4,0,1,1,0,6,6,fall
2012-09-20,3,5,0,1,1,4,52,56,fall
2012-09-20,3,6,0,1,1,9,161,170,fall
2012-09-20,3,7,0,1,1,20,514,534,fall
2012-09-20,3,8,0,1,1,44,746,790,fall
2012-09-20,3,9,0,1,1,25,330,355,fall
2012-09-20,3,10,0,1,1,33,157,190,fall
2012-09-20,3,11,0,1,1,37,206,243,fall
2012-09-20,3,12,0,1,1,57,233,290,fall
2012-09-20,3,13,0,1,1,68,268,336,fall
2012-09-20,3,14,0,1,1,76,222,298,fall
2012-09-20,3,15,0,1,1,60,231,291,fall
2012-09-20,3,16,0,1,1,72,385,457,fall
2012-09-20,3,17,0,1,1,91,885,976,fall
2012-09-20,3,18,0,1,1,119,781,900,fall
2012-09-20,3,19,0,1,1,69,534,603,fall
2012-09-20,3,20,0,1,1,57,360,417,fall
2012-09-20,3,21,0,1,1,28,246,274,fall
2012-09-20,3,22,0,1,1,35,252,287,fall
2012-09-20,3,23,0,1,1,17,137,154,fall
2012-09-21,3,0,0,1,1,13,53,66,fall
2012-09-21,3,1,0,1,1,11,38,49,fall
2012-09-21,3,2,0,1,1,6,8,14,fall
2012-09-21,3,3,0,1,1,1,11,12,fall
2012-09-21,3,4,0,1,1,1,9,10,fall
2012-09-21,3,5,0,1,1,2,47,49,fall
2012-09-21,3,6,0,1,1,19,146,165,fall
2012-09-21,3,7,0,1,1,35,468,503,fall
2012-09-21,3,8,0,1,1,31,726,757,fall
2012-09-21,3,9,0,1,1,35,348,383,fall
2012-09-21,3,10,0,1,1,44,181,225,fall
2012-09-21,3,11,0,1,1,79,242,321,fall
2012-09-21,3,12,0,1,1,84,305,389,fall
2012-09-21,3,13,0,1,1,105,316,421,fall
2012-09-21,3,14,0,1,1,113,299,412,fall
2012-09-21,3,15,0,1,1,90,333,423,fall
2012-09-21,3,16,0,1,1,103,464,567,fall
2012-09-21,3,17,0,1,1,107,739,846,fall
2012-09-21,3,18,0,1,1,106,699,805,fall
2012-09-21,3,19,0,1,1,95,493,588,fall
2012-09-21,3,20,0,1,1,54,315,369,fall
2012-09-21,3,21,0,1,1,46,266,312,fall
2012-09-21,3,22,0,1,1,47,248,295,fall
2012-09-21,3,23,0,1,1,23,163,186,fall
2012-09-22,3,0,0,0,1,32,140,172,fall
2012-09-22,3,1,0,0,1,18,106,124,fall
2012-09-22,3,2,0,0,1,10,73,83,fall
2012-09-22,3,3,0,0,1,6,39,45,fall
2012-09-22,3,4,0,0,1,5,10,15,fall
2012-09-22,3,5,0,0,1,2,15,17,fall
2012-09-22,3,6,0,0,1,6,35,41,fall
2012-09-22,3,7,0,0,1,7,70,77,fall
2012-09-22,3,8,0,0,1,21,197,218,fall
2012-09-22,3,9,0,0,1,88,289,377,fall
2012-09-22,3,10,0,0,1,124,350,474,fall
2012-09-22,3,11,0,0,1,189,437,626,fall
2012-09-22,3,12,0,0,1,228,460,688,fall
2012-09-22,3,13,0,0,1,273,434,707,fall
2012-09-22,3,14,0,0,1,250,404,654,fall
2012-09-22,3,15,0,0,1,307,443,750,fall
2012-09-22,3,16,0,0,1,253,427,680,fall
2012-09-22,3,17,0,0,1,195,451,646,fall
2012-09-22,3,18,0,0,1,171,427,598,fall
2012-09-22,3,19,0,0,1,99,308,407,fall
2012-09-22,3,20,0,0,1,76,249,325,fall
2012-09-22,3,21,0,0,1,59,202,261,fall
2012-09-22,3,22,0,0,1,59,180,239,fall
2012-09-22,3,23,0,0,1,34,137,171,fall
2012-09-23,4,0,0,0,1,34,146,180,winter
2012-09-23,4,1,0,0,1,23,119,142,winter
2012-09-23,4,2,0,0,1,18,77,95,winter
2012-09-23,4,3,0,0,1,13,41,54,winter
2012-09-23,4,4,0,0,1,1,9,10,winter
2012-09-23,4,5,0,0,1,1,5,6,winter
2012-09-23,4,6,0,0,1,5,11,16,winter
2012-09-23,4,7,0,0,1,9,48,57,winter
2012-09-23,4,8,0,0,1,38,137,175,winter
2012-09-23,4,9,0,0,1,71,205,276,winter
2012-09-23,4,10,0,0,1,138,351,489,winter
2012-09-23,4,11,0,0,1,186,384,570,winter
2012-09-23,4,12,0,0,1,250,526,776,winter
2012-09-23,4,13,0,0,1,257,445,702,winter
2012-09-23,4,14,0,0,1,266,400,666,winter
2012-09-23,4,15,0,0,1,265,375,640,winter
2012-09-23,4,16,0,0,1,254,437,691,winter
2012-09-23,4,17,0,0,1,227,496,723,winter
2012-09-23,4,18,0,0,1,135,405,540,winter
2012-09-23,4,19,0,0,1,82,331,413,winter
2012-09-23,4,20,0,0,1,60,192,252,winter
2012-09-23,4,21,0,0,2,51,145,196,winter
2012-09-23,4,22,0,0,1,40,98,138,winter
2012-09-23,4,23,0,0,2,30,70,100,winter
2012-09-24,4,0,0,1,1,10,54,64,winter
2012-09-24,4,1,0,1,1,6,12,18,winter
2012-09-24,4,2,0,1,2,0,8,8,winter
2012-09-24,4,3,0,1,1,0,5,5,winter
2012-09-24,4,4,0,1,1,0,8,8,winter
2012-09-24,4,5,0,1,1,2,35,37,winter
2012-09-24,4,6,0,1,1,6,162,168,winter
2012-09-24,4,7,0,1,1,17,513,530,winter
2012-09-24,4,8,0,1,1,31,719,750,winter
2012-09-24,4,9,0,1,1,42,286,328,winter
2012-09-24,4,10,0,1,1,52,146,198,winter
2012-09-24,4,11,0,1,1,71,167,238,winter
2012-09-24,4,12,0,1,1,77,265,342,winter
2012-09-24,4,13,0,1,1,80,248,328,winter
2012-09-24,4,14,0,1,1,77,226,303,winter
2012-09-24,4,15,0,1,1,84,216,300,winter
2012-09-24,4,16,0,1,1,99,417,516,winter
2012-09-24,4,17,0,1,1,89,809,898,winter
2012-09-24,4,18,0,1,1,95,758,853,winter
2012-09-24,4,19,0,1,1,56,534,590,winter
2012-09-24,4,20,0,1,1,52,380,432,winter
2012-09-24,4,21,0,1,1,26,230,256,winter
2012-09-24,4,22,0,1,1,18,154,172,winter
2012-09-24,4,23,0,1,1,11,83,94,winter
2012-09-25,4,0,0,1,1,8,56,64,winter
2012-09-25,4,1,0,1,1,2,11,13,winter
2012-09-25,4,2,0,1,1,5,9,14,winter
2012-09-25,4,3,0,1,1,2,3,5,winter
2012-09-25,4,4,0,1,1,2,7,9,winter
2012-09-25,4,5,0,1,1,1,46,47,winter
2012-09-25,4,6,0,1,1,5,189,194,winter
2012-09-25,4,7,0,1,1,17,539,556,winter
2012-09-25,4,8,0,1,1,41,764,805,winter
2012-09-25,4,9,0,1,1,28,381,409,winter
2012-09-25,4,10,0,1,1,45,125,170,winter
2012-09-25,4,11,0,1,1,63,155,218,winter
2012-09-25,4,12,0,1,1,69,233,302,winter
2012-09-25,4,13,0,1,1,48,257,305,winter
2012-09-25,4,14,0,1,1,80,213,293,winter
2012-09-25,4,15,0,1,1,56,247,303,winter
2012-09-25,4,16,0,1,1,59,436,495,winter
2012-09-25,4,17,0,1,1,107,860,967,winter
2012-09-25,4,18,0,1,1,64,758,822,winter
2012-09-25,4,19,0,1,1,49,490,539,winter
2012-09-25,4,20,0,1,1,37,388,425,winter
2012-09-25,4,21,0,1,1,34,263,297,winter
2012-09-25,4,22,0,1,1,14,174,188,winter
2012-09-25,4,23,0,1,1,9,89,98,winter
2012-09-26,4,0,0,1,1,6,34,40,winter
2012-09-26,4,1,0,1,1,10,19,29,winter
2012-09-26,4,2,0,1,2,2,15,17,winter
2012-09-26,4,3,0,1,2,4,6,10,winter
2012-09-26,4,4,0,1,1,2,12,14,winter
2012-09-26,4,5,0,1,1,1,35,36,winter
2012-09-26,4,6,0,1,1,3,179,182,winter
2012-09-26,4,7,0,1,1,9,523,532,winter
2012-09-26,4,8,0,1,1,30,808,838,winter
2012-09-26,4,9,0,1,1,27,307,334,winter
2012-09-26,4,10,0,1,1,29,156,185,winter
2012-09-26,4,11,0,1,1,46,181,227,winter
2012-09-26,4,12,0,1,1,56,260,316,winter
2012-09-26,4,13,0,1,1,67,273,340,winter
2012-09-26,4,14,0,1,1,60,217,277,winter
2012-09-26,4,15,0,1,1,69,231,300,winter
2012-09-26,4,16,0,1,1,71,397,468,winter
2012-09-26,4,17,0,1,1,77,876,953,winter
2012-09-26,4,18,0,1,1,69,815,884,winter
2012-09-26,4,19,0,1,1,38,589,627,winter
2012-09-26,4,20,0,1,1,45,389,434,winter
2012-09-26,4,21,0,1,1,32,328,360,winter
2012-09-26,4,22,0,1,3,21,194,215,winter
2012-09-26,4,23,0,1,2,13,102,115,winter
2012-09-27,4,0,0,1,1,5,60,65,winter
2012-09-27,4,1,0,1,1,5,16,21,winter
2012-09-27,4,2,0,1,1,3,13,16,winter
2012-09-27,4,3,0,1,1,0,7,7,winter
2012-09-27,4,4,0,1,1,2,6,8,winter
2012-09-27,4,5,0,1,1,2,64,66,winter
2012-09-27,4,6,0,1,1,5,164,169,winter
2012-09-27,4,7,0,1,1,12,546,558,winter
2012-09-27,4,8,0,1,1,20,774,794,winter
2012-09-27,4,9,0,1,1,30,305,335,winter
2012-09-27,4,10,0,1,2,40,168,208,winter
2012-09-27,4,11,0,1,2,67,227,294,winter
2012-09-27,4,12,0,1,2,63,272,335,winter
2012-09-27,4,13,0,1,2,61,265,326,winter
2012-09-27,4,14,0,1,2,44,214,258,winter
2012-09-27,4,15,0,1,2,41,255,296,winter
2012-09-27,4,16,0,1,2,73,399,472,winter
2012-09-27,4,17,0,1,2,87,818,905,winter
2012-09-27,4,18,0,1,2,77,822,899,winter
2012-09-27,4,19,0,1,1,48,511,559,winter
2012-09-27,4,20,0,1,2,45,412,457,winter
2012-09-27,4,21,0,1,3,18,235,253,winter
2012-09-27,4,22,0,1,3,2,45,47,winter
2012-09-27,4,23,0,1,3,1,44,45,winter
2012-09-28,4,0,0,1,3,2,15,17,winter
2012-09-28,4,1,0,1,3,0,13,13,winter
2012-09-28,4,2,0,1,3,1,9,10,winter
2012-09-28,4,3,0,1,2,0,7,7,winter
2012-09-28,4,4,0,1,3,2,10,12,winter
2012-09-28,4,5,0,1,1,1,37,38,winter
2012-09-28,4,6,0,1,2,2,136,138,winter
2012-09-28,4,7,0,1,2,10,384,394,winter
2012-09-28,4,8,0,1,1,31,674,705,winter
2012-09-28,4,9,0,1,2,27,399,426,winter
2012-09-28,4,10,0,1,2,51,194,245,winter
2012-09-28,4,11,0,1,2,109,252,361,winter
2012-09-28,4,12,0,1,2,94,286,380,winter
2012-09-28,4,13,0,1,2,106,304,410,winter
2012-09-28,4,14,0,1,2,105,294,399,winter
2012-09-28,4,15,0,1,2,104,288,392,winter
2012-09-28,4,16,0,1,2,83,419,502,winter
2012-09-28,4,17,0,1,2,101,707,808,winter
2012-09-28,4,18,0,1,2,58,609,667,winter
2012-09-28,4,19,0,1,3,38,470,508,winter
2012-09-28,4,20,0,1,3,32,304,336,winter
2012-09-28,4,21,0,1,3,32,205,237,winter
2012-09-28,4,22,0,1,2,30,190,220,winter
2012-09-28,4,23,0,1,2,26,164,190,winter
2012-09-29,4,0,0,0,1,15,134,149,winter
2012-09-29,4,1,0,0,1,12,89,101,winter
2012-09-29,4,2,0,0,2,12,80,92,winter
2012-09-29,4,3,0,0,2,4,25,29,winter
2012-09-29,4,4,0,0,1,6,8,14,winter
2012-09-29,4,5,0,0,1,2,13,15,winter
2012-09-29,4,6,0,0,1,4,33,37,winter
2012-09-29,4,7,0,0,1,12,61,73,winter
2012-09-29,4,8,0,0,1,37,174,211,winter
2012-09-29,4,9,0,0,1,69,263,332,winter
2012-09-29,4,10,0,0,1,134,338,472,winter
2012-09-29,4,11,0,0,1,217,446,663,winter
2012-09-29,4,12,0,0,1,191,491,682,winter
2012-09-29,4,13,0,0,1,233,453,686,winter
2012-09-29,4,14,0,0,1,302,448,750,winter
2012-09-29,4,15,0,0,1,271,456,727,winter
2012-09-29,4,16,0,0,1,275,447,722,winter
2012-09-29,4,17,0,0,1,256,456,712,winter
2012-09-29,4,18,0,0,1,174,420,594,winter
2012-09-29,4,19,0,0,1,119,351,470,winter
2012-09-29,4,20,0,0,1,88,227,315,winter
2012-09-29,4,21,0,0,1,73,219,292,winter
2012-09-29,4,22,0,0,1,48,173,221,winter
2012-09-29,4,23,0,0,1,35,161,196,winter
2012-09-30,4,0,0,0,1,35,112,147,winter
2012-09-30,4,1,0,0,1,31,85,116,winter
2012-09-30,4,2,0,0,1,21,71,92,winter
2012-09-30,4,3,0,0,1,17,41,58,winter
2012-09-30,4,4,0,0,1,1,6,7,winter
2012-09-30,4,5,0,0,1,1,9,10,winter
2012-09-30,4,6,0,0,1,2,20,22,winter
2012-09-30,4,7,0,0,1,14,43,57,winter
2012-09-30,4,8,0,0,1,18,126,144,winter
2012-09-30,4,9,0,0,1,74,211,285,winter
2012-09-30,4,10,0,0,1,160,319,479,winter
2012-09-30,4,11,0,0,1,222,369,591,winter
2012-09-30,4,12,0,0,1,206,474,680,winter
2012-09-30,4,13,0,0,1,180,414,594,winter
2012-09-30,4,14,0,0,1,208,404,612,winter
2012-09-30,4,15,0,0,1,230,419,649,winter
2012-09-30,4,16,0,0,1,202,446,648,winter
2012-09-30,4,17,0,0,1,195,380,575,winter
2012-09-30,4,18,0,0,1,91,310,401,winter
2012-09-30,4,19,0,0,3,34,223,257,winter
2012-09-30,4,20,0,0,3,31,163,194,winter
2012-09-30,4,21,0,0,1,19,104,123,winter
2012-09-30,4,22,0,0,1,15,76,91,winter
2012-09-30,4,23,0,0,1,8,49,57,winter
2012-10-01,4,0,0,1,1,6,39,45,winter
2012-10-01,4,1,0,1,1,5,13,18,winter
2012-10-01,4,2,0,1,1,6,6,12,winter
2012-10-01,4,3,0,1,1,1,6,7,winter
2012-10-01,4,4,0,1,1,0,10,10,winter
2012-10-01,4,5,0,1,1,2,34,36,winter
2012-10-01,4,6,0,1,1,8,147,155,winter
2012-10-01,4,7,0,1,1,13,470,483,winter
2012-10-01,4,8,0,1,2,40,744,784,winter
2012-10-01,4,9,0,1,2,26,314,340,winter
2012-10-01,4,10,0,1,1,44,135,179,winter
2012-10-01,4,11,0,1,1,76,196,272,winter
2012-10-01,4,12,0,1,2,61,262,323,winter
2012-10-01,4,13,0,1,2,80,225,305,winter
2012-10-01,4,14,0,1,2,51,193,244,winter
2012-10-01,4,15,0,1,2,95,234,329,winter
2012-10-01,4,16,0,1,2,51,408,459,winter
2012-10-01,4,17,0,1,3,65,791,856,winter
2012-10-01,4,18,0,1,3,42,571,613,winter
2012-10-01,4,19,0,1,2,33,483,516,winter
2012-10-01,4,20,0,1,3,11,251,262,winter
2012-10-01,4,21,0,1,2,13,205,218,winter
2012-10-01,4,22,0,1,3,17,190,207,winter
2012-10-01,4,23,0,1,3,17,88,105,winter
2012-10-02,4,0,0,1,2,1,30,31,winter
2012-10-02,4,1,0,1,2,0,11,11,winter
2012-10-02,4,2,0,1,2,0,2,2,winter
2012-10-02,4,3,0,1,2,1,4,5,winter
2012-10-02,4,4,0,1,2,2,8,10,winter
2012-10-02,4,5,0,1,2,1,42,43,winter
2012-10-02,4,6,0,1,3,3,176,179,winter
2012-10-02,4,7,0,1,3,4,256,260,winter
2012-10-02,4,8,0,1,3,6,128,134,winter
2012-10-02,4,9,0,1,3,3,83,86,winter
2012-10-02,4,10,0,1,3,3,42,45,winter
2012-10-02,4,11,0,1,3,7,92,99,winter
2012-10-02,4,12,0,1,2,6,98,104,winter
2012-10-02,4,13,0,1,2,6,148,154,winter
2012-10-02,4,14,0,1,3,16,147,163,winter
2012-10-02,4,15,0,1,3,14,195,209,winter
2012-10-02,4,16,0,1,3,46,328,374,winter
2012-10-02,4,17,0,1,3,38,677,715,winter
2012-10-02,4,18,0,1,3,48,639,687,winter
2012-10-02,4,19,0,1,3,27,368,395,winter
2012-10-02,4,20,0,1,3,20,286,306,winter
2012-10-02,4,21,0,1,3,24,265,289,winter
2012-10-02,4,22,0,1,2,28,212,240,winter
2012-10-02,4,23,0,1,2,11,87,98,winter
2012-10-03,4,0,0,1,3,5,47,52,winter
2012-10-03,4,1,0,1,2,3,16,19,winter
2012-10-03,4,2,0,1,2,2,7,9,winter
2012-10-03,4,3,0,1,2,0,7,7,winter
2012-10-03,4,4,0,1,2,2,9,11,winter
2012-10-03,4,5,0,1,2,2,32,34,winter
2012-10-03,4,6,0,1,2,4,173,177,winter
2012-10-03,4,7,0,1,2,11,504,515,winter
2012-10-03,4,8,0,1,2,28,781,809,winter
2012-10-03,4,9,0,1,2,30,332,362,winter
2012-10-03,4,10,0,1,1,29,146,175,winter
2012-10-03,4,11,0,1,1,52,178,230,winter
2012-10-03,4,12,0,1,2,69,289,358,winter
2012-10-03,4,13,0,1,2,55,224,279,winter
2012-10-03,4,14,0,1,2,56,195,251,winter
2012-10-03,4,15,0,1,2,59,260,319,winter
2012-10-03,4,16,0,1,2,42,436,478,winter
2012-10-03,4,17,0,1,1,84,833,917,winter
2012-10-03,4,18,0,1,1,54,756,810,winter
2012-10-03,4,19,0,1,1,49,544,593,winter
2012-10-03,4,20,0,1,1,48,449,497,winter
2012-10-03,4,21,0,1,2,14,195,209,winter
2012-10-03,4,22,0,1,1,9,232,241,winter
2012-10-03,4,23,0,1,2,21,199,220,winter
2012-10-04,4,0,0,1,3,11,65,76,winter
2012-10-04,4,1,0,1,2,2,23,25,winter
2012-10-04,4,2,0,1,1,3,10,13,winter
2012-10-04,4,3,0,1,2,5,6,11,winter
2012-10-04,4,4,0,1,2,0,10,10,winter
2012-10-04,4,5,0,1,3,2,37,39,winter
2012-10-04,4,6,0,1,3,1,132,133,winter
2012-10-04,4,7,0,1,2,12,379,391,winter
2012-10-04,4,8,0,1,1,27,711,738,winter
2012-10-04,4,9,0,1,2,40,319,359,winter
2012-10-04,4,10,0,1,2,27,150,177,winter
2012-10-04,4,11,0,1,2,38,176,214,winter
2012-10-04,4,12,0,1,2,57,231,288,winter
2012-10-04,4,13,0,1,2,63,231,294,winter
2012-10-04,4,14,0,1,1,56,211,267,winter
2012-10-04,4,15,0,1,1,77,248,325,winter
2012-10-04,4,16,0,1,1,86,411,497,winter
2012-10-04,4,17,0,1,1,112,789,901,winter
2012-10-04,4,18,0,1,1,75,812,887,winter
2012-10-04,4,19,0,1,1,67,467,534,winter
2012-10-04,4,20,0,1,1,50,391,441,winter
2012-10-04,4,21,0,1,1,33,288,321,winter
2012-10-04,4,22,0,1,1,29,203,232,winter
2012-10-04,4,23,0,1,1,18,137,155,winter
2012-10-05,4,0,0,1,1,16,86,102,winter
2012-10-05,4,1,0,1,1,3,43,46,winter
2012-10-05,4,2,0,1,1,1,10,11,winter
2012-10-05,4,3,0,1,1,5,11,16,winter
2012-10-05,4,4,0,1,1,0,11,11,winter
2012-10-05,4,5,0,1,1,0,41,41,winter
2012-10-05,4,6,0,1,1,4,133,137,winter
2012-10-05,4,7,0,1,1,11,417,428,winter
2012-10-05,4,8,0,1,1,36,749,785,winter
2012-10-05,4,9,0,1,1,58,326,384,winter
2012-10-05,4,10,0,1,1,68,192,260,winter
2012-10-05,4,11,0,1,1,90,214,304,winter
2012-10-05,4,12,0,1,1,161,307,468,winter
2012-10-05,4,13,0,1,1,117,307,424,winter
2012-10-05,4,14,0,1,1,113,287,400,winter
2012-10-05,4,15,0,1,1,150,320,470,winter
2012-10-05,4,16,0,1,1,153,481,634,winter
2012-10-05,4,17,0,1,1,158,742,900,winter
2012-10-05,4,18,0,1,1,106,655,761,winter
2012-10-05,4,19,0,1,1,67,433,500,winter
2012-10-05,4,20,0,1,1,66,306,372,winter
2012-10-05,4,21,0,1,1,47,220,267,winter
2012-10-05,4,22,0,1,1,63,201,264,winter
2012-10-05,4,23,0,1,1,23,148,171,winter
2012-10-06,4,0,0,0,1,37,154,191,winter
2012-10-06,4,1,0,0,1,25,116,141,winter
2012-10-06,4,2,0,0,1,13,62,75,winter
2012-10-06,4,3,0,0,1,2,54,56,winter
2012-10-06,4,4,0,0,1,4,7,11,winter
2012-10-06,4,5,0,0,1,2,8,10,winter
2012-10-06,4,6,0,0,1,2,28,30,winter
2012-10-06,4,7,0,0,1,13,71,84,winter
2012-10-06,4,8,0,0,1,22,184,206,winter
2012-10-06,4,9,0,0,1,130,265,395,winter
2012-10-06,4,10,0,0,1,198,341,539,winter
2012-10-06,4,11,0,0,1,258,389,647,winter
2012-10-06,4,12,0,0,1,362,381,743,winter
2012-10-06,4,13,0,0,2,310,400,710,winter
2012-10-06,4,14,0,0,2,269,307,576,winter
2012-10-06,4,15,0,0,1,279,341,620,winter
2012-10-06,4,16,0,0,1,317,342,659,winter
2012-10-06,4,17,0,0,1,268,342,610,winter
2012-10-06,4,18,0,0,1,183,312,495,winter
2012-10-06,4,19,0,0,1,102,239,341,winter
2012-10-06,4,20,0,0,1,75,172,247,winter
2012-10-06,4,21,0,0,1,78,137,215,winter
2012-10-06,4,22,0,0,1,45,140,185,winter
2012-10-06,4,23,0,0,1,37,142,179,winter
2012-10-07,4,0,0,0,1,28,99,127,winter
2012-10-07,4,1,0,0,1,29,80,109,winter
2012-10-07,4,2,0,0,1,10,64,74,winter
2012-10-07,4,3,0,0,2,5,17,22,winter
2012-10-07,4,4,0,0,2,5,6,11,winter
2012-10-07,4,5,0,0,2,2,8,10,winter
2012-10-07,4,6,0,0,2,4,19,23,winter
2012-10-07,4,7,0,0,3,6,29,35,winter
2012-10-07,4,8,0,0,3,11,51,62,winter
2012-10-07,4,9,0,0,3,16,70,86,winter
2012-10-07,4,10,0,0,2,41,144,185,winter
2012-10-07,4,11,0,0,2,76,260,336,winter
2012-10-07,4,12,0,0,2,100,292,392,winter
2012-10-07,4,13,0,0,2,80,240,320,winter
2012-10-07,4,14,0,0,2,71,243,314,winter
2012-10-07,4,15,0,0,3,74,232,306,winter
2012-10-07,4,16,0,0,3,87,246,333,winter
2012-10-07,4,17,0,0,3,35,122,157,winter
2012-10-07,4,18,0,0,3,24,82,106,winter
2012-10-07,4,19,0,0,2,17,97,114,winter
2012-10-07,4,20,0,0,1,19,97,116,winter
2012-10-07,4,21,0,0,1,22,91,113,winter
2012-10-07,4,22,0,0,1,7,72,79,winter
2012-10-07,4,23,0,0,1,12,68,80,winter
2012-10-08,4,0,1,0,1,7,44,51,winter
2012-10-08,4,1,1,0,1,2,35,37,winter
2012-10-08,4,2,1,0,1,3,12,15,winter
2012-10-08,4,3,1,0,1,2,8,10,winter
2012-10-08,4,4,1,0,1,1,6,7,winter
2012-10-08,4,5,1,0,1,2,17,19,winter
2012-10-08,4,6,1,0,1,5,54,59,winter
2012-10-08,4,7,1,0,2,3,151,154,winter
2012-10-08,4,8,1,0,2,23,374,397,winter
2012-10-08,4,9,1,0,2,59,273,332,winter
2012-10-08,4,10,1,0,2,69,229,298,winter
2012-10-08,4,11,1,0,2,72,236,308,winter
2012-10-08,4,12,1,0,2,74,267,341,winter
2012-10-08,4,13,1,0,2,82,323,405,winter
2012-10-08,4,14,1,0,2,121,299,420,winter
2012-10-08,4,15,1,0,3,76,294,370,winter
2012-10-08,4,16,1,0,3,61,316,377,winter
2012-10-08,4,17,1,0,2,81,416,497,winter
2012-10-08,4,18,1,0,2,41,415,456,winter
2012-10-08,4,19,1,0,2,38,333,371,winter
2012-10-08,4,20,1,0,3,20,207,227,winter
2012-10-08,4,21,1,0,2,17,134,151,winter
2012-10-08,4,22,1,0,3,6,101,107,winter
2012-10-08,4,23,1,0,2,9,60,69,winter
2012-10-09,4,0,0,1,2,9,22,31,winter
2012-10-09,4,1,0,1,3,0,13,13,winter
2012-10-09,4,2,0,1,3,2,5,7,winter
2012-10-09,4,3,0,1,3,0,3,3,winter
2012-10-09,4,4,0,1,3,1,6,7,winter
2012-10-09,4,5,0,1,2,0,19,19,winter
2012-10-09,4,6,0,1,2,2,141,143,winter
2012-10-09,4,7,0,1,1,5,357,362,winter
2012-10-09,4,8,0,1,2,15,698,713,winter
2012-10-09,4,9,0,1,2,37,345,382,winter
2012-10-09,4,10,0,1,2,33,131,164,winter
2012-10-09,4,11,0,1,2,37,156,193,winter
2012-10-09,4,12,0,1,2,43,217,260,winter
2012-10-09,4,13,0,1,2,54,184,238,winter
2012-10-09,4,14,0,1,2,43,201,244,winter
2012-10-09,4,15,0,1,2,59,195,254,winter
2012-10-09,4,16,0,1,2,70,354,424,winter
2012-10-09,4,17,0,1,2,73,733,806,winter
2012-10-09,4,18,0,1,2,26,758,784,winter
2012-10-09,4,19,0,1,2,31,483,514,winter
2012-10-09,4,20,0,1,2,30,330,360,winter
2012-10-09,4,21,0,1,2,16,209,225,winter
2012-10-09,4,22,0,1,2,7,155,162,winter
2012-10-09,4,23,0,1,2,8,76,84,winter
2012-10-10,4,0,0,1,2,0,33,33,winter
2012-10-10,4,1,0,1,2,2,6,8,winter
2012-10-10,4,2,0,1,2,2,6,8,winter
2012-10-10,4,3,0,1,2,0,6,6,winter
2012-10-10,4,4,0,1,2,0,6,6,winter
2012-10-10,4,5,0,1,2,2,38,40,winter
2012-10-10,4,6,0,1,2,3,172,175,winter
2012-10-10,4,7,0,1,1,9,498,507,winter
2012-10-10,4,8,0,1,1,33,806,839,winter
2012-10-10,4,9,0,1,1,35,331,366,winter
2012-10-10,4,10,0,1,1,27,190,217,winter
2012-10-10,4,11,0,1,1,53,238,291,winter
2012-10-10,4,12,0,1,1,78,312,390,winter
2012-10-10,4,13,0,1,1,60,237,297,winter
2012-10-10,4,14,0,1,1,63,208,271,winter
2012-10-10,4,15,0,1,1,58,261,319,winter
2012-10-10,4,16,0,1,1,92,474,566,winter
2012-10-10,4,17,0,1,1,91,857,948,winter
2012-10-10,4,18,0,1,2,57,787,844,winter
2012-10-10,4,19,0,1,2,32,534,566,winter
2012-10-10,4,20,0,1,1,21,371,392,winter
2012-10-10,4,21,0,1,1,18,251,269,winter
2012-10-10,4,22,0,1,1,27,170,197,winter
2012-10-10,4,23,0,1,1,17,119,136,winter
2012-10-11,4,0,0,1,1,1,41,42,winter
2012-10-11,4,1,0,1,1,1,10,11,winter
2012-10-11,4,2,0,1,1,4,7,11,winter
2012-10-11,4,3,0,1,1,0,3,3,winter
2012-10-11,4,4,0,1,1,0,10,10,winter
2012-10-11,4,5,0,1,1,0,42,42,winter
2012-10-11,4,6,0,1,1,1,158,159,winter
2012-10-11,4,7,0,1,1,11,467,478,winter
2012-10-11,4,8,0,1,1,25,773,798,winter
2012-10-11,4,9,0,1,1,27,328,355,winter
2012-10-11,4,10,0,1,1,39,165,204,winter
2012-10-11,4,11,0,1,1,76,175,251,winter
2012-10-11,4,12,0,1,1,47,279,326,winter
2012-10-11,4,13,0,1,1,48,243,291,winter
2012-10-11,4,14,0,1,1,78,270,348,winter
2012-10-11,4,15,0,1,1,102,358,460,winter
2012-10-11,4,16,0,1,1,68,413,481,winter
2012-10-11,4,17,0,1,1,90,737,827,winter
2012-10-11,4,18,0,1,1,64,628,692,winter
2012-10-11,4,19,0,1,1,81,662,743,winter
2012-10-11,4,20,0,1,1,27,388,415,winter
2012-10-11,4,21,0,1,1,24,236,260,winter
2012-10-11,4,22,0,1,1,10,167,177,winter
2012-10-11,4,23,0,1,1,10,176,186,winter
2012-10-12,4,0,0,1,1,8,60,68,winter
2012-10-12,4,1,0,1,1,8,29,37,winter
2012-10-12,4,2,0,1,1,0,16,16,winter
2012-10-12,4,3,0,1,1,0,6,6,winter
2012-10-12,4,4,0,1,1,0,8,8,winter
2012-10-12,4,5,0,1,1,2,33,35,winter
2012-10-12,4,6,0,1,1,3,140,143,winter
2012-10-12,4,7,0,1,1,8,384,392,winter
2012-10-12,4,8,0,1,1,34,711,745,winter
2012-10-12,4,9,0,1,1,26,374,400,winter
2012-10-12,4,10,0,1,1,75,200,275,winter
2012-10-12,4,11,0,1,1,61,252,313,winter
2012-10-12,4,12,0,1,1,75,312,387,winter
2012-10-12,4,13,0,1,1,81,300,381,winter
2012-10-12,4,14,0,1,1,109,262,371,winter
2012-10-12,4,15,0,1,1,138,317,455,winter
2012-10-12,4,16,0,1,1,108,412,520,winter
2012-10-12,4,17,0,1,1,131,706,837,winter
2012-10-12,4,18,0,1,1,76,566,642,winter
2012-10-12,4,19,0,1,1,40,453,493,winter
2012-10-12,4,20,0,1,1,28,280,308,winter
2012-10-12,4,21,0,1,1,21,169,190,winter
2012-10-12,4,22,0,1,1,17,143,160,winter
2012-10-12,4,23,0,1,1,11,89,100,winter
2012-10-13,4,0,0,0,1,31,218,249,winter
2012-10-13,4,1,0,0,1,23,123,146,winter
2012-10-13,4,2,0,0,1,7,60,67,winter
2012-10-13,4,3,0,0,1,2,13,15,winter
2012-10-13,4,4,0,0,1,2,9,11,winter
2012-10-13,4,5,0,0,1,0,11,11,winter
2012-10-13,4,6,0,0,1,5,23,28,winter
2012-10-13,4,7,0,0,1,10,60,70,winter
2012-10-13,4,8,0,0,1,23,151,174,winter
2012-10-13,4,9,0,0,1,46,220,266,winter
2012-10-13,4,10,0,0,1,82,265,347,winter
2012-10-13,4,11,0,0,1,192,335,527,winter
2012-10-13,4,12,0,0,1,202,371,573,winter
2012-10-13,4,13,0,0,1,235,435,670,winter
2012-10-13,4,14,0,0,1,243,354,597,winter
2012-10-13,4,15,0,0,1,251,364,615,winter
2012-10-13,4,16,0,0,1,294,343,637,winter
2012-10-13,4,17,0,0,1,193,335,528,winter
2012-10-13,4,18,0,0,1,174,299,473,winter
2012-10-13,4,19,0,0,1,73,259,332,winter
2012-10-13,4,20,0,0,1,57,198,255,winter
2012-10-13,4,21,0,0,1,47,157,204,winter
2012-10-13,4,22,0,0,1,33,156,189,winter
2012-10-13,4,23,0,0,1,27,98,125,winter
2012-10-14,4,0,0,0,1,8,103,111,winter
2012-10-14,4,1,0,0,1,16,96,112,winter
2012-10-14,4,2,0,0,1,8,58,66,winter
2012-10-14,4,3,0,0,1,3,25,28,winter
2012-10-14,4,4,0,0,1,2,10,12,winter
2012-10-14,4,5,0,0,1,5,6,11,winter
2012-10-14,4,6,0,0,1,4,20,24,winter
2012-10-14,4,7,0,0,1,7,44,51,winter
2012-10-14,4,8,0,0,1,28,104,132,winter
2012-10-14,4,9,0,0,2,62,161,223,winter
2012-10-14,4,10,0,0,1,150,278,428,winter
2012-10-14,4,11,0,0,1,156,338,494,winter
2012-10-14,4,12,0,0,1,200,362,562,winter
2012-10-14,4,13,0,0,1,218,401,619,winter
2012-10-14,4,14,0,0,1,249,368,617,winter
2012-10-14,4,15,0,0,1,213,355,568,winter
2012-10-14,4,16,0,0,1,203,378,581,winter
2012-10-14,4,17,0,0,1,193,346,539,winter
2012-10-14,4,18,0,0,1,134,319,453,winter
2012-10-14,4,19,0,0,1,68,268,336,winter
2012-10-14,4,20,0,0,1,48,198,246,winter
2012-10-14,4,21,0,0,1,40,156,196,winter
2012-10-14,4,22,0,0,1,38,87,125,winter
2012-10-14,4,23,0,0,2,27,78,105,winter
2012-10-15,4,0,0,1,2,17,31,48,winter
2012-10-15,4,1,0,1,2,5,24,29,winter
2012-10-15,4,2,0,1,2,1,5,6,winter
2012-10-15,4,3,0,1,2,2,2,4,winter
2012-10-15,4,4,0,1,2,1,9,10,winter
2012-10-15,4,5,0,1,2,2,38,40,winter
2012-10-15,4,6,0,1,2,6,141,147,winter
2012-10-15,4,7,0,1,2,15,461,476,winter
2012-10-15,4,8,0,1,2,24,713,737,winter
2012-10-15,4,9,0,1,3,31,328,359,winter
2012-10-15,4,10,0,1,2,43,125,168,winter
2012-10-15,4,11,0,1,2,88,175,263,winter
2012-10-15,4,12,0,1,3,73,211,284,winter
2012-10-15,4,13,0,1,2,37,109,146,winter
2012-10-15,4,14,0,1,2,57,128,185,winter
2012-10-15,4,15,0,1,1,70,190,260,winter
2012-10-15,4,16,0,1,1,76,371,447,winter
2012-10-15,4,17,0,1,1,96,670,766,winter
2012-10-15,4,18,0,1,3,52,540,592,winter
2012-10-15,4,19,0,1,3,12,227,239,winter
2012-10-15,4,20,0,1,2,19,237,256,winter
2012-10-15,4,21,0,1,1,16,190,206,winter
2012-10-15,4,22,0,1,1,8,118,126,winter
2012-10-15,4,23,0,1,1,9,72,81,winter
2012-10-16,4,0,0,1,1,3,45,48,winter
2012-10-16,4,1,0,1,1,4,9,13,winter
2012-10-16,4,2,0,1,1,2,1,3,winter
2012-10-16,4,3,0,1,1,0,2,2,winter
2012-10-16,4,4,0,1,1,0,7,7,winter
2012-10-16,4,5,0,1,1,5,47,52,winter
2012-10-16,4,6,0,1,1,4,168,172,winter
2012-10-16,4,7,0,1,1,20,505,525,winter
2012-10-16,4,8,0,1,1,35,800,835,winter
2012-10-16,4,9,0,1,1,32,323,355,winter
2012-10-16,4,10,0,1,1,65,157,222,winter
2012-10-16,4,11,0,1,1,56,172,228,winter
2012-10-16,4,12,0,1,2,69,256,325,winter
2012-10-16,4,13,0,1,1,68,260,328,winter
2012-10-16,4,14,0,1,1,94,214,308,winter
2012-10-16,4,15,0,1,1,76,270,346,winter
2012-10-16,4,16,0,1,1,79,367,446,winter
2012-10-16,4,17,0,1,1,104,839,943,winter
2012-10-16,4,18,0,1,1,71,767,838,winter
2012-10-16,4,19,0,1,1,40,491,531,winter
2012-10-16,4,20,0,1,1,35,397,432,winter
2012-10-16,4,21,0,1,1,19,176,195,winter
2012-10-16,4,22,0,1,1,18,163,181,winter
2012-10-16,4,23,0,1,1,23,176,199,winter
2012-10-17,4,0,0,1,1,1,48,49,winter
2012-10-17,4,1,0,1,1,3,14,17,winter
2012-10-17,4,2,0,1,1,4,12,16,winter
2012-10-17,4,3,0,1,1,0,7,7,winter
2012-10-17,4,4,0,1,1,0,4,4,winter
2012-10-17,4,5,0,1,2,2,39,41,winter
2012-10-17,4,6,0,1,1,7,171,178,winter
2012-10-17,4,7,0,1,1,15,449,464,winter
2012-10-17,4,8,0,1,2,38,779,817,winter
2012-10-17,4,9,0,1,2,38,344,382,winter
2012-10-17,4,10,0,1,2,60,168,228,winter
2012-10-17,4,11,0,1,2,78,156,234,winter
2012-10-17,4,12,0,1,2,71,261,332,winter
2012-10-17,4,13,0,1,2,73,237,310,winter
2012-10-17,4,14,0,1,2,82,188,270,winter
2012-10-17,4,15,0,1,2,62,239,301,winter
2012-10-17,4,16,0,1,1,70,396,466,winter
2012-10-17,4,17,0,1,1,122,766,888,winter
2012-10-17,4,18,0,1,1,90,794,884,winter
2012-10-17,4,19,0,1,1,49,467,516,winter
2012-10-17,4,20,0,1,1,54,360,414,winter
2012-10-17,4,21,0,1,1,28,301,329,winter
2012-10-17,4,22,0,1,1,17,198,215,winter
2012-10-17,4,23,0,1,1,15,84,99,winter
2012-10-18,4,0,0,1,1,4,53,57,winter
2012-10-18,4,1,0,1,1,0,14,14,winter
2012-10-18,4,2,0,1,1,1,13,14,winter
2012-10-18,4,3,0,1,1,0,5,5,winter
2012-10-18,4,4,0,1,1,0,5,5,winter
2012-10-18,4,5,0,1,1,1,41,42,winter
2012-10-18,4,6,0,1,1,3,150,153,winter
2012-10-18,4,7,0,1,1,20,488,508,winter
2012-10-18,4,8,0,1,1,31,803,834,winter
2012-10-18,4,9,0,1,2,41,346,387,winter
2012-10-18,4,10,0,1,2,60,158,218,winter
2012-10-18,4,11,0,1,2,79,189,268,winter
2012-10-18,4,12,0,1,2,93,284,377,winter
2012-10-18,4,13,0,1,1,96,236,332,winter
2012-10-18,4,14,0,1,2,94,191,285,winter
2012-10-18,4,15,0,1,2,69,284,353,winter
2012-10-18,4,16,0,1,1,94,356,450,winter
2012-10-18,4,17,0,1,2,102,788,890,winter
2012-10-18,4,18,0,1,2,68,720,788,winter
2012-10-18,4,19,0,1,2,42,471,513,winter
2012-10-18,4,20,0,1,2,39,348,387,winter
2012-10-18,4,21,0,1,2,38,245,283,winter
2012-10-18,4,22,0,1,2,27,202,229,winter
2012-10-18,4,23,0,1,2,6,111,117,winter
2012-10-19,4,0,0,1,2,5,51,56,winter
2012-10-19,4,1,0,1,3,4,12,16,winter
2012-10-19,4,2,0,1,2,1,9,10,winter
2012-10-19,4,3,0,1,2,0,5,5,winter
2012-10-19,4,4,0,1,2,1,5,6,winter
2012-10-19,4,5,0,1,2,1,35,36,winter
2012-10-19,4,6,0,1,3,5,126,131,winter
2012-10-19,4,7,0,1,3,5,149,154,winter
2012-10-19,4,8,0,1,2,20,447,467,winter
2012-10-19,4,9,0,1,2,26,363,389,winter
2012-10-19,4,10,0,1,2,26,198,224,winter
2012-10-19,4,11,0,1,1,41,211,252,winter
2012-10-19,4,12,0,1,1,74,258,332,winter
2012-10-19,4,13,0,1,1,87,288,375,winter
2012-10-19,4,14,0,1,1,88,277,365,winter
2012-10-19,4,15,0,1,1,93,302,395,winter
2012-10-19,4,16,0,1,3,131,434,565,winter
2012-10-19,4,17,0,1,3,48,377,425,winter
2012-10-19,4,18,0,1,1,21,212,233,winter
2012-10-19,4,19,0,1,1,19,213,232,winter
2012-10-19,4,20,0,1,1,13,216,229,winter
2012-10-19,4,21,0,1,1,17,189,206,winter
2012-10-19,4,22,0,1,1,14,176,190,winter
2012-10-19,4,23,0,1,1,13,118,131,winter
2012-10-20,4,0,0,0,1,13,110,123,winter
2012-10-20,4,1,0,0,1,2,93,95,winter
2012-10-20,4,2,0,0,1,9,69,78,winter
2012-10-20,4,3,0,0,1,2,27,29,winter
2012-10-20,4,4,0,0,1,9,9,18,winter
2012-10-20,4,5,0,0,1,6,7,13,winter
2012-10-20,4,6,0,0,1,5,26,31,winter
2012-10-20,4,7,0,0,1,6,59,65,winter
2012-10-20,4,8,0,0,1,29,164,193,winter
2012-10-20,4,9,0,0,1,106,257,363,winter
2012-10-20,4,10,0,0,1,111,312,423,winter
2012-10-20,4,11,0,0,1,204,408,612,winter
2012-10-20,4,12,0,0,1,267,436,703,winter
2012-10-20,4,13,0,0,1,273,441,714,winter
2012-10-20,4,14,0,0,1,335,376,711,winter
2012-10-20,4,15,0,0,1,308,403,711,winter
2012-10-20,4,16,0,0,1,325,366,691,winter
2012-10-20,4,17,0,0,1,347,384,731,winter
2012-10-20,4,18,0,0,1,165,356,521,winter
2012-10-20,4,19,0,0,1,77,268,345,winter
2012-10-20,4,20,0,0,1,61,198,259,winter
2012-10-20,4,21,0,0,1,72,224,296,winter
2012-10-20,4,22,0,0,1,47,155,202,winter
2012-10-20,4,23,0,0,1,27,136,163,winter
2012-10-21,4,0,0,0,1,35,119,154,winter
2012-10-21,4,1,0,0,1,20,97,117,winter
2012-10-21,4,2,0,0,1,44,88,132,winter
2012-10-21,4,3,0,0,1,12,29,41,winter
2012-10-21,4,4,0,0,1,8,13,21,winter
2012-10-21,4,5,0,0,1,6,4,10,winter
2012-10-21,4,6,0,0,1,8,18,26,winter
2012-10-21,4,7,0,0,1,13,43,56,winter
2012-10-21,4,8,0,0,1,39,104,143,winter
2012-10-21,4,9,0,0,1,77,192,269,winter
2012-10-21,4,10,0,0,1,167,276,443,winter
2012-10-21,4,11,0,0,1,191,356,547,winter
2012-10-21,4,12,0,0,1,236,439,675,winter
2012-10-21,4,13,0,0,1,243,383,626,winter
2012-10-21,4,14,0,0,1,235,405,640,winter
2012-10-21,4,15,0,0,1,240,383,623,winter
2012-10-21,4,16,0,0,1,182,409,591,winter
2012-10-21,4,17,0,0,1,153,338,491,winter
2012-10-21,4,18,0,0,1,71,342,413,winter
2012-10-21,4,19,0,0,1,50,216,266,winter
2012-10-21,4,20,0,0,1,35,160,195,winter
2012-10-21,4,21,0,0,1,42,124,166,winter
2012-10-21,4,22,0,0,1,18,95,113,winter
2012-10-21,4,23,0,0,1,7,59,66,winter
2012-10-22,4,0,0,1,1,3,28,31,winter
2012-10-22,4,1,0,1,1,0,11,11,winter
2012-10-22,4,2,0,1,1,1,4,5,winter
2012-10-22,4,3,0,1,1,1,5,6,winter
2012-10-22,4,4,0,1,1,1,6,7,winter
2012-10-22,4,5,0,1,1,2,44,46,winter
2012-10-22,4,6,0,1,1,4,140,144,winter
2012-10-22,4,7,0,1,1,15,437,452,winter
2012-10-22,4,8,0,1,1,32,696,728,winter
2012-10-22,4,9,0,1,1,25,335,360,winter
2012-10-22,4,10,0,1,1,51,161,212,winter
2012-10-22,4,11,0,1,1,63,148,211,winter
2012-10-22,4,12,0,1,1,52,231,283,winter
2012-10-22,4,13,0,1,1,88,227,315,winter
2012-10-22,4,14,0,1,1,73,209,282,winter
2012-10-22,4,15,0,1,1,74,222,296,winter
2012-10-22,4,16,0,1,1,80,444,524,winter
2012-10-22,4,17,0,1,1,84,838,922,winter
2012-10-22,4,18,0,1,1,60,726,786,winter
2012-10-22,4,19,0,1,1,36,478,514,winter
2012-10-22,4,20,0,1,1,21,382,403,winter
2012-10-22,4,21,0,1,1,19,155,174,winter
2012-10-22,4,22,0,1,1,25,158,183,winter
2012-10-22,4,23,0,1,1,20,143,163,winter
2012-10-23,4,0,0,1,1,5,32,37,winter
2012-10-23,4,1,0,1,1,1,16,17,winter
2012-10-23,4,2,0,1,1,1,6,7,winter
2012-10-23,4,3,0,1,1,0,1,1,winter
2012-10-23,4,4,0,1,1,1,6,7,winter
2012-10-23,4,5,0,1,1,1,49,50,winter
2012-10-23,4,6,0,1,1,6,152,158,winter
2012-10-23,4,7,0,1,2,12,519,531,winter
2012-10-23,4,8,0,1,2,28,733,761,winter
2012-10-23,4,9,0,1,2,29,305,334,winter
2012-10-23,4,10,0,1,1,50,171,221,winter
2012-10-23,4,11,0,1,1,52,201,253,winter
2012-10-23,4,12,0,1,2,80,298,378,winter
2012-10-23,4,13,0,1,2,59,244,303,winter
2012-10-23,4,14,0,1,1,67,229,296,winter
2012-10-23,4,15,0,1,1,76,270,346,winter
2012-10-23,4,16,0,1,1,108,433,541,winter
2012-10-23,4,17,0,1,1,67,871,938,winter
2012-10-23,4,18,0,1,1,64,762,826,winter
2012-10-23,4,19,0,1,1,25,457,482,winter
2012-10-23,4,20,0,1,1,45,334,379,winter
2012-10-23,4,21,0,1,1,35,260,295,winter
2012-10-23,4,22,0,1,1,20,174,194,winter
2012-10-23,4,23,0,1,1,9,102,111,winter
2012-10-24,4,0,0,1,1,7,39,46,winter
2012-10-24,4,1,0,1,1,4,23,27,winter
2012-10-24,4,2,0,1,1,0,6,6,winter
2012-10-24,4,3,0,1,1,0,4,4,winter
2012-10-24,4,4,0,1,1,1,5,6,winter
2012-10-24,4,5,0,1,1,1,52,53,winter
2012-10-24,4,6,0,1,1,11,162,173,winter
2012-10-24,4,7,0,1,1,20,506,526,winter
2012-10-24,4,8,0,1,2,24,777,801,winter
2012-10-24,4,9,0,1,2,24,349,373,winter
2012-10-24,4,10,0,1,2,29,142,171,winter
2012-10-24,4,11,0,1,1,47,189,236,winter
2012-10-24,4,12,0,1,1,48,268,316,winter
2012-10-24,4,13,0,1,1,65,241,306,winter
2012-10-24,4,14,0,1,1,64,237,301,winter
2012-10-24,4,15,0,1,1,63,245,308,winter
2012-10-24,4,16,0,1,1,67,465,532,winter
2012-10-24,4,17,0,1,1,87,876,963,winter
2012-10-24,4,18,0,1,1,63,795,858,winter
2012-10-24,4,19,0,1,2,50,522,572,winter
2012-10-24,4,20,0,1,2,45,396,441,winter
2012-10-24,4,21,0,1,2,33,280,313,winter
2012-10-24,4,22,0,1,2,30,208,238,winter
2012-10-24,4,23,0,1,2,12,111,123,winter
2012-10-25,4,0,0,1,2,19,57,76,winter
2012-10-25,4,1,0,1,1,6,22,28,winter
2012-10-25,4,2,0,1,1,3,15,18,winter
2012-10-25,4,3,0,1,2,0,8,8,winter
2012-10-25,4,4,0,1,2,1,4,5,winter
2012-10-25,4,5,0,1,2,2,53,55,winter
2012-10-25,4,6,0,1,2,3,168,171,winter
2012-10-25,4,7,0,1,2,18,477,495,winter
2012-10-25,4,8,0,1,2,33,746,779,winter
2012-10-25,4,9,0,1,2,23,320,343,winter
2012-10-25,4,10,0,1,2,53,172,225,winter
2012-10-25,4,11,0,1,2,57,181,238,winter
2012-10-25,4,12,0,1,2,61,258,319,winter
2012-10-25,4,13,0,1,2,49,264,313,winter
2012-10-25,4,14,0,1,1,71,214,285,winter
2012-10-25,4,15,0,1,1,63,242,305,winter
2012-10-25,4,16,0,1,1,92,407,499,winter
2012-10-25,4,17,0,1,1,112,774,886,winter
2012-10-25,4,18,0,1,1,77,732,809,winter
2012-10-25,4,19,0,1,1,45,497,542,winter
2012-10-25,4,20,0,1,2,28,319,347,winter
2012-10-25,4,21,0,1,2,24,247,271,winter
2012-10-25,4,22,0,1,2,22,185,207,winter
2012-10-25,4,23,0,1,2,13,122,135,winter
2012-10-26,4,0,0,1,2,6,65,71,winter
2012-10-26,4,1,0,1,2,4,32,36,winter
2012-10-26,4,2,0,1,2,4,15,19,winter
2012-10-26,4,3,0,1,2,5,8,13,winter
2012-10-26,4,4,0,1,2,1,4,5,winter
2012-10-26,4,5,0,1,2,3,47,50,winter
2012-10-26,4,6,0,1,2,2,142,144,winter
2012-10-26,4,7,0,1,2,13,408,421,winter
2012-10-26,4,8,0,1,2,20,714,734,winter
2012-10-26,4,9,0,1,2,56,347,403,winter
2012-10-26,4,10,0,1,2,41,156,197,winter
2012-10-26,4,11,0,1,2,68,222,290,winter
2012-10-26,4,12,0,1,2,90,302,392,winter
2012-10-26,4,13,0,1,2,77,260,337,winter
2012-10-26,4,14,0,1,2,99,252,351,winter
2012-10-26,4,15,0,1,2,142,306,448,winter
2012-10-26,4,16,0,1,2,137,445,582,winter
2012-10-26,4,17,0,1,2,125,692,817,winter
2012-10-26,4,18,0,1,2,81,584,665,winter
2012-10-26,4,19,0,1,2,72,399,471,winter
2012-10-26,4,20,0,1,2,40,271,311,winter
2012-10-26,4,21,0,1,2,40,252,292,winter
2012-10-26,4,22,0,1,2,37,180,217,winter
2012-10-26,4,23,0,1,1,19,159,178,winter
2012-10-27,4,0,0,0,1,10,132,142,winter
2012-10-27,4,1,0,0,2,23,123,146,winter
2012-10-27,4,2,0,0,2,19,71,90,winter
2012-10-27,4,3,0,0,1,5,21,26,winter
2012-10-27,4,4,0,0,2,1,12,13,winter
2012-10-27,4,5,0,0,2,2,7,9,winter
2012-10-27,4,6,0,0,2,2,29,31,winter
2012-10-27,4,7,0,0,1,7,79,86,winter
2012-10-27,4,8,0,0,1,26,187,213,winter
2012-10-27,4,9,0,0,1,88,240,328,winter
2012-10-27,4,10,0,0,1,165,314,479,winter
2012-10-27,4,11,0,0,1,197,388,585,winter
2012-10-27,4,12,0,0,1,264,404,668,winter
2012-10-27,4,13,0,0,1,310,450,760,winter
2012-10-27,4,14,0,0,1,325,425,750,winter
2012-10-27,4,15,0,0,2,310,401,711,winter
2012-10-27,4,16,0,0,2,257,355,612,winter
2012-10-27,4,17,0,0,2,248,370,618,winter
2012-10-27,4,18,0,0,2,138,318,456,winter
2012-10-27,4,19,0,0,2,67,233,300,winter
2012-10-27,4,20,0,0,2,58,238,296,winter
2012-10-27,4,21,0,0,2,49,160,209,winter
2012-10-27,4,22,0,0,2,41,116,157,winter
2012-10-27,4,23,0,0,2,31,136,167,winter
2012-10-28,4,0,0,0,3,20,97,117,winter
2012-10-28,4,1,0,0,2,22,111,133,winter
2012-10-28,4,2,0,0,2,17,99,116,winter
2012-10-28,4,3,0,0,2,18,61,79,winter
2012-10-28,4,4,0,0,2,1,19,20,winter
2012-10-28,4,5,0,0,2,6,22,28,winter
2012-10-28,4,6,0,0,2,7,32,39,winter
2012-10-28,4,7,0,0,2,17,48,65,winter
2012-10-28,4,8,0,0,2,55,118,173,winter
2012-10-28,4,9,0,0,2,124,206,330,winter
2012-10-28,4,10,0,0,2,120,314,434,winter
2012-10-28,4,11,0,0,2,110,352,462,winter
2012-10-28,4,12,0,0,2,118,373,491,winter
2012-10-28,4,13,0,0,2,75,316,391,winter
2012-10-28,4,14,0,0,2,98,304,402,winter
2012-10-28,4,15,0,0,2,76,225,301,winter
2012-10-28,4,16,0,0,3,42,251,293,winter
2012-10-28,4,17,0,0,3,37,188,225,winter
2012-10-28,4,18,0,0,3,18,136,154,winter
2012-10-28,4,19,0,0,3,7,47,54,winter
2012-10-28,4,20,0,0,3,4,51,55,winter
2012-10-28,4,21,0,0,3,2,44,46,winter
2012-10-28,4,22,0,0,3,2,35,37,winter
2012-10-28,4,23,0,0,3,2,12,14,winter
2012-10-29,4,0,0,1,3,2,20,22,winter
2012-10-30,4,13,0,1,3,11,105,116,winter
2012-10-30,4,14,0,1,3,8,118,126,winter
2012-10-30,4,15,0,1,3,10,114,124,winter
2012-10-30,4,16,0,1,3,15,83,98,winter
2012-10-30,4,17,0,1,3,19,105,124,winter
2012-10-30,4,18,0,1,3,4,139,143,winter
2012-10-30,4,19,0,1,2,6,109,115,winter
2012-10-30,4,20,0,1,2,5,76,81,winter
2012-10-30,4,21,0,1,2,4,60,64,winter
2012-10-30,4,22,0,1,1,2,64,66,winter
2012-10-30,4,23,0,1,1,3,36,39,winter
2012-10-31,4,0,0,1,2,0,16,16,winter
2012-10-31,4,1,0,1,2,0,8,8,winter
2012-10-31,4,2,0,1,2,0,7,7,winter
2012-10-31,4,3,0,1,2,0,3,3,winter
2012-10-31,4,4,0,1,2,0,5,5,winter
2012-10-31,4,5,0,1,2,0,24,24,winter
2012-10-31,4,6,0,1,1,0,116,116,winter
2012-10-31,4,7,0,1,2,3,334,337,winter
2012-10-31,4,8,0,1,1,6,615,621,winter
2012-10-31,4,9,0,1,1,17,280,297,winter
2012-10-31,4,10,0,1,1,21,147,168,winter
2012-10-31,4,11,0,1,2,37,152,189,winter
2012-10-31,4,12,0,1,1,44,197,241,winter
2012-10-31,4,13,0,1,1,22,191,213,winter
2012-10-31,4,14,0,1,2,45,179,224,winter
2012-10-31,4,15,0,1,1,33,197,230,winter
2012-10-31,4,16,0,1,2,51,373,424,winter
2012-10-31,4,17,0,1,2,39,684,723,winter
2012-10-31,4,18,0,1,2,28,556,584,winter
2012-10-31,4,19,0,1,2,27,383,410,winter
2012-10-31,4,20,0,1,2,9,259,268,winter
2012-10-31,4,21,0,1,2,12,180,192,winter
2012-10-31,4,22,0,1,1,18,147,165,winter
2012-10-31,4,23,0,1,1,7,94,101,winter
2012-11-01,4,0,0,1,1,8,52,60,winter
2012-11-01,4,1,0,1,1,8,22,30,winter
2012-11-01,4,2,0,1,1,10,10,20,winter
2012-11-01,4,3,0,1,1,5,10,15,winter
2012-11-01,4,4,0,1,2,2,8,10,winter
2012-11-01,4,5,0,1,1,1,39,40,winter
2012-11-01,4,6,0,1,1,2,146,148,winter
2012-11-01,4,7,0,1,2,6,414,420,winter
2012-11-01,4,8,0,1,2,12,668,680,winter
2012-11-01,4,9,0,1,3,21,310,331,winter
2012-11-01,4,10,0,1,3,13,133,146,winter
2012-11-01,4,11,0,1,3,14,156,170,winter
2012-11-01,4,12,0,1,3,23,198,221,winter
2012-11-01,4,13,0,1,2,49,199,248,winter
2012-11-01,4,14,0,1,2,31,154,185,winter
2012-11-01,4,15,0,1,2,35,179,214,winter
2012-11-01,4,16,0,1,2,31,313,344,winter
2012-11-01,4,17,0,1,3,37,652,689,winter
2012-11-01,4,18,0,1,2,50,628,678,winter
2012-11-01,4,19,0,1,2,28,424,452,winter
2012-11-01,4,20,0,1,2,16,280,296,winter
2012-11-01,4,21,0,1,2,29,238,267,winter
2012-11-01,4,22,0,1,1,27,175,202,winter
2012-11-01,4,23,0,1,1,8,112,120,winter
2012-11-02,4,0,0,1,1,10,40,50,winter
2012-11-02,4,1,0,1,1,5,19,24,winter
2012-11-02,4,2,0,1,1,3,7,10,winter
2012-11-02,4,3,0,1,1,0,3,3,winter
2012-11-02,4,4,0,1,1,1,6,7,winter
2012-11-02,4,5,0,1,2,1,25,26,winter
2012-11-02,4,6,0,1,1,2,120,122,winter
2012-11-02,4,7,0,1,2,8,349,357,winter
2012-11-02,4,8,0,1,1,31,656,687,winter
2012-11-02,4,9,0,1,1,27,355,382,winter
2012-11-02,4,10,0,1,1,21,183,204,winter
2012-11-02,4,11,0,1,1,42,179,221,winter
2012-11-02,4,12,0,1,1,52,240,292,winter
2012-11-02,4,13,0,1,1,64,230,294,winter
2012-11-02,4,14,0,1,2,63,199,262,winter
2012-11-02,4,15,0,1,2,51,255,306,winter
2012-11-02,4,16,0,1,1,48,373,421,winter
2012-11-02,4,17,0,1,1,57,581,638,winter
2012-11-02,4,18,0,1,2,32,490,522,winter
2012-11-02,4,19,0,1,2,38,336,374,winter
2012-11-02,4,20,0,1,2,14,207,221,winter
2012-11-02,4,21,0,1,2,23,133,156,winter
2012-11-02,4,22,0,1,1,14,135,149,winter
2012-11-02,4,23,0,1,1,11,108,119,winter
2012-11-03,4,0,0,0,1,9,99,108,winter
2012-11-03,4,1,0,0,2,6,83,89,winter
2012-11-03,4,2,0,0,2,10,36,46,winter
2012-11-03,4,3,0,0,2,6,22,28,winter
2012-11-03,4,4,0,0,2,8,8,16,winter
2012-11-03,4,5,0,0,2,1,8,9,winter
2012-11-03,4,6,0,0,2,4,17,21,winter
2012-11-03,4,7,0,0,2,1,58,59,winter
2012-11-03,4,8,0,0,2,10,132,142,winter
2012-11-03,4,9,0,0,2,31,188,219,winter
2012-11-03,4,10,0,0,1,68,260,328,winter
2012-11-03,4,11,0,0,2,56,284,340,winter
2012-11-03,4,12,0,0,2,74,320,394,winter
2012-11-03,4,13,0,0,2,110,339,449,winter
2012-11-03,4,14,0,0,2,136,319,455,winter
2012-11-03,4,15,0,0,2,117,331,448,winter
2012-11-03,4,16,0,0,2,108,292,400,winter
2012-11-03,4,17,0,0,2,112,298,410,winter
2012-11-03,4,18,0,0,2,58,239,297,winter
2012-11-03,4,19,0,0,1,22,217,239,winter
2012-11-03,4,20,0,0,1,23,158,181,winter
2012-11-03,4,21,0,0,1,31,135,166,winter
2012-11-03,4,22,0,0,1,13,133,146,winter
2012-11-03,4,23,0,0,1,15,133,148,winter
2012-11-04,4,0,0,0,1,5,97,102,winter
2012-11-04,4,1,0,0,1,26,139,165,winter
2012-11-04,4,2,0,0,1,6,31,37,winter
2012-11-04,4,3,0,0,1,1,10,11,winter
2012-11-04,4,4,0,0,1,2,7,9,winter
2012-11-04,4,5,0,0,1,0,5,5,winter
2012-11-04,4,6,0,0,1,2,14,16,winter
2012-11-04,4,7,0,0,1,11,39,50,winter
2012-11-04,4,8,0,0,1,34,115,149,winter
2012-11-04,4,9,0,0,1,56,161,217,winter
2012-11-04,4,10,0,0,1,73,287,360,winter
2012-11-04,4,11,0,0,1,134,311,445,winter
2012-11-04,4,12,0,0,1,150,354,504,winter
2012-11-04,4,13,0,0,1,122,371,493,winter
2012-11-04,4,14,0,0,1,149,360,509,winter
2012-11-04,4,15,0,0,1,149,300,449,winter
2012-11-04,4,16,0,0,1,119,316,435,winter
2012-11-04,4,17,0,0,1,57,270,327,winter
2012-11-04,4,18,0,0,1,31,206,237,winter
2012-11-04,4,19,0,0,1,24,203,227,winter
2012-11-04,4,20,0,0,1,7,134,141,winter
2012-11-04,4,21,0,0,1,16,71,87,winter
2012-11-04,4,22,0,0,1,15,64,79,winter
2012-11-04,4,23,0,0,2,12,41,53,winter
2012-11-05,4,0,0,1,2,3,20,23,winter
2012-11-05,4,1,0,1,2,0,8,8,winter
2012-11-05,4,2,0,1,2,2,4,6,winter
2012-11-05,4,3,0,1,2,1,3,4,winter
2012-11-05,4,4,0,1,2,5,11,16,winter
2012-11-05,4,5,0,1,2,1,38,39,winter
2012-11-05,4,6,0,1,2,4,135,139,winter
2012-11-05,4,7,0,1,2,8,453,461,winter
2012-11-05,4,8,0,1,2,19,629,648,winter
2012-11-05,4,9,0,1,2,18,239,257,winter
2012-11-05,4,10,0,1,1,30,112,142,winter
2012-11-05,4,11,0,1,1,31,119,150,winter
2012-11-05,4,12,0,1,1,38,206,244,winter
2012-11-05,4,13,0,1,1,39,183,222,winter
2012-11-05,4,14,0,1,1,31,165,196,winter
2012-11-05,4,15,0,1,1,24,207,231,winter
2012-11-05,4,16,0,1,1,35,325,360,winter
2012-11-05,4,17,0,1,1,34,604,638,winter
2012-11-05,4,18,0,1,1,19,523,542,winter
2012-11-05,4,19,0,1,1,11,361,372,winter
2012-11-05,4,20,0,1,1,13,228,241,winter
2012-11-05,4,21,0,1,1,8,144,152,winter
2012-11-05,4,22,0,1,1,4,111,115,winter
2012-11-05,4,23,0,1,1,0,53,53,winter
2012-11-06,4,0,0,1,1,1,18,19,winter
2012-11-06,4,1,0,1,1,0,8,8,winter
2012-11-06,4,2,0,1,1,0,2,2,winter
2012-11-06,4,3,0,1,1,0,4,4,winter
2012-11-06,4,4,0,1,1,0,7,7,winter
2012-11-06,4,5,0,1,2,1,40,41,winter
2012-11-06,4,6,0,1,1,6,143,149,winter
2012-11-06,4,7,0,1,1,9,378,387,winter
2012-11-06,4,8,0,1,1,20,568,588,winter
2012-11-06,4,9,0,1,1,25,338,363,winter
2012-11-06,4,10,0,1,1,41,189,230,winter
2012-11-06,4,11,0,1,1,39,177,216,winter
2012-11-06,4,12,0,1,1,31,217,248,winter
2012-11-06,4,13,0,1,1,46,232,278,winter
2012-11-06,4,14,0,1,1,44,196,240,winter
2012-11-06,4,15,0,1,1,45,227,272,winter
2012-11-06,4,16,0,1,1,33,369,402,winter
2012-11-06,4,17,0,1,1,30,597,627,winter
2012-11-06,4,18,0,1,1,20,477,497,winter
2012-11-06,4,19,0,1,1,15,356,371,winter
2012-11-06,4,20,0,1,1,10,218,228,winter
2012-11-06,4,21,0,1,2,14,137,151,winter
2012-11-06,4,22,0,1,2,17,136,153,winter
2012-11-06,4,23,0,1,1,19,186,205,winter
2012-11-07,4,0,0,1,2,49,234,283,winter
2012-11-07,4,1,0,1,2,6,86,92,winter
2012-11-07,4,2,0,1,2,6,68,74,winter
2012-11-07,4,3,0,1,2,2,9,11,winter
2012-11-07,4,4,0,1,2,0,9,9,winter
2012-11-07,4,5,0,1,2,0,27,27,winter
2012-11-07,4,6,0,1,2,3,115,118,winter
2012-11-07,4,7,0,1,2,5,314,319,winter
2012-11-07,4,8,0,1,2,18,583,601,winter
2012-11-07,4,9,0,1,2,17,351,368,winter
2012-11-07,4,10,0,1,2,27,151,178,winter
2012-11-07,4,11,0,1,2,15,132,147,winter
2012-11-07,4,12,0,1,2,24,188,212,winter
2012-11-07,4,13,0,1,2,23,158,181,winter
2012-11-07,4,14,0,1,2,19,142,161,winter
2012-11-07,4,15,0,1,2,20,178,198,winter
2012-11-07,4,16,0,1,2,23,250,273,winter
2012-11-07,4,17,0,1,2,16,501,517,winter
2012-11-07,4,18,0,1,2,17,448,465,winter
2012-11-07,4,19,0,1,2,17,302,319,winter
2012-11-07,4,20,0,1,2,7,249,256,winter
2012-11-07,4,21,0,1,2,5,121,126,winter
2012-11-07,4,22,0,1,3,4,56,60,winter
2012-11-07,4,23,0,1,3,3,37,40,winter
2012-11-08,4,0,0,1,3,1,14,15,winter
2012-11-08,4,1,0,1,3,1,11,12,winter
2012-11-08,4,2,0,1,2,1,5,6,winter
2012-11-08,4,4,0,1,2,1,9,10,winter
2012-11-08,4,5,0,1,2,0,35,35,winter
2012-11-08,4,6,0,1,1,2,122,124,winter
2012-11-08,4,7,0,1,1,12,411,423,winter
2012-11-08,4,8,0,1,1,16,652,668,winter
2012-11-08,4,9,0,1,1,22,253,275,winter
2012-11-08,4,10,0,1,1,13,148,161,winter
2012-11-08,4,11,0,1,1,16,155,171,winter
2012-11-08,4,12,0,1,1,33,202,235,winter
2012-11-08,4,13,0,1,1,33,195,228,winter
2012-11-08,4,14,0,1,1,33,149,182,winter
2012-11-08,4,15,0,1,1,32,201,233,winter
2012-11-08,4,16,0,1,1,18,321,339,winter
2012-11-08,4,17,0,1,1,36,556,592,winter
2012-11-08,4,18,0,1,1,16,491,507,winter
2012-11-08,4,19,0,1,1,14,359,373,winter
2012-11-08,4,20,0,1,1,10,235,245,winter
2012-11-08,4,21,0,1,1,11,222,233,winter
2012-11-08,4,22,0,1,1,14,147,161,winter
2012-11-08,4,23,0,1,1,5,82,87,winter
2012-11-09,4,0,0,1,1,9,46,55,winter
2012-11-09,4,1,0,1,1,3,17,20,winter
2012-11-09,4,2,0,1,1,1,11,12,winter
2012-11-09,4,3,0,1,1,3,6,9,winter
2012-11-09,4,4,0,1,1,0,14,14,winter
2012-11-09,4,5,0,1,1,2,25,27,winter
2012-11-09,4,6,0,1,1,5,126,131,winter
2012-11-09,4,7,0,1,1,9,332,341,winter
2012-11-09,4,8,0,1,1,25,668,693,winter
2012-11-09,4,9,0,1,1,23,304,327,winter
2012-11-09,4,10,0,1,1,34,163,197,winter
2012-11-09,4,11,0,1,1,66,185,251,winter
2012-11-09,4,12,0,1,1,48,214,262,winter
2012-11-09,4,13,0,1,1,62,237,299,winter
2012-11-09,4,14,0,1,1,67,207,274,winter
2012-11-09,4,15,0,1,1,78,278,356,winter
2012-11-09,4,16,0,1,1,57,377,434,winter
2012-11-09,4,17,0,1,1,61,593,654,winter
2012-11-09,4,18,0,1,1,46,450,496,winter
2012-11-09,4,19,0,1,1,30,331,361,winter
2012-11-09,4,20,0,1,1,20,235,255,winter
2012-11-09,4,21,0,1,1,23,176,199,winter
2012-11-09,4,22,0,1,1,17,146,163,winter
2012-11-09,4,23,0,1,1,20,142,162,winter
2012-11-10,4,0,0,0,1,16,106,122,winter
2012-11-10,4,1,0,0,1,8,68,76,winter
2012-11-10,4,2,0,0,1,2,42,44,winter
2012-11-10,4,3,0,0,1,9,11,20,winter
2012-11-10,4,4,0,0,1,2,4,6,winter
2012-11-10,4,5,0,0,1,1,9,10,winter
2012-11-10,4,6,0,0,1,5,11,16,winter
2012-11-10,4,7,0,0,1,14,57,71,winter
2012-11-10,4,8,0,0,1,16,130,146,winter
2012-11-10,4,9,0,0,1,43,216,259,winter
2012-11-10,4,10,0,0,1,86,264,350,winter
2012-11-10,4,11,0,0,1,143,323,466,winter
2012-11-10,4,12,0,0,1,258,348,606,winter
2012-11-10,4,13,0,0,1,268,383,651,winter
2012-11-10,4,14,0,0,1,280,347,627,winter
2012-11-10,4,15,0,0,1,216,351,567,winter
2012-11-10,4,16,0,0,1,227,378,605,winter
2012-11-10,4,17,0,0,1,183,318,501,winter
2012-11-10,4,18,0,0,1,103,256,359,winter
2012-11-10,4,19,0,0,1,55,228,283,winter
2012-11-10,4,20,0,0,1,39,153,192,winter
2012-11-10,4,21,0,0,1,51,169,220,winter
2012-11-10,4,22,0,0,1,39,154,193,winter
2012-11-10,4,23,0,0,1,26,120,146,winter
2012-11-11,4,0,0,0,1,14,110,124,winter
2012-11-11,4,1,0,0,1,26,82,108,winter
2012-11-11,4,2,0,0,1,12,58,70,winter
2012-11-11,4,3,0,0,1,9,39,48,winter
2012-11-11,4,4,0,0,1,5,6,11,winter
2012-11-11,4,5,0,0,1,0,12,12,winter
2012-11-11,4,6,0,0,1,3,16,19,winter
2012-11-11,4,7,0,0,1,12,56,68,winter
2012-11-11,4,8,0,0,1,32,87,119,winter
2012-11-11,4,9,0,0,1,94,179,273,winter
2012-11-11,4,10,0,0,1,133,272,405,winter
2012-11-11,4,11,0,0,1,180,324,504,winter
2012-11-11,4,12,0,0,1,195,390,585,winter
2012-11-11,4,13,0,0,1,262,424,686,winter
2012-11-11,4,14,0,0,1,292,362,654,winter
2012-11-11,4,15,0,0,1,304,420,724,winter
2012-11-11,4,16,0,0,1,260,393,653,winter
2012-11-11,4,17,0,0,1,151,342,493,winter
2012-11-11,4,18,0,0,1,102,303,405,winter
2012-11-11,4,19,0,0,1,69,208,277,winter
2012-11-11,4,20,0,0,1,54,146,200,winter
2012-11-11,4,21,0,0,1,44,127,171,winter
2012-11-11,4,22,0,0,1,21,113,134,winter
2012-11-11,4,23,0,0,1,16,93,109,winter
2012-11-12,4,0,1,0,1,6,43,49,winter
2012-11-12,4,1,1,0,1,4,26,30,winter
2012-11-12,4,2,1,0,1,6,14,20,winter
2012-11-12,4,3,1,0,1,1,3,4,winter
2012-11-12,4,4,1,0,1,1,3,4,winter
2012-11-12,4,5,1,0,1,1,23,24,winter
2012-11-12,4,6,1,0,1,7,64,71,winter
2012-11-12,4,7,1,0,1,16,248,264,winter
2012-11-12,4,8,1,0,1,50,490,540,winter
2012-11-12,4,9,1,0,1,60,337,397,winter
2012-11-12,4,10,1,0,1,82,184,266,winter
2012-11-12,4,11,1,0,1,112,255,367,winter
2012-11-12,4,12,1,0,1,105,314,419,winter
2012-11-12,4,13,1,0,1,108,312,420,winter
2012-11-12,4,14,1,0,1,134,310,444,winter
2012-11-12,4,15,1,0,1,102,280,382,winter
2012-11-12,4,16,1,0,1,87,347,434,winter
2012-11-12,4,17,1,0,1,66,530,596,winter
2012-11-12,4,18,1,0,1,65,486,551,winter
2012-11-12,4,19,1,0,1,30,323,353,winter
2012-11-12,4,20,1,0,2,31,273,304,winter
2012-11-12,4,21,1,0,3,10,145,155,winter
2012-11-12,4,22,1,0,1,12,100,112,winter
2012-11-12,4,23,1,0,2,1,62,63,winter
2012-11-13,4,0,0,1,2,5,18,23,winter
2012-11-13,4,1,0,1,3,0,5,5,winter
2012-11-13,4,2,0,1,3,7,4,11,winter
2012-11-13,4,3,0,1,3,2,3,5,winter
2012-11-13,4,4,0,1,2,0,9,9,winter
2012-11-13,4,5,0,1,2,0,18,18,winter
2012-11-13,4,6,0,1,3,2,48,50,winter
2012-11-13,4,7,0,1,3,1,106,107,winter
2012-11-13,4,8,0,1,3,4,207,211,winter
2012-11-13,4,9,0,1,3,1,109,110,winter
2012-11-13,4,10,0,1,3,10,84,94,winter
2012-11-13,4,11,0,1,1,22,133,155,winter
2012-11-13,4,12,0,1,1,16,180,196,winter
2012-11-13,4,13,0,1,1,30,188,218,winter
2012-11-13,4,14,0,1,1,34,169,203,winter
2012-11-13,4,15,0,1,1,33,184,217,winter
2012-11-13,4,16,0,1,1,28,282,310,winter
2012-11-13,4,17,0,1,1,33,575,608,winter
2012-11-13,4,18,0,1,1,45,514,559,winter
2012-11-13,4,19,0,1,1,12,344,356,winter
2012-11-13,4,20,0,1,1,12,211,223,winter
2012-11-13,4,21,0,1,1,9,178,187,winter
2012-11-13,4,22,0,1,1,15,120,135,winter
2012-11-13,4,23,0,1,1,6,78,84,winter
2012-11-14,4,0,0,1,1,4,20,24,winter
2012-11-14,4,1,0,1,1,2,10,12,winter
2012-11-14,4,2,0,1,1,0,1,1,winter
2012-11-14,4,3,0,1,1,0,5,5,winter
2012-11-14,4,4,0,1,1,0,6,6,winter
2012-11-14,4,5,0,1,1,0,39,39,winter
2012-11-14,4,6,0,1,1,4,142,146,winter
2012-11-14,4,7,0,1,1,10,405,415,winter
2012-11-14,4,8,0,1,1,27,664,691,winter
2012-11-14,4,9,0,1,1,22,310,332,winter
2012-11-14,4,10,0,1,1,18,153,171,winter
2012-11-14,4,11,0,1,1,25,126,151,winter
2012-11-14,4,12,0,1,1,40,200,240,winter
2012-11-14,4,13,0,1,1,32,182,214,winter
2012-11-14,4,14,0,1,1,20,161,181,winter
2012-11-14,4,15,0,1,1,32,228,260,winter
2012-11-14,4,16,0,1,1,31,290,321,winter
2012-11-14,4,17,0,1,1,19,564,583,winter
2012-11-14,4,18,0,1,1,24,543,567,winter
2012-11-14,4,19,0,1,1,28,368,396,winter
2012-11-14,4,20,0,1,1,15,252,267,winter
2012-11-14,4,21,0,1,1,5,208,213,winter
2012-11-14,4,22,0,1,1,6,167,173,winter
2012-11-14,4,23,0,1,1,9,78,87,winter
2012-11-15,4,0,0,1,2,1,33,34,winter
2012-11-15,4,1,0,1,2,2,14,16,winter
2012-11-15,4,2,0,1,2,0,7,7,winter
2012-11-15,4,3,0,1,2,0,2,2,winter
2012-11-15,4,4,0,1,2,0,5,5,winter
2012-11-15,4,5,0,1,2,3,34,37,winter
2012-11-15,4,6,0,1,2,1,146,147,winter
2012-11-15,4,7,0,1,2,7,403,410,winter
2012-11-15,4,8,0,1,2,21,625,646,winter
2012-11-15,4,9,0,1,2,17,306,323,winter
2012-11-15,4,10,0,1,2,11,142,153,winter
2012-11-15,4,11,0,1,2,28,138,166,winter
2012-11-15,4,12,0,1,2,29,184,213,winter
2012-11-15,4,13,0,1,2,20,197,217,winter
2012-11-15,4,14,0,1,2,27,174,201,winter
2012-11-15,4,15,0,1,2,26,191,217,winter
2012-11-15,4,16,0,1,2,24,318,342,winter
2012-11-15,4,17,0,1,2,22,541,563,winter
2012-11-15,4,18,0,1,2,10,563,573,winter
2012-11-15,4,19,0,1,2,11,375,386,winter
2012-11-15,4,20,0,1,1,23,262,285,winter
2012-11-15,4,21,0,1,2,20,204,224,winter
2012-11-15,4,22,0,1,2,10,143,153,winter
2012-11-15,4,23,0,1,2,7,118,125,winter
2012-11-16,4,0,0,1,2,7,58,65,winter
2012-11-16,4,1,0,1,2,5,16,21,winter
2012-11-16,4,2,0,1,2,0,9,9,winter
2012-11-16,4,3,0,1,2,0,6,6,winter
2012-11-16,4,4,0,1,2,0,5,5,winter
2012-11-16,4,5,0,1,2,2,34,36,winter
2012-11-16,4,6,0,1,2,4,126,130,winter
2012-11-16,4,7,0,1,2,5,362,367,winter
2012-11-16,4,8,0,1,2,17,694,711,winter
2012-11-16,4,9,0,1,1,21,330,351,winter
2012-11-16,4,10,0,1,1,33,165,198,winter
2012-11-16,4,11,0,1,1,33,185,218,winter
2012-11-16,4,12,0,1,1,28,262,290,winter
2012-11-16,4,13,0,1,1,52,226,278,winter
2012-11-16,4,14,0,1,1,47,204,251,winter
2012-11-16,4,15,0,1,1,30,237,267,winter
2012-11-16,4,16,0,1,1,33,350,383,winter
2012-11-16,4,17,0,1,1,41,539,580,winter
2012-11-16,4,18,0,1,1,22,483,505,winter
2012-11-16,4,19,0,1,1,26,306,332,winter
2012-11-16,4,20,0,1,1,20,207,227,winter
2012-11-16,4,21,0,1,1,21,157,178,winter
2012-11-16,4,22,0,1,1,23,139,162,winter
2012-11-16,4,23,0,1,1,14,114,128,winter
2012-11-17,4,0,0,0,1,11,95,106,winter
2012-11-17,4,1,0,0,1,13,74,87,winter
2012-11-17,4,2,0,0,1,8,41,49,winter
2012-11-17,4,3,0,0,1,2,19,21,winter
2012-11-17,4,4,0,0,1,1,6,7,winter
2012-11-17,4,5,0,0,1,1,10,11,winter
2012-11-17,4,6,0,0,1,0,21,21,winter
2012-11-17,4,7,0,0,1,8,70,78,winter
2012-11-17,4,8,0,0,1,30,138,168,winter
2012-11-17,4,9,0,0,1,48,200,248,winter
2012-11-17,4,10,0,0,1,62,258,320,winter
2012-11-17,4,11,0,0,1,80,343,423,winter
2012-11-17,4,12,0,0,1,117,359,476,winter
2012-11-17,4,13,0,0,1,179,346,525,winter
2012-11-17,4,14,0,0,1,175,380,555,winter
2012-11-17,4,15,0,0,1,175,374,549,winter
2012-11-17,4,16,0,0,1,144,325,469,winter
2012-11-17,4,17,0,0,1,101,302,403,winter
2012-11-17,4,18,0,0,1,34,237,271,winter
2012-11-17,4,19,0,0,1,45,208,253,winter
2012-11-17,4,20,0,0,2,30,142,172,winter
2012-11-17,4,21,0,0,2,15,124,139,winter
2012-11-17,4,22,0,0,2,15,130,145,winter
2012-11-17,4,23,0,0,2,19,114,133,winter
2012-11-18,4,0,0,0,2,11,118,129,winter
2012-11-18,4,1,0,0,1,14,81,95,winter
2012-11-18,4,2,0,0,1,8,65,73,winter
2012-11-18,4,3,0,0,2,9,37,46,winter
2012-11-18,4,4,0,0,2,4,8,12,winter
2012-11-18,4,5,0,0,1,5,7,12,winter
2012-11-18,4,6,0,0,1,2,13,15,winter
2012-11-18,4,7,0,0,1,3,39,42,winter
2012-11-18,4,8,0,0,1,19,100,119,winter
2012-11-18,4,9,0,0,1,49,155,204,winter
2012-11-18,4,10,0,0,1,79,250,329,winter
2012-11-18,4,11,0,0,1,92,267,359,winter
2012-11-18,4,12,0,0,1,101,341,442,winter
2012-11-18,4,13,0,0,1,113,334,447,winter
2012-11-18,4,14,0,0,1,125,303,428,winter
2012-11-18,4,15,0,0,1,89,318,407,winter
2012-11-18,4,16,0,0,2,59,313,372,winter
2012-11-18,4,17,0,0,2,48,232,280,winter
2012-11-18,4,18,0,0,1,36,240,276,winter
2012-11-18,4,19,0,0,1,16,194,210,winter
2012-11-18,4,20,0,0,1,9,120,129,winter
2012-11-18,4,21,0,0,1,17,93,110,winter
2012-11-18,4,22,0,0,2,8,66,74,winter
2012-11-18,4,23,0,0,1,6,53,59,winter
2012-11-19,4,0,0,1,1,5,22,27,winter
2012-11-19,4,1,0,1,2,0,19,19,winter
2012-11-19,4,2,0,1,2,0,5,5,winter
2012-11-19,4,3,0,1,2,0,2,2,winter
2012-11-19,4,4,0,1,2,1,11,12,winter
2012-11-19,4,5,0,1,2,1,38,39,winter
2012-11-19,4,6,0,1,2,3,128,131,winter
2012-11-19,4,7,0,1,2,5,381,386,winter
2012-11-19,4,8,0,1,2,13,650,663,winter
2012-11-19,4,9,0,1,2,18,260,278,winter
2012-11-19,4,10,0,1,2,33,106,139,winter
2012-11-19,4,11,0,1,2,33,164,197,winter
2012-11-19,4,12,0,1,2,35,207,242,winter
2012-11-19,4,13,0,1,1,46,205,251,winter
2012-11-19,4,14,0,1,1,47,170,217,winter
2012-11-19,4,15,0,1,1,44,213,257,winter
2012-11-19,4,16,0,1,1,55,325,380,winter
2012-11-19,4,17,0,1,2,33,586,619,winter
2012-11-19,4,18,0,1,2,21,559,580,winter
2012-11-19,4,19,0,1,2,25,381,406,winter
2012-11-19,4,20,0,1,2,7,252,259,winter
2012-11-19,4,21,0,1,2,15,188,203,winter
2012-11-19,4,22,0,1,1,7,106,113,winter
2012-11-19,4,23,0,1,1,2,72,74,winter
2012-11-20,4,0,0,1,1,3,26,29,winter
2012-11-20,4,1,0,1,1,3,10,13,winter
2012-11-20,4,2,0,1,2,0,5,5,winter
2012-11-20,4,3,0,1,2,0,2,2,winter
2012-11-20,4,4,0,1,2,0,6,6,winter
2012-11-20,4,5,0,1,2,2,32,34,winter
2012-11-20,4,6,0,1,2,2,146,148,winter
2012-11-20,4,7,0,1,1,7,411,418,winter
2012-11-20,4,8,0,1,1,16,649,665,winter
2012-11-20,4,9,0,1,2,28,298,326,winter
2012-11-20,4,10,0,1,2,32,144,176,winter
2012-11-20,4,11,0,1,2,45,160,205,winter
2012-11-20,4,12,0,1,2,70,243,313,winter
2012-11-20,4,13,0,1,2,49,218,267,winter
2012-11-20,4,14,0,1,2,47,177,224,winter
2012-11-20,4,15,0,1,2,61,226,287,winter
2012-11-20,4,16,0,1,2,60,335,395,winter
2012-11-20,4,17,0,1,2,37,553,590,winter
2012-11-20,4,18,0,1,2,16,534,550,winter
2012-11-20,4,19,0,1,2,23,361,384,winter
2012-11-20,4,20,0,1,2,11,224,235,winter
2012-11-20,4,21,0,1,1,14,143,157,winter
2012-11-20,4,22,0,1,1,7,115,122,winter
2012-11-20,4,23,0,1,1,1,82,83,winter
2012-11-21,4,0,0,1,1,1,25,26,winter
2012-11-21,4,1,0,1,1,1,13,14,winter
2012-11-21,4,2,0,1,1,2,6,8,winter
2012-11-21,4,3,0,1,1,0,2,2,winter
2012-11-21,4,4,0,1,1,0,10,10,winter
2012-11-21,4,5,0,1,1,1,28,29,winter
2012-11-21,4,6,0,1,1,2,99,101,winter
2012-11-21,4,7,0,1,1,11,262,273,winter
2012-11-21,4,8,0,1,2,12,539,551,winter
2012-11-21,4,9,0,1,1,45,320,365,winter
2012-11-21,4,10,0,1,1,22,150,172,winter
2012-11-21,4,11,0,1,1,43,198,241,winter
2012-11-21,4,12,0,1,1,74,270,344,winter
2012-11-21,4,13,0,1,1,70,295,365,winter
2012-11-21,4,14,0,1,1,84,329,413,winter
2012-11-21,4,15,0,1,1,68,381,449,winter
2012-11-21,4,16,0,1,1,59,410,469,winter
2012-11-21,4,17,0,1,1,41,333,374,winter
2012-11-21,4,18,0,1,1,24,287,311,winter
2012-11-21,4,19,0,1,1,23,220,243,winter
2012-11-21,4,20,0,1,1,11,125,136,winter
2012-11-21,4,21,0,1,1,8,97,105,winter
2012-11-21,4,22,0,1,1,6,82,88,winter
2012-11-21,4,23,0,1,1,7,50,57,winter
2012-11-22,4,0,1,0,1,3,43,46,winter
2012-11-22,4,1,1,0,1,5,37,42,winter
2012-11-22,4,2,1,0,1,3,15,18,winter
2012-11-22,4,3,1,0,1,0,6,6,winter
2012-11-22,4,4,1,0,1,1,2,3,winter
2012-11-22,4,5,1,0,1,2,6,8,winter
2012-11-22,4,6,1,0,1,2,15,17,winter
2012-11-22,4,7,1,0,1,7,49,56,winter
2012-11-22,4,8,1,0,1,20,77,97,winter
2012-11-22,4,9,1,0,1,25,94,119,winter
2012-11-22,4,10,1,0,1,65,154,219,winter
2012-11-22,4,11,1,0,1,89,143,232,winter
2012-11-22,4,12,1,0,1,117,145,262,winter
2012-11-22,4,13,1,0,1,125,144,269,winter
2012-11-22,4,14,1,0,1,125,95,220,winter
2012-11-22,4,15,1,0,1,132,96,228,winter
2012-11-22,4,16,1,0,1,101,81,182,winter
2012-11-22,4,17,1,0,1,66,43,109,winter
2012-11-22,4,18,1,0,1,16,54,70,winter
2012-11-22,4,19,1,0,1,13,31,44,winter
2012-11-22,4,20,1,0,1,15,37,52,winter
2012-11-22,4,21,1,0,1,7,39,46,winter
2012-11-22,4,22,1,0,1,8,36,44,winter
2012-11-22,4,23,1,0,1,8,28,36,winter
2012-11-23,4,0,0,1,1,0,32,32,winter
2012-11-23,4,1,0,1,1,2,11,13,winter
2012-11-23,4,2,0,1,1,1,4,5,winter
2012-11-23,4,3,0,1,1,1,0,1,winter
2012-11-23,4,4,0,1,1,1,3,4,winter
2012-11-23,4,5,0,1,1,0,10,10,winter
2012-11-23,4,6,0,1,1,0,20,20,winter
2012-11-23,4,7,0,1,1,5,72,77,winter
2012-11-23,4,8,0,1,1,11,83,94,winter
2012-11-23,4,9,0,1,1,32,80,112,winter
2012-11-23,4,10,0,1,1,87,114,201,winter
2012-11-23,4,11,0,1,1,121,130,251,winter
2012-11-23,4,12,0,1,1,186,193,379,winter
2012-11-23,4,13,0,1,1,224,200,424,winter
2012-11-23,4,14,0,1,1,240,195,435,winter
2012-11-23,4,15,0,1,1,233,214,447,winter
2012-11-23,4,16,0,1,2,158,199,357,winter
2012-11-23,4,17,0,1,2,117,183,300,winter
2012-11-23,4,18,0,1,2,50,158,208,winter
2012-11-23,4,19,0,1,2,33,121,154,winter
2012-11-23,4,20,0,1,1,42,100,142,winter
2012-11-23,4,21,0,1,1,23,75,98,winter
2012-11-23,4,22,0,1,1,16,63,79,winter
2012-11-23,4,23,0,1,1,20,47,67,winter
2012-11-24,4,0,0,0,1,9,33,42,winter
2012-11-24,4,1,0,0,1,1,19,20,winter
2012-11-24,4,2,0,0,1,10,22,32,winter
2012-11-24,4,3,0,0,1,6,5,11,winter
2012-11-24,4,4,0,0,1,1,2,3,winter
2012-11-24,4,5,0,0,1,1,2,3,winter
2012-11-24,4,6,0,0,1,1,9,10,winter
2012-11-24,4,7,0,0,2,4,21,25,winter
2012-11-24,4,8,0,0,2,7,55,62,winter
2012-11-24,4,9,0,0,2,26,96,122,winter
2012-11-24,4,10,0,0,2,46,96,142,winter
2012-11-24,4,11,0,0,2,55,131,186,winter
2012-11-24,4,12,0,0,2,53,146,199,winter
2012-11-24,4,13,0,0,1,64,161,225,winter
2012-11-24,4,14,0,0,1,58,149,207,winter
2012-11-24,4,15,0,0,1,59,139,198,winter
2012-11-24,4,16,0,0,1,43,127,170,winter
2012-11-24,4,17,0,0,1,29,97,126,winter
2012-11-24,4,18,0,0,1,22,123,145,winter
2012-11-24,4,19,0,0,1,9,74,83,winter
2012-11-24,4,20,0,0,1,3,55,58,winter
2012-11-24,4,21,0,0,1,9,66,75,winter
2012-11-24,4,22,0,0,1,7,69,76,winter
2012-11-24,4,23,0,0,1,9,48,57,winter
2012-11-25,4,0,0,0,1,3,31,34,winter
2012-11-25,4,1,0,0,1,4,32,36,winter
2012-11-25,4,2,0,0,1,1,27,28,winter
2012-11-25,4,3,0,0,1,0,8,8,winter
2012-11-25,4,4,0,0,1,1,1,2,winter
2012-11-25,4,5,0,0,2,0,3,3,winter
2012-11-25,4,6,0,0,2,1,10,11,winter
2012-11-25,4,7,0,0,2,2,19,21,winter
2012-11-25,4,8,0,0,2,2,32,34,winter
2012-11-25,4,9,0,0,2,13,83,96,winter
2012-11-25,4,10,0,0,1,15,124,139,winter
2012-11-25,4,11,0,0,2,49,155,204,winter
2012-11-25,4,12,0,0,2,37,165,202,winter
2012-11-25,4,13,0,0,2,37,158,195,winter
2012-11-25,4,14,0,0,2,33,170,203,winter
2012-11-25,4,15,0,0,1,36,209,245,winter
2012-11-25,4,16,0,0,1,25,203,228,winter
2012-11-25,4,17,0,0,1,11,170,181,winter
2012-11-25,4,18,0,0,1,9,132,141,winter
2012-11-25,4,19,0,0,1,13,114,127,winter
2012-11-25,4,20,0,0,1,9,110,119,winter
2012-11-25,4,21,0,0,1,4,60,64,winter
2012-11-25,4,22,0,0,1,3,59,62,winter
2012-11-25,4,23,0,0,1,1,40,41,winter
2012-11-26,4,0,0,1,1,4,19,23,winter
2012-11-26,4,1,0,1,1,1,9,10,winter
2012-11-26,4,2,0,1,1,0,5,5,winter
2012-11-26,4,3,0,1,1,1,4,5,winter
2012-11-26,4,4,0,1,1,0,10,10,winter
2012-11-26,4,5,0,1,1,0,41,41,winter
2012-11-26,4,6,0,1,1,1,123,124,winter
2012-11-26,4,7,0,1,1,2,363,365,winter
2012-11-26,4,8,0,1,1,9,629,638,winter
2012-11-26,4,9,0,1,1,10,276,286,winter
2012-11-26,4,10,0,1,1,20,127,147,winter
2012-11-26,4,11,0,1,1,18,112,130,winter
2012-11-26,4,12,0,1,1,22,188,210,winter
2012-11-26,4,13,0,1,1,20,197,217,winter
2012-11-26,4,14,0,1,1,51,177,228,winter
2012-11-26,4,15,0,1,1,49,181,230,winter
2012-11-26,4,16,0,1,1,49,297,346,winter
2012-11-26,4,17,0,1,1,13,540,553,winter
2012-11-26,4,18,0,1,1,19,502,521,winter
2012-11-26,4,19,0,1,1,16,355,371,winter
2012-11-26,4,20,0,1,1,12,265,277,winter
2012-11-26,4,21,0,1,1,9,172,181,winter
2012-11-26,4,22,0,1,1,3,101,104,winter
2012-11-26,4,23,0,1,2,8,57,65,winter
2012-11-27,4,0,0,1,2,2,24,26,winter
2012-11-27,4,1,0,1,2,0,6,6,winter
2012-11-27,4,2,0,1,2,0,5,5,winter
2012-11-27,4,3,0,1,3,1,3,4,winter
2012-11-27,4,4,0,1,3,0,5,5,winter
2012-11-27,4,5,0,1,2,0,31,31,winter
2012-11-27,4,6,0,1,2,3,97,100,winter
2012-11-27,4,7,0,1,3,4,289,293,winter
2012-11-27,4,8,0,1,3,6,494,500,winter
2012-11-27,4,9,0,1,2,11,257,268,winter
2012-11-27,4,10,0,1,3,5,52,57,winter
2012-11-27,4,11,0,1,3,6,59,65,winter
2012-11-27,4,12,0,1,3,6,70,76,winter
2012-11-27,4,13,0,1,3,4,73,77,winter
2012-11-27,4,14,0,1,3,8,86,94,winter
2012-11-27,4,15,0,1,2,9,146,155,winter
2012-11-27,4,16,0,1,2,5,252,257,winter
2012-11-27,4,17,0,1,2,13,514,527,winter
2012-11-27,4,18,0,1,1,13,469,482,winter
2012-11-27,4,19,0,1,1,12,338,350,winter
2012-11-27,4,20,0,1,1,4,228,232,winter
2012-11-27,4,21,0,1,1,6,179,185,winter
2012-11-27,4,22,0,1,1,2,95,97,winter
2012-11-27,4,23,0,1,2,3,64,67,winter
2012-11-28,4,0,0,1,2,1,22,23,winter
2012-11-28,4,1,0,1,2,0,12,12,winter
2012-11-28,4,2,0,1,2,0,1,1,winter
2012-11-28,4,3,0,1,2,0,3,3,winter
2012-11-28,4,4,0,1,2,0,4,4,winter
2012-11-28,4,5,0,1,2,0,39,39,winter
2012-11-28,4,6,0,1,2,4,132,136,winter
2012-11-28,4,7,0,1,2,6,403,409,winter
2012-11-28,4,8,0,1,1,9,683,692,winter
2012-11-28,4,9,0,1,1,13,309,322,winter
2012-11-28,4,10,0,1,1,17,144,161,winter
2012-11-28,4,11,0,1,1,19,127,146,winter
2012-11-28,4,12,0,1,1,19,189,208,winter
2012-11-28,4,13,0,1,1,21,193,214,winter
2012-11-28,4,14,0,1,1,15,161,176,winter
2012-11-28,4,15,0,1,1,7,172,179,winter
2012-11-28,4,16,0,1,1,9,316,325,winter
2012-11-28,4,17,0,1,1,17,546,563,winter
2012-11-28,4,18,0,1,1,12,530,542,winter
2012-11-28,4,19,0,1,1,9,378,387,winter
2012-11-28,4,20,0,1,1,5,258,263,winter
2012-11-28,4,21,0,1,1,4,219,223,winter
2012-11-28,4,22,0,1,1,6,148,154,winter
2012-11-28,4,23,0,1,1,5,73,78,winter
2012-11-29,4,0,0,1,1,4,25,29,winter
2012-11-29,4,1,0,1,1,1,15,16,winter
2012-11-29,4,2,0,1,1,1,6,7,winter
2012-11-29,4,4,0,1,1,0,7,7,winter
2012-11-29,4,5,0,1,1,0,42,42,winter
2012-11-29,4,6,0,1,1,1,120,121,winter
2012-11-29,4,7,0,1,1,8,354,362,winter
2012-11-29,4,8,0,1,1,15,664,679,winter
2012-11-29,4,9,0,1,1,13,286,299,winter
2012-11-29,4,10,0,1,1,25,153,178,winter
2012-11-29,4,11,0,1,1,13,150,163,winter
2012-11-29,4,12,0,1,1,11,225,236,winter
2012-11-29,4,13,0,1,1,15,209,224,winter
2012-11-29,4,14,0,1,1,13,174,187,winter
2012-11-29,4,15,0,1,1,19,201,220,winter
2012-11-29,4,16,0,1,1,24,346,370,winter
2012-11-29,4,17,0,1,1,17,544,561,winter
2012-11-29,4,18,0,1,1,17,520,537,winter
2012-11-29,4,19,0,1,1,18,326,344,winter
2012-11-29,4,20,0,1,1,11,241,252,winter
2012-11-29,4,21,0,1,1,7,201,208,winter
2012-11-29,4,22,0,1,1,4,147,151,winter
2012-11-29,4,23,0,1,1,6,124,130,winter
2012-11-30,4,0,0,1,1,4,48,52,winter
2012-11-30,4,1,0,1,1,2,17,19,winter
2012-11-30,4,2,0,1,1,2,10,12,winter
2012-11-30,4,3,0,1,1,0,4,4,winter
2012-11-30,4,4,0,1,1,0,3,3,winter
2012-11-30,4,5,0,1,1,1,39,40,winter
2012-11-30,4,6,0,1,1,2,104,106,winter
2012-11-30,4,7,0,1,1,6,346,352,winter
2012-11-30,4,8,0,1,2,20,709,729,winter
2012-11-30,4,9,0,1,1,17,313,330,winter
2012-11-30,4,10,0,1,2,10,159,169,winter
2012-11-30,4,11,0,1,2,31,170,201,winter
2012-11-30,4,12,0,1,2,25,243,268,winter
2012-11-30,4,13,0,1,2,21,241,262,winter
2012-11-30,4,14,0,1,2,26,225,251,winter
2012-11-30,4,15,0,1,2,34,262,296,winter
2012-11-30,4,16,0,1,1,37,368,405,winter
2012-11-30,4,17,0,1,1,31,551,582,winter
2012-11-30,4,18,0,1,2,20,489,509,winter
2012-11-30,4,19,0,1,1,18,359,377,winter
2012-11-30,4,20,0,1,1,12,233,245,winter
2012-11-30,4,21,0,1,1,14,169,183,winter
2012-11-30,4,22,0,1,1,18,145,163,winter
2012-11-30,4,23,0,1,2,11,99,110,winter
2012-12-01,4,0,0,0,1,9,99,108,winter
2012-12-01,4,1,0,0,1,5,64,69,winter
2012-12-01,4,2,0,0,2,3,47,50,winter
2012-12-01,4,3,0,0,2,1,14,15,winter
2012-12-01,4,4,0,0,1,0,5,5,winter
2012-12-01,4,5,0,0,1,1,12,13,winter
2012-12-01,4,6,0,0,1,7,20,27,winter
2012-12-01,4,7,0,0,2,7,56,63,winter
2012-12-01,4,8,0,0,2,11,133,144,winter
2012-12-01,4,9,0,0,2,34,159,193,winter
2012-12-01,4,10,0,0,2,45,211,256,winter
2012-12-01,4,11,0,0,2,74,318,392,winter
2012-12-01,4,12,0,0,2,119,327,446,winter
2012-12-01,4,13,0,0,2,123,386,509,winter
2012-12-01,4,14,0,0,2,110,369,479,winter
2012-12-01,4,15,0,0,2,113,371,484,winter
2012-12-01,4,16,0,0,2,89,354,443,winter
2012-12-01,4,17,0,0,2,50,270,320,winter
2012-12-01,4,18,0,0,2,42,255,297,winter
2012-12-01,4,19,0,0,2,30,219,249,winter
2012-12-01,4,20,0,0,1,28,170,198,winter
2012-12-01,4,21,0,0,2,23,135,158,winter
2012-12-01,4,22,0,0,2,17,130,147,winter
2012-12-01,4,23,0,0,2,10,116,126,winter
2012-12-02,4,0,0,0,2,9,108,117,winter
2012-12-02,4,1,0,0,2,10,84,94,winter
2012-12-02,4,2,0,0,2,2,72,74,winter
2012-12-02,4,3,0,0,2,4,21,25,winter
2012-12-02,4,4,0,0,2,1,6,7,winter
2012-12-02,4,5,0,0,2,1,7,8,winter
2012-12-02,4,6,0,0,2,1,15,16,winter
2012-12-02,4,7,0,0,2,5,26,31,winter
2012-12-02,4,8,0,0,2,12,81,93,winter
2012-12-02,4,9,0,0,2,37,135,172,winter
2012-12-02,4,10,0,0,2,63,230,293,winter
2012-12-02,4,11,0,0,2,81,274,355,winter
2012-12-02,4,12,0,0,2,111,409,520,winter
2012-12-02,4,13,0,0,1,84,347,431,winter
2012-12-02,4,14,0,0,1,142,331,473,winter
2012-12-02,4,15,0,0,1,106,311,417,winter
2012-12-02,4,16,0,0,2,85,358,443,winter
2012-12-02,4,17,0,0,3,59,244,303,winter
2012-12-02,4,18,0,0,2,25,178,203,winter
2012-12-02,4,19,0,0,2,16,158,174,winter
2012-12-02,4,20,0,0,2,12,142,154,winter
2012-12-02,4,21,0,0,2,8,91,99,winter
2012-12-02,4,22,0,0,2,11,85,96,winter
2012-12-02,4,23,0,0,2,7,44,51,winter
2012-12-03,4,0,0,1,2,3,18,21,winter
2012-12-03,4,1,0,1,1,2,11,13,winter
2012-12-03,4,2,0,1,1,1,9,10,winter
2012-12-03,4,3,0,1,1,2,6,8,winter
2012-12-03,4,4,0,1,1,1,4,5,winter
2012-12-03,4,5,0,1,1,0,38,38,winter
2012-12-03,4,6,0,1,1,2,136,138,winter
2012-12-03,4,7,0,1,2,9,387,396,winter
2012-12-03,4,8,0,1,1,19,712,731,winter
2012-12-03,4,9,0,1,1,19,289,308,winter
2012-12-03,4,10,0,1,1,31,105,136,winter
2012-12-03,4,11,0,1,1,51,182,233,winter
2012-12-03,4,12,0,1,1,40,228,268,winter
2012-12-03,4,13,0,1,1,81,240,321,winter
2012-12-03,4,14,0,1,1,51,209,260,winter
2012-12-03,4,15,0,1,1,58,210,268,winter
2012-12-03,4,16,0,1,1,45,397,442,winter
2012-12-03,4,17,0,1,1,43,665,708,winter
2012-12-03,4,18,0,1,1,26,666,692,winter
2012-12-03,4,19,0,1,1,27,444,471,winter
2012-12-03,4,20,0,1,2,16,284,300,winter
2012-12-03,4,21,0,1,1,14,207,221,winter
2012-12-03,4,22,0,1,1,5,139,144,winter
2012-12-03,4,23,0,1,1,9,93,102,winter
2012-12-04,4,0,0,1,1,6,49,55,winter
2012-12-04,4,1,0,1,1,3,22,25,winter
2012-12-04,4,2,0,1,1,3,5,8,winter
2012-12-04,4,3,0,1,2,1,3,4,winter
2012-12-04,4,4,0,1,2,0,7,7,winter
2012-12-04,4,5,0,1,2,1,45,46,winter
2012-12-04,4,6,0,1,2,3,150,153,winter
2012-12-04,4,7,0,1,1,7,495,502,winter
2012-12-04,4,8,0,1,2,21,700,721,winter
2012-12-04,4,9,0,1,1,19,317,336,winter
2012-12-04,4,10,0,1,1,26,130,156,winter
2012-12-04,4,11,0,1,1,24,183,207,winter
2012-12-04,4,12,0,1,1,39,273,312,winter
2012-12-04,4,13,0,1,2,39,233,272,winter
2012-12-04,4,14,0,1,2,39,231,270,winter
2012-12-04,4,15,0,1,2,56,244,300,winter
2012-12-04,4,16,0,1,1,44,391,435,winter
2012-12-04,4,17,0,1,1,43,700,743,winter
2012-12-04,4,18,0,1,1,38,693,731,winter
2012-12-04,4,19,0,1,1,46,414,460,winter
2012-12-04,4,20,0,1,2,34,272,306,winter
2012-12-04,4,21,0,1,2,28,252,280,winter
2012-12-04,4,22,0,1,2,26,155,181,winter
2012-12-04,4,23,0,1,1,5,91,96,winter
2012-12-05,4,0,0,1,1,6,31,37,winter
2012-12-05,4,1,0,1,1,0,11,11,winter
2012-12-05,4,2,0,1,1,2,7,9,winter
2012-12-05,4,3,0,1,1,0,7,7,winter
2012-12-05,4,4,0,1,1,1,9,10,winter
2012-12-05,4,5,0,1,1,1,48,49,winter
2012-12-05,4,6,0,1,3,5,119,124,winter
2012-12-05,4,7,0,1,3,9,389,398,winter
2012-12-05,4,8,0,1,2,22,737,759,winter
2012-12-05,4,9,0,1,2,26,362,388,winter
2012-12-05,4,10,0,1,2,14,127,141,winter
2012-12-05,4,11,0,1,1,11,161,172,winter
2012-12-05,4,12,0,1,1,24,208,232,winter
2012-12-05,4,13,0,1,1,14,200,214,winter
2012-12-05,4,14,0,1,1,39,179,218,winter
2012-12-05,4,15,0,1,1,20,265,285,winter
2012-12-05,4,16,0,1,1,23,354,377,winter
2012-12-05,4,17,0,1,1,29,576,605,winter
2012-12-05,4,18,0,1,1,29,580,609,winter
2012-12-05,4,19,0,1,1,14,400,414,winter
2012-12-05,4,20,0,1,1,19,274,293,winter
2012-12-05,4,21,0,1,1,14,184,198,winter
2012-12-05,4,22,0,1,1,4,101,105,winter
2012-12-05,4,23,0,1,1,5,69,74,winter
2012-12-06,4,0,0,1,1,1,43,44,winter
2012-12-06,4,1,0,1,1,0,16,16,winter
2012-12-06,4,2,0,1,1,0,9,9,winter
2012-12-06,4,3,0,1,1,0,2,2,winter
2012-12-06,4,4,0,1,1,1,8,9,winter
2012-12-06,4,5,0,1,1,0,32,32,winter
2012-12-06,4,6,0,1,1,2,122,124,winter
2012-12-06,4,7,0,1,1,8,381,389,winter
2012-12-06,4,8,0,1,1,13,646,659,winter
2012-12-06,4,9,0,1,1,19,257,276,winter
2012-12-06,4,10,0,1,1,23,122,145,winter
2012-12-06,4,11,0,1,1,16,162,178,winter
2012-12-06,4,12,0,1,1,29,206,235,winter
2012-12-06,4,13,0,1,1,33,212,245,winter
2012-12-06,4,14,0,1,1,37,175,212,winter
2012-12-06,4,15,0,1,1,38,232,270,winter
2012-12-06,4,16,0,1,1,39,292,331,winter
2012-12-06,4,17,0,1,1,31,586,617,winter
2012-12-06,4,18,0,1,1,23,542,565,winter
2012-12-06,4,19,0,1,1,13,360,373,winter
2012-12-06,4,20,0,1,2,5,222,227,winter
2012-12-06,4,21,0,1,2,7,184,191,winter
2012-12-06,4,22,0,1,1,2,131,133,winter
2012-12-06,4,23,0,1,1,0,93,93,winter
2012-12-07,4,0,0,1,1,3,45,48,winter
2012-12-07,4,1,0,1,2,2,26,28,winter
2012-12-07,4,2,0,1,2,0,11,11,winter
2012-12-07,4,3,0,1,2,0,5,5,winter
2012-12-07,4,4,0,1,1,0,10,10,winter
2012-12-07,4,5,0,1,2,1,25,26,winter
2012-12-07,4,6,0,1,2,0,84,84,winter
2012-12-07,4,7,0,1,3,3,212,215,winter
2012-12-07,4,8,0,1,2,11,430,441,winter
2012-12-07,4,9,0,1,2,10,291,301,winter
2012-12-07,4,10,0,1,2,16,150,166,winter
2012-12-07,4,11,0,1,2,20,183,203,winter
2012-12-07,4,12,0,1,2,36,204,240,winter
2012-12-07,4,13,0,1,2,23,197,220,winter
2012-12-07,4,14,0,1,2,40,175,215,winter
2012-12-07,4,15,0,1,2,34,269,303,winter
2012-12-07,4,16,0,1,1,39,336,375,winter
2012-12-07,4,17,0,1,2,29,539,568,winter
2012-12-07,4,18,0,1,2,25,473,498,winter
2012-12-07,4,19,0,1,2,15,337,352,winter
2012-12-07,4,20,0,1,3,12,229,241,winter
2012-12-07,4,21,0,1,2,9,162,171,winter
2012-12-07,4,22,0,1,2,15,150,165,winter
2012-12-07,4,23,0,1,2,6,116,122,winter
2012-12-08,4,0,0,0,2,5,98,103,winter
2012-12-08,4,1,0,0,2,16,84,100,winter
2012-12-08,4,2,0,0,2,3,67,70,winter
2012-12-08,4,3,0,0,2,6,23,29,winter
2012-12-08,4,4,0,0,2,3,9,12,winter
2012-12-08,4,5,0,0,2,2,4,6,winter
2012-12-08,4,6,0,0,2,1,19,20,winter
2012-12-08,4,7,0,0,2,3,36,39,winter
2012-12-08,4,8,0,0,2,5,106,111,winter
2012-12-08,4,9,0,0,2,17,153,170,winter
2012-12-08,4,10,0,0,2,43,244,287,winter
2012-12-08,4,11,0,0,2,63,341,404,winter
2012-12-08,4,12,0,0,2,122,364,486,winter
2012-12-08,4,13,0,0,2,148,399,547,winter
2012-12-08,4,14,0,0,2,164,378,542,winter
2012-12-08,4,15,0,0,1,167,374,541,winter
2012-12-08,4,16,0,0,1,139,368,507,winter
2012-12-08,4,17,0,0,1,77,268,345,winter
2012-12-08,4,18,0,0,1,40,264,304,winter
2012-12-08,4,19,0,0,1,34,212,246,winter
2012-12-08,4,20,0,0,2,20,162,182,winter
2012-12-08,4,21,0,0,2,34,175,209,winter
2012-12-08,4,22,0,0,2,23,137,160,winter
2012-12-08,4,23,0,0,2,18,144,162,winter
2012-12-09,4,0,0,0,2,15,103,118,winter
2012-12-09,4,1,0,0,2,17,85,102,winter
2012-12-09,4,2,0,0,2,8,70,78,winter
2012-12-09,4,3,0,0,2,14,34,48,winter
2012-12-09,4,4,0,0,2,1,11,12,winter
2012-12-09,4,5,0,0,2,0,8,8,winter
2012-12-09,4,6,0,0,3,0,6,6,winter
2012-12-09,4,7,0,0,3,1,22,23,winter
2012-12-09,4,8,0,0,3,1,68,69,winter
2012-12-09,4,9,0,0,2,9,94,103,winter
2012-12-09,4,10,0,0,2,39,180,219,winter
2012-12-09,4,11,0,0,2,40,210,250,winter
2012-12-09,4,12,0,0,2,60,255,315,winter
2012-12-09,4,13,0,0,2,65,220,285,winter
2012-12-09,4,14,0,0,2,42,190,232,winter
2012-12-09,4,15,0,0,3,25,200,225,winter
2012-12-09,4,16,0,0,3,33,220,253,winter
2012-12-09,4,17,0,0,3,20,209,229,winter
2012-12-09,4,18,0,0,3,17,181,198,winter
2012-12-09,4,19,0,0,3,12,110,122,winter
2012-12-09,4,20,0,0,3,6,102,108,winter
2012-12-09,4,21,0,0,2,10,86,96,winter
2012-12-09,4,22,0,0,3,3,75,78,winter
2012-12-09,4,23,0,0,3,3,48,51,winter
2012-12-10,4,0,0,1,3,0,20,20,winter
2012-12-10,4,1,0,1,2,0,4,4,winter
2012-12-10,4,2,0,1,2,2,3,5,winter
2012-12-10,4,3,0,1,2,0,4,4,winter
2012-12-10,4,4,0,1,2,3,9,12,winter
2012-12-10,4,5,0,1,2,0,27,27,winter
2012-12-10,4,6,0,1,2,2,121,123,winter
2012-12-10,4,7,0,1,2,3,291,294,winter
2012-12-10,4,8,0,1,2,9,575,584,winter
2012-12-10,4,9,0,1,2,11,273,284,winter
2012-12-10,4,10,0,1,2,12,121,133,winter
2012-12-10,4,11,0,1,3,8,126,134,winter
2012-12-10,4,12,0,1,3,23,150,173,winter
2012-12-10,4,13,0,1,3,30,190,220,winter
2012-12-10,4,14,0,1,2,31,179,210,winter
2012-12-10,4,15,0,1,2,29,207,236,winter
2012-12-10,4,16,0,1,2,37,308,345,winter
2012-12-10,4,17,0,1,2,38,578,616,winter
2012-12-10,4,18,0,1,2,20,544,564,winter
2012-12-10,4,19,0,1,1,18,409,427,winter
2012-12-10,4,20,0,1,1,13,287,300,winter
2012-12-10,4,21,0,1,2,21,224,245,winter
2012-12-10,4,22,0,1,2,11,115,126,winter
2012-12-10,4,23,0,1,1,8,76,84,winter
2012-12-11,4,0,0,1,3,2,29,31,winter
2012-12-11,4,1,0,1,1,1,7,8,winter
2012-12-11,4,2,0,1,2,0,1,1,winter
2012-12-11,4,3,0,1,3,0,3,3,winter
2012-12-11,4,4,0,1,2,0,8,8,winter
2012-12-11,4,5,0,1,3,1,40,41,winter
2012-12-11,4,6,0,1,2,0,118,118,winter
2012-12-11,4,7,0,1,1,8,372,380,winter
2012-12-11,4,8,0,1,2,16,708,724,winter
2012-12-11,4,9,0,1,1,12,322,334,winter
2012-12-11,4,10,0,1,1,12,142,154,winter
2012-12-11,4,11,0,1,2,28,145,173,winter
2012-12-11,4,12,0,1,2,13,213,226,winter
2012-12-11,4,13,0,1,2,28,226,254,winter
2012-12-11,4,14,0,1,2,19,185,204,winter
2012-12-11,4,15,0,1,2,20,250,270,winter
2012-12-11,4,16,0,1,2,24,334,358,winter
2012-12-11,4,17,0,1,1,21,580,601,winter
2012-12-11,4,18,0,1,1,23,523,546,winter
2012-12-11,4,19,0,1,1,21,412,433,winter
2012-12-11,4,20,0,1,1,9,248,257,winter
2012-12-11,4,21,0,1,1,14,193,207,winter
2012-12-11,4,22,0,1,1,6,100,106,winter
2012-12-11,4,23,0,1,1,4,60,64,winter
2012-12-12,4,0,0,1,1,1,33,34,winter
2012-12-12,4,1,0,1,1,3,18,21,winter
2012-12-12,4,2,0,1,1,5,4,9,winter
2012-12-12,4,3,0,1,1,3,7,10,winter
2012-12-12,4,4,0,1,1,0,4,4,winter
2012-12-12,4,5,0,1,1,0,37,37,winter
2012-12-12,4,6,0,1,2,2,126,128,winter
2012-12-12,4,7,0,1,2,3,366,369,winter
2012-12-12,4,8,0,1,2,18,670,688,winter
2012-12-12,4,9,0,1,2,13,272,285,winter
2012-12-12,4,10,0,1,2,20,116,136,winter
2012-12-12,4,11,0,1,2,24,148,172,winter
2012-12-12,4,12,0,1,2,14,218,232,winter
2012-12-12,4,13,0,1,2,18,220,238,winter
2012-12-12,4,14,0,1,2,34,191,225,winter
2012-12-12,4,15,0,1,2,21,207,228,winter
2012-12-12,4,16,0,1,2,19,310,329,winter
2012-12-12,4,17,0,1,2,21,540,561,winter
2012-12-12,4,18,0,1,2,25,515,540,winter
2012-12-12,4,19,0,1,2,18,384,402,winter
2012-12-12,4,20,0,1,1,25,243,268,winter
2012-12-12,4,21,0,1,2,16,186,202,winter
2012-12-12,4,22,0,1,2,4,118,122,winter
2012-12-12,4,23,0,1,2,3,76,79,winter
2012-12-13,4,0,0,1,2,1,31,32,winter
2012-12-13,4,1,0,1,2,4,19,23,winter
2012-12-13,4,2,0,1,2,3,5,8,winter
2012-12-13,4,3,0,1,2,0,2,2,winter
2012-12-13,4,4,0,1,2,0,8,8,winter
2012-12-13,4,5,0,1,2,2,31,33,winter
2012-12-13,4,6,0,1,1,2,112,114,winter
2012-12-13,4,7,0,1,1,5,380,385,winter
2012-12-13,4,8,0,1,1,24,655,679,winter
2012-12-13,4,9,0,1,1,25,300,325,winter
2012-12-13,4,10,0,1,1,28,139,167,winter
2012-12-13,4,11,0,1,1,25,164,189,winter
2012-12-13,4,12,0,1,1,30,252,282,winter
2012-12-13,4,13,0,1,1,41,230,271,winter
2012-12-13,4,14,0,1,1,31,211,242,winter
2012-12-13,4,15,0,1,1,40,240,280,winter
2012-12-13,4,16,0,1,1,50,356,406,winter
2012-12-13,4,17,0,1,1,43,507,550,winter
2012-12-13,4,18,0,1,1,20,446,466,winter
2012-12-13,4,19,0,1,1,20,328,348,winter
2012-12-13,4,20,0,1,1,6,235,241,winter
2012-12-13,4,21,0,1,1,13,200,213,winter
2012-12-13,4,22,0,1,1,7,141,148,winter
2012-12-13,4,23,0,1,1,5,115,120,winter
2012-12-14,4,0,0,1,1,4,43,47,winter
2012-12-14,4,1,0,1,1,0,26,26,winter
2012-12-14,4,2,0,1,1,3,6,9,winter
2012-12-14,4,3,0,1,1,0,12,12,winter
2012-12-14,4,4,0,1,1,1,9,10,winter
2012-12-14,4,5,0,1,1,0,34,34,winter
2012-12-14,4,6,0,1,1,1,112,113,winter
2012-12-14,4,7,0,1,1,3,305,308,winter
2012-12-14,4,8,0,1,1,13,623,636,winter
2012-12-14,4,9,0,1,1,13,330,343,winter
2012-12-14,4,10,0,1,1,28,162,190,winter
2012-12-14,4,11,0,1,1,31,180,211,winter
2012-12-14,4,12,0,1,1,29,244,273,winter
2012-12-14,4,13,0,1,1,39,274,313,winter
2012-12-14,4,14,0,1,1,48,251,299,winter
2012-12-14,4,15,0,1,1,57,252,309,winter
2012-12-14,4,16,0,1,1,45,372,417,winter
2012-12-14,4,17,0,1,1,40,582,622,winter
2012-12-14,4,18,0,1,1,23,432,455,winter
2012-12-14,4,19,0,1,1,17,302,319,winter
2012-12-14,4,20,0,1,1,12,209,221,winter
2012-12-14,4,21,0,1,1,7,165,172,winter
2012-12-14,4,22,0,1,1,4,134,138,winter
2012-12-14,4,23,0,1,1,11,123,134,winter
2012-12-15,4,0,0,0,1,4,90,94,winter
2012-12-15,4,1,0,0,2,9,86,95,winter
2012-12-15,4,2,0,0,1,6,63,69,winter
2012-12-15,4,3,0,0,2,5,18,23,winter
2012-12-15,4,4,0,0,2,1,5,6,winter
2012-12-15,4,5,0,0,2,0,3,3,winter
2012-12-15,4,6,0,0,2,0,11,11,winter
2012-12-15,4,7,0,0,2,1,47,48,winter
2012-12-15,4,8,0,0,2,8,111,119,winter
2012-12-15,4,9,0,0,1,17,203,220,winter
2012-12-15,4,10,0,0,1,23,250,273,winter
2012-12-15,4,11,0,0,1,66,327,393,winter
2012-12-15,4,12,0,0,1,89,364,453,winter
2012-12-15,4,13,0,0,1,88,368,456,winter
2012-12-15,4,14,0,0,1,92,334,426,winter
2012-12-15,4,15,0,0,1,95,352,447,winter
2012-12-15,4,16,0,0,1,85,328,413,winter
2012-12-15,4,17,0,0,1,35,274,309,winter
2012-12-15,4,18,0,0,1,40,232,272,winter
2012-12-15,4,19,0,0,1,32,225,257,winter
2012-12-15,4,20,0,0,2,23,178,201,winter
2012-12-15,4,21,0,0,1,15,169,184,winter
2012-12-15,4,22,0,0,1,22,134,156,winter
2012-12-15,4,23,0,0,2,11,108,119,winter
2012-12-16,4,0,0,0,2,8,102,110,winter
2012-12-16,4,1,0,0,3,14,82,96,winter
2012-12-16,4,2,0,0,2,8,79,87,winter
2012-12-16,4,3,0,0,2,1,37,38,winter
2012-12-16,4,4,0,0,2,1,10,11,winter
2012-12-16,4,5,0,0,2,0,9,9,winter
2012-12-16,4,6,0,0,2,0,6,6,winter
2012-12-16,4,7,0,0,2,5,22,27,winter
2012-12-16,4,8,0,0,2,12,76,88,winter
2012-12-16,4,9,0,0,2,19,113,132,winter
2012-12-16,4,10,0,0,2,42,215,257,winter
2012-12-16,4,11,0,0,2,47,248,295,winter
2012-12-16,4,12,0,0,2,67,350,417,winter
2012-12-16,4,13,0,0,2,67,289,356,winter
2012-12-16,4,14,0,0,2,50,260,310,winter
2012-12-16,4,15,0,0,2,46,292,338,winter
2012-12-16,4,16,0,0,2,66,334,400,winter
2012-12-16,4,17,0,0,2,29,214,243,winter
2012-12-16,4,18,0,0,3,8,99,107,winter
2012-12-16,4,19,0,0,1,10,99,109,winter
2012-12-16,4,20,0,0,2,14,108,122,winter
2012-12-16,4,21,0,0,2,14,92,106,winter
2012-12-16,4,22,0,0,2,6,83,89,winter
2012-12-16,4,23,0,0,2,4,29,33,winter
2012-12-17,4,0,0,1,2,2,26,28,winter
2012-12-17,4,1,0,1,2,1,14,15,winter
2012-12-17,4,2,0,1,2,1,4,5,winter
2012-12-17,4,3,0,1,2,0,3,3,winter
2012-12-17,4,4,0,1,3,2,3,5,winter
2012-12-17,4,5,0,1,2,0,24,24,winter
2012-12-17,4,6,0,1,2,1,107,108,winter
2012-12-17,4,7,0,1,2,5,314,319,winter
2012-12-17,4,8,0,1,2,10,582,592,winter
2012-12-17,4,9,0,1,2,11,271,282,winter
2012-12-17,4,10,0,1,2,15,120,135,winter
2012-12-17,4,11,0,1,2,22,148,170,winter
2012-12-17,4,12,0,1,2,21,211,232,winter
2012-12-17,4,13,0,1,2,16,194,210,winter
2012-12-17,4,14,0,1,2,12,169,181,winter
2012-12-17,4,15,0,1,2,15,196,211,winter
2012-12-17,4,16,0,1,3,15,287,302,winter
2012-12-17,4,17,0,1,2,17,478,495,winter
2012-12-17,4,18,0,1,2,14,493,507,winter
2012-12-17,4,19,0,1,2,7,333,340,winter
2012-12-17,4,20,0,1,2,8,192,200,winter
2012-12-17,4,21,0,1,2,6,114,120,winter
2012-12-17,4,22,0,1,2,5,49,54,winter
2012-12-17,4,23,0,1,3,6,41,47,winter
2012-12-18,4,0,0,1,2,0,18,18,winter
2012-12-18,4,1,0,1,2,0,15,15,winter
2012-12-18,4,2,0,1,2,2,5,7,winter
2012-12-18,4,3,0,1,1,0,5,5,winter
2012-12-18,4,4,0,1,1,3,5,8,winter
2012-12-18,4,5,0,1,1,0,36,36,winter
2012-12-18,4,6,0,1,1,1,117,118,winter
2012-12-18,4,7,0,1,1,4,351,355,winter
2012-12-18,4,8,0,1,1,10,652,662,winter
2012-12-18,4,9,0,1,1,19,307,326,winter
2012-12-18,4,10,0,1,1,22,162,184,winter
2012-12-18,4,11,0,1,1,58,211,269,winter
2012-12-18,4,12,0,1,3,49,264,313,winter
2012-12-18,4,13,0,1,1,51,235,286,winter
2012-12-18,4,14,0,1,1,56,191,247,winter
2012-12-18,4,15,0,1,1,28,218,246,winter
2012-12-18,4,16,0,1,1,40,323,363,winter
2012-12-18,4,17,0,1,1,39,533,572,winter
2012-12-18,4,18,0,1,1,13,512,525,winter
2012-12-18,4,19,0,1,1,19,334,353,winter
2012-12-18,4,20,0,1,1,4,264,268,winter
2012-12-18,4,21,0,1,1,9,159,168,winter
2012-12-18,4,22,0,1,1,5,127,132,winter
2012-12-18,4,23,0,1,1,1,80,81,winter
2012-12-19,4,0,0,1,1,6,35,41,winter
2012-12-19,4,1,0,1,1,1,14,15,winter
2012-12-19,4,2,0,1,1,1,2,3,winter
2012-12-19,4,3,0,1,1,0,5,5,winter
2012-12-19,4,4,0,1,1,1,6,7,winter
2012-12-19,4,5,0,1,1,2,29,31,winter
2012-12-19,4,6,0,1,1,3,109,112,winter
2012-12-19,4,7,0,1,1,3,360,363,winter
2012-12-19,4,8,0,1,1,13,665,678,winter
2012-12-19,4,9,0,1,1,8,309,317,winter
2012-12-19,4,10,0,1,1,17,147,164,winter
2012-12-19,4,11,0,1,1,31,169,200,winter
2012-12-19,4,12,0,1,1,33,203,236,winter
2012-12-19,4,13,0,1,1,30,183,213,winter
2012-12-19,4,14,0,1,1,33,185,218,winter
2012-12-19,4,15,0,1,1,28,209,237,winter
2012-12-19,4,16,0,1,1,37,297,334,winter
2012-12-19,4,17,0,1,1,26,536,562,winter
2012-12-19,4,18,0,1,1,23,546,569,winter
2012-12-19,4,19,0,1,1,7,329,336,winter
2012-12-19,4,20,0,1,1,10,231,241,winter
2012-12-19,4,21,0,1,1,4,164,168,winter
2012-12-19,4,22,0,1,1,12,117,129,winter
2012-12-19,4,23,0,1,1,4,84,88,winter
2012-12-20,4,0,0,1,1,2,40,42,winter
2012-12-20,4,1,0,1,1,1,19,20,winter
2012-12-20,4,2,0,1,1,2,6,8,winter
2012-12-20,4,3,0,1,2,1,3,4,winter
2012-12-20,4,4,0,1,2,0,6,6,winter
2012-12-20,4,5,0,1,2,0,35,35,winter
2012-12-20,4,6,0,1,2,4,114,118,winter
2012-12-20,4,7,0,1,2,4,346,350,winter
2012-12-20,4,8,0,1,2,14,585,599,winter
2012-12-20,4,9,0,1,2,14,303,317,winter
2012-12-20,4,10,0,1,2,23,138,161,winter
2012-12-20,4,11,0,1,2,22,168,190,winter
2012-12-20,4,12,0,1,2,31,181,212,winter
2012-12-20,4,13,0,1,2,46,171,217,winter
2012-12-20,4,14,0,1,2,43,171,214,winter
2012-12-20,4,15,0,1,2,33,216,249,winter
2012-12-20,4,16,0,1,2,21,281,302,winter
2012-12-20,4,17,0,1,2,25,450,475,winter
2012-12-20,4,18,0,1,2,22,359,381,winter
2012-12-20,4,19,0,1,3,3,115,118,winter
2012-12-20,4,20,0,1,3,1,49,50,winter
2012-12-20,4,21,0,1,3,1,25,26,winter
2012-12-20,4,22,0,1,3,1,20,21,winter
2012-12-20,4,23,0,1,3,0,13,13,winter
2012-12-21,1,0,0,1,3,0,17,17,springer
2012-12-21,1,1,0,1,3,2,7,9,springer
2012-12-21,1,2,0,1,3,0,3,3,springer
2012-12-21,1,3,0,1,3,0,3,3,springer
2012-12-21,1,4,0,1,2,1,5,6,springer
2012-12-21,1,5,0,1,2,0,13,13,springer
2012-12-21,1,6,0,1,2,4,76,80,springer
2012-12-21,1,7,0,1,2,3,205,208,springer
2012-12-21,1,8,0,1,2,8,464,472,springer
2012-12-21,1,9,0,1,2,2,265,267,springer
2012-12-21,1,10,0,1,1,8,146,154,springer
2012-12-21,1,11,0,1,2,12,150,162,springer
2012-12-21,1,12,0,1,2,25,199,224,springer
2012-12-21,1,13,0,1,2,26,214,240,springer
2012-12-21,1,14,0,1,2,20,199,219,springer
2012-12-21,1,15,0,1,2,29,234,263,springer
2012-12-21,1,16,0,1,2,28,253,281,springer
2012-12-21,1,17,0,1,2,24,297,321,springer
2012-12-21,1,18,0,1,2,7,236,243,springer
2012-12-21,1,19,0,1,1,5,148,153,springer
2012-12-21,1,20,0,1,1,8,104,112,springer
2012-12-21,1,21,0,1,1,2,68,70,springer
2012-12-21,1,22,0,1,1,6,57,63,springer
2012-12-21,1,23,0,1,1,1,39,40,springer
2012-12-22,1,0,0,0,1,1,30,31,springer
2012-12-22,1,1,0,0,1,1,34,35,springer
2012-12-22,1,2,0,0,1,0,23,23,springer
2012-12-22,1,3,0,0,1,0,7,7,springer
2012-12-22,1,4,0,0,1,3,2,5,springer
2012-12-22,1,5,0,0,1,0,5,5,springer
2012-12-22,1,6,0,0,1,0,13,13,springer
2012-12-22,1,7,0,0,1,2,18,20,springer
2012-12-22,1,8,0,0,1,0,29,29,springer
2012-12-22,1,9,0,0,1,13,77,90,springer
2012-12-22,1,10,0,0,1,13,105,118,springer
2012-12-22,1,11,0,0,1,29,130,159,springer
2012-12-22,1,12,0,0,1,18,128,146,springer
2012-12-22,1,13,0,0,1,23,135,158,springer
2012-12-22,1,14,0,0,1,20,141,161,springer
2012-12-22,1,15,0,0,1,14,139,153,springer
2012-12-22,1,16,0,0,1,23,124,147,springer
2012-12-22,1,17,0,0,1,15,99,114,springer
2012-12-22,1,18,0,0,1,7,75,82,springer
2012-12-22,1,19,0,0,1,9,51,60,springer
2012-12-22,1,20,0,0,1,6,55,61,springer
2012-12-22,1,21,0,0,1,4,49,53,springer
2012-12-22,1,22,0,0,1,1,38,39,springer
2012-12-22,1,23,0,0,1,3,37,40,springer
2012-12-23,1,0,0,0,1,3,24,27,springer
2012-12-23,1,1,0,0,1,1,19,20,springer
2012-12-23,1,2,0,0,1,1,17,18,springer
2012-12-23,1,3,0,0,1,0,9,9,springer
2012-12-23,1,4,0,0,1,1,3,4,springer
2012-12-23,1,5,0,0,1,0,6,6,springer
2012-12-23,1,6,0,0,1,4,5,9,springer
2012-12-23,1,7,0,0,1,3,16,19,springer
2012-12-23,1,8,0,0,1,5,43,48,springer
2012-12-23,1,9,0,0,1,7,49,56,springer
2012-12-23,1,10,0,0,1,26,67,93,springer
2012-12-23,1,11,0,0,1,48,104,152,springer
2012-12-23,1,12,0,0,1,52,144,196,springer
2012-12-23,1,13,0,0,1,63,123,186,springer
2012-12-23,1,14,0,0,1,57,118,175,springer
2012-12-23,1,15,0,0,1,39,98,137,springer
2012-12-23,1,16,0,0,1,53,137,190,springer
2012-12-23,1,17,0,0,1,21,93,114,springer
2012-12-23,1,18,0,0,1,8,85,93,springer
2012-12-23,1,19,0,0,1,4,54,58,springer
2012-12-23,1,20,0,0,1,0,52,52,springer
2012-12-23,1,21,0,0,1,4,38,42,springer
2012-12-23,1,22,0,0,1,5,53,58,springer
2012-12-23,1,23,0,0,1,3,22,25,springer
2012-12-24,1,0,0,1,1,0,12,12,springer
2012-12-24,1,1,0,1,1,0,11,11,springer
2012-12-24,1,2,0,1,1,0,5,5,springer
2012-12-24,1,3,0,1,1,1,2,3,springer
2012-12-24,1,5,0,1,1,0,9,9,springer
2012-12-24,1,6,0,1,1,1,16,17,springer
2012-12-24,1,7,0,1,1,3,27,30,springer
2012-12-24,1,8,0,1,1,4,62,66,springer
2012-12-24,1,9,0,1,2,17,68,85,springer
2012-12-24,1,10,0,1,2,21,82,103,springer
2012-12-24,1,11,0,1,2,20,104,124,springer
2012-12-24,1,12,0,1,2,22,113,135,springer
2012-12-24,1,13,0,1,3,16,54,70,springer
2012-12-24,1,14,0,1,3,13,33,46,springer
2012-12-24,1,15,0,1,3,6,27,33,springer
2012-12-24,1,16,0,1,3,6,27,33,springer
2012-12-24,1,17,0,1,3,7,19,26,springer
2012-12-24,1,18,0,1,3,6,20,26,springer
2012-12-24,1,19,0,1,2,4,14,18,springer
2012-12-24,1,20,0,1,3,6,17,23,springer
2012-12-24,1,21,0,1,3,13,9,22,springer
2012-12-24,1,22,0,1,2,7,5,12,springer
2012-12-24,1,23,0,1,3,1,10,11,springer
2012-12-25,1,0,1,0,3,3,10,13,springer
2012-12-25,1,1,1,0,2,0,13,13,springer
2012-12-25,1,2,1,0,2,0,7,7,springer
2012-12-25,1,4,1,0,2,0,1,1,springer
2012-12-25,1,5,1,0,2,2,1,3,springer
2012-12-25,1,6,1,0,2,1,6,7,springer
2012-12-25,1,7,1,0,2,0,6,6,springer
2012-12-25,1,8,1,0,2,1,10,11,springer
2012-12-25,1,9,1,0,2,7,21,28,springer
2012-12-25,1,10,1,0,1,11,21,32,springer
2012-12-25,1,11,1,0,1,43,43,86,springer
2012-12-25,1,12,1,0,1,62,52,114,springer
2012-12-25,1,13,1,0,1,75,46,121,springer
2012-12-25,1,14,1,0,1,58,68,126,springer
2012-12-25,1,15,1,0,1,51,56,107,springer
2012-12-25,1,16,1,0,2,48,38,86,springer
2012-12-25,1,17,1,0,2,16,34,50,springer
2012-12-25,1,18,1,0,2,20,23,43,springer
2012-12-25,1,19,1,0,2,16,20,36,springer
2012-12-25,1,20,1,0,2,11,29,40,springer
2012-12-25,1,21,1,0,2,8,26,34,springer
2012-12-25,1,22,1,0,2,3,16,19,springer
2012-12-25,1,23,1,0,2,4,26,30,springer
2012-12-26,1,0,0,1,2,1,8,9,springer
2012-12-26,1,1,0,1,2,0,7,7,springer
2012-12-26,1,2,0,1,2,0,1,1,springer
2012-12-26,1,3,0,1,2,0,2,2,springer
2012-12-26,1,4,0,1,1,0,2,2,springer
2012-12-26,1,5,0,1,2,0,11,11,springer
2012-12-26,1,6,0,1,2,0,36,36,springer
2012-12-26,1,7,0,1,3,0,26,26,springer
2012-12-26,1,8,0,1,3,0,31,31,springer
2012-12-26,1,9,0,1,3,1,22,23,springer
2012-12-26,1,10,0,1,3,0,8,8,springer
2012-12-26,1,11,0,1,3,0,10,10,springer
2012-12-26,1,12,0,1,3,0,10,10,springer
2012-12-26,1,13,0,1,3,0,15,15,springer
2012-12-26,1,14,0,1,3,0,20,20,springer
2012-12-26,1,15,0,1,3,0,13,13,springer
2012-12-26,1,16,0,1,3,0,13,13,springer
2012-12-26,1,17,0,1,3,2,51,53,springer
2012-12-26,1,18,0,1,3,1,42,43,springer
2012-12-26,1,19,0,1,3,2,33,35,springer
2012-12-26,1,20,0,1,3,0,32,32,springer
2012-12-26,1,21,0,1,2,0,20,20,springer
2012-12-26,1,22,0,1,3,0,11,11,springer
2012-12-26,1,23,0,1,3,2,8,10,springer
2012-12-27,1,0,0,1,3,0,3,3,springer
2012-12-27,1,1,0,1,3,0,5,5,springer
2012-12-27,1,2,0,1,2,0,2,2,springer
2012-12-27,1,3,0,1,2,0,1,1,springer
2012-12-27,1,4,0,1,2,0,3,3,springer
2012-12-27,1,5,0,1,1,1,10,11,springer
2012-12-27,1,6,0,1,1,0,45,45,springer
2012-12-27,1,7,0,1,1,0,90,90,springer
2012-12-27,1,8,0,1,1,2,206,208,springer
2012-12-27,1,9,0,1,1,6,127,133,springer
2012-12-27,1,10,0,1,1,8,67,75,springer
2012-12-27,1,11,0,1,2,23,80,103,springer
2012-12-27,1,12,0,1,1,22,87,109,springer
2012-12-27,1,13,0,1,1,19,99,118,springer
2012-12-27,1,14,0,1,2,25,94,119,springer
2012-12-27,1,15,0,1,2,31,89,120,springer
2012-12-27,1,16,0,1,2,23,151,174,springer
2012-12-27,1,17,0,1,2,30,227,257,springer
2012-12-27,1,18,0,1,2,9,188,197,springer
2012-12-27,1,19,0,1,1,11,106,117,springer
2012-12-27,1,20,0,1,1,12,79,91,springer
2012-12-27,1,21,0,1,2,12,51,63,springer
2012-12-27,1,22,0,1,2,11,33,44,springer
2012-12-27,1,23,0,1,2,2,24,26,springer
2012-12-28,1,0,0,1,2,3,22,25,springer
2012-12-28,1,1,0,1,1,0,9,9,springer
2012-12-28,1,2,0,1,1,0,5,5,springer
2012-12-28,1,3,0,1,2,0,2,2,springer
2012-12-28,1,4,0,1,2,0,4,4,springer
2012-12-28,1,5,0,1,2,0,15,15,springer
2012-12-28,1,6,0,1,1,2,49,51,springer
2012-12-28,1,7,0,1,1,1,111,112,springer
2012-12-28,1,8,0,1,2,1,238,239,springer
2012-12-28,1,9,0,1,2,18,173,191,springer
2012-12-28,1,10,0,1,2,77,85,162,springer
2012-12-28,1,11,0,1,2,71,107,178,springer
2012-12-28,1,12,0,1,2,72,150,222,springer
2012-12-28,1,13,0,1,2,76,146,222,springer
2012-12-28,1,14,0,1,2,84,177,261,springer
2012-12-28,1,15,0,1,2,74,151,225,springer
2012-12-28,1,16,0,1,1,42,208,250,springer
2012-12-28,1,17,0,1,1,43,228,271,springer
2012-12-28,1,18,0,1,1,16,197,213,springer
2012-12-28,1,19,0,1,2,15,113,128,springer
2012-12-28,1,20,0,1,2,14,83,97,springer
2012-12-28,1,21,0,1,2,17,75,92,springer
2012-12-28,1,22,0,1,2,13,49,62,springer
2012-12-28,1,23,0,1,2,5,54,59,springer
2012-12-29,1,0,0,0,2,1,25,26,springer
2012-12-29,1,1,0,0,2,6,31,37,springer
2012-12-29,1,2,0,0,2,1,18,19,springer
2012-12-29,1,3,0,0,2,1,5,6,springer
2012-12-29,1,4,0,0,2,0,3,3,springer
2012-12-29,1,5,0,0,2,0,3,3,springer
2012-12-29,1,6,0,0,2,0,7,7,springer
2012-12-29,1,7,0,0,2,1,17,18,springer
2012-12-29,1,8,0,0,2,9,35,44,springer
2012-12-29,1,9,0,0,2,16,33,49,springer
2012-12-29,1,10,0,0,3,6,35,41,springer
2012-12-29,1,11,0,0,3,7,38,45,springer
2012-12-29,1,12,0,0,3,5,43,48,springer
2012-12-29,1,13,0,0,3,13,71,84,springer
2012-12-29,1,14,0,0,2,10,88,98,springer
2012-12-29,1,15,0,0,2,19,110,129,springer
2012-12-29,1,16,0,0,1,22,125,147,springer
2012-12-29,1,17,0,0,1,18,100,118,springer
2012-12-29,1,18,0,0,1,8,102,110,springer
2012-12-29,1,19,0,0,2,7,90,97,springer
2012-12-29,1,20,0,0,2,2,64,66,springer
2012-12-29,1,21,0,0,2,4,56,60,springer
2012-12-29,1,22,0,0,2,3,51,54,springer
2012-12-29,1,23,0,0,2,0,32,32,springer
2012-12-30,1,0,0,0,2,0,41,41,springer
2012-12-30,1,1,0,0,2,1,27,28,springer
2012-12-30,1,2,0,0,2,0,19,19,springer
2012-12-30,1,3,0,0,2,1,14,15,springer
2012-12-30,1,4,0,0,2,0,7,7,springer
2012-12-30,1,5,0,0,2,0,2,2,springer
2012-12-30,1,6,0,0,2,1,7,8,springer
2012-12-30,1,7,0,0,1,0,13,13,springer
2012-12-30,1,8,0,0,1,1,32,33,springer
2012-12-30,1,9,0,0,1,9,65,74,springer
2012-12-30,1,10,0,0,1,31,91,122,springer
2012-12-30,1,11,0,0,1,33,103,136,springer
2012-12-30,1,12,0,0,1,47,97,144,springer
2012-12-30,1,13,0,0,1,49,120,169,springer
2012-12-30,1,14,0,0,1,39,121,160,springer
2012-12-30,1,15,0,0,1,37,101,138,springer
2012-12-30,1,16,0,0,1,31,102,133,springer
2012-12-30,1,17,0,0,1,26,97,123,springer
2012-12-30,1,18,0,0,2,12,113,125,springer
2012-12-30,1,19,0,0,1,16,86,102,springer
2012-12-30,1,20,0,0,1,9,63,72,springer
2012-12-30,1,21,0,0,1,5,42,47,springer
2012-12-30,1,22,0,0,1,6,30,36,springer
2012-12-30,1,23,0,0,1,10,39,49,springer
2012-12-31,1,0,0,1,1,4,30,34,springer
2012-12-31,1,1,0,1,1,6,13,19,springer
2012-12-31,1,2,0,1,1,3,8,11,springer
2012-12-31,1,3,0,1,1,0,1,1,springer
2012-12-31,1,4,0,1,1,0,3,3,springer
2012-12-31,1,5,0,1,1,0,9,9,springer
2012-12-31,1,6,0,1,1,0,40,40,springer
2012-12-31,1,7,0,1,1,2,83,85,springer
2012-12-31,1,8,0,1,1,9,187,196,springer
2012-12-31,1,9,0,1,2,13,144,157,springer
2012-12-31,1,10,0,1,2,33,87,120,springer
2012-12-31,1,11,0,1,2,43,114,157,springer
2012-12-31,1,12,0,1,2,52,172,224,springer
2012-12-31,1,13,0,1,2,38,165,203,springer
2012-12-31,1,14,0,1,2,62,185,247,springer
2012-12-31,1,15,0,1,2,69,246,315,springer
2012-12-31,1,16,0,1,2,30,184,214,springer
2012-12-31,1,17,0,1,2,14,150,164,springer
2012-12-31,1,18,0,1,2,10,112,122,springer
2012-12-31,1,19,0,1,2,11,108,119,springer
2012-12-31,1,20,0,1,2,8,81,89,springer
2012-12-31,1,21,0,1,1,7,83,90,springer
2012-12-31,1,22,0,1,1,13,48,61,springer
2012-12-31,1,23,0,1,1,12,37,49,springer
